[layer]
type=Tile Layer 1
data=
1,21,1,1,1,1,1,0,1,
1,0,0,21,0,0,0,0,1,
1,1,21,1,1,1,1,1,1,
1,0,0,21,0,1,0,1,0,
1,21,1,1,1,1,1,1,1,
0,0,0,0,21,0,1,1,1,
0,21,1,1,1,0,0,1,1,
0,1,1,1,1,1,0,21,0,
0,21,0,1,1,1,1,1,0,
0,1,21,0,1,1,1,1,1,
0,1,21,0,0,1,1,1,1,
0,0,1,1,21,0,1,1,1,
0,1,0,21,1,1,1,1,1,
0,0,0,0,21,0,1,1,1,
0,1,1,0,0,21,1,1,1,
0,1,0,0,21,1,0,1,1,
0,1,1,1,21,1,0,1,1,
0,0,21,0,0,1,0,1,1,
0,1,1,1,1,1,21,1,1,
0,1,0,0,0,0,0,1,21,
0,1,1,1,1,1,0,1,21,
0,1,1,1,1,1,0,1,21,
21,1,1,1,1,1,1,1,1,
0,1,1,1,1,1,21,1,0,
1,0,21,1,1,1,1,0,1,
1,21,0,1,1,1,1,0,0,
1,1,1,1,1,1,1,21,0,
1,1,1,1,1,1,1,21,0,
1,1,1,0,0,0,0,21,0,
1,1,1,0,1,1,21,1,0,
0,0,0,0,0,0,0,0,0,
0,0,0,0,0,0,0,0,0,
0,0,0,0,0,0,0,0,0.
[layer]
type=Tile Layer 2
data=
166,0,166,166,166,166,166,0,166,
164,0,0,0,0,0,0,0,164,
154,154,0,154,154,154,154,154,154,
112,0,0,0,0,112,0,112,0,
133,0,133,133,133,133,133,133,133,
0,0,0,0,0,0,129,129,129,
0,0,118,118,118,0,0,118,118,
0,108,108,108,108,108,0,0,0,
0,0,0,134,134,134,134,134,0,
0,124,0,0,124,124,124,124,124,
0,114,0,0,0,114,114,114,114,
0,0,103,103,0,0,103,103,103,
0,129,0,0,129,129,129,129,129,
0,0,0,0,0,0,119,119,119,
0,109,109,0,0,0,109,109,109,
0,99,0,0,0,99,0,99,99,
0,123,123,123,0,123,0,123,123,
0,0,0,0,0,113,0,113,113,
0,104,104,104,104,104,0,104,104,
0,95,0,0,0,0,0,95,0,
0,94,94,94,94,94,0,94,0,
0,85,85,85,85,85,0,85,0,
0,80,80,80,80,80,80,80,80,
0,83,83,83,83,83,0,83,0,
74,0,0,74,74,74,74,0,74,
73,0,0,73,73,73,73,0,0,
72,72,72,72,72,72,72,0,0,
71,71,71,71,71,71,71,0,0,
70,70,70,0,0,0,0,0,0,
69,69,69,0,69,69,0,69,0,
0,0,0,0,0,0,0,0,0,
0,0,0,0,0,0,0,0,0,
0,0,0,0,0,0,0,0,0.