[layer]
type=Tile Layer 1
data=
0,21,1,4,5,0,1,3,1,
5,0,1,1,1,1,21,0,1,
0,1,1,1,1,1,1,21,0,
5,0,1,1,1,21,0,1,0,
0,0,3,1,1,0,21,0,1,
0,1,1,0,21,1,4,0,1,
1,1,1,1,21,1,5,1,1,
1,1,6,0,0,21,0,1,0,
0,4,0,1,3,1,1,4,21,
1,1,0,1,0,21,0,6,0,
0,1,3,5,0,5,21,4,1,
0,0,0,21,0,3,0,1,0,
0,0,0,0,0,0,0,0,0,
0,0,0,0,0,0,0,0,0,
0,0,0,0,0,0,0,0,0.
[layer]
type=Tile Layer 2
data=
0,0,89,89,89,0,89,89,89,
64,0,64,64,64,64,0,0,64,
0,63,63,63,63,63,63,0,0,
62,0,62,62,62,0,0,62,0,
0,0,55,55,55,0,0,0,55,
0,54,54,0,0,54,54,0,54,
48,48,48,48,0,48,48,48,48,
52,52,52,0,0,0,0,52,0,
0,51,0,51,51,51,51,51,0,
50,50,0,50,0,0,0,50,0,
0,49,49,49,0,49,0,49,49,
0,0,0,0,0,48,0,48,0,
0,0,0,0,0,0,0,0,0,
0,0,0,0,0,0,0,0,0,
0,0,0,0,0,0,0,0,0.