[layer]
type=Tile Layer 1
data=
1,1,1,1,1,1,1,1,21,
1,1,1,1,0,21,0,0,0,
1,1,1,1,1,1,1,1,21,
1,1,0,0,0,21,0,1,1,
1,1,1,1,1,21,0,1,1,
1,1,21,1,1,1,1,1,1,
1,1,21,1,1,0,1,1,1,
1,1,1,21,1,0,0,0,0,
1,1,1,1,1,21,1,1,0,
1,0,21,0,0,0,1,1,1,
0,0,1,1,21,1,1,1,1,
0,1,1,1,0,0,0,0,21,
1,1,1,21,1,1,1,1,1,
0,0,1,0,1,21,0,0,0,
1,1,1,21,1,1,1,0,1,
0,21,0,0,1,1,1,0,1,
1,1,1,21,1,1,1,1,1,
0,0,1,0,1,1,1,0,21,
1,1,1,21,1,1,1,0,1,
1,1,1,0,0,21,0,0,1,
1,1,1,1,1,1,1,21,1,
1,1,1,1,21,1,1,0,0,
1,1,0,21,0,1,1,1,0,
1,1,0,21,1,1,1,1,0,
1,0,1,21,1,1,1,1,0,
1,0,21,0,1,1,1,0,0,
1,1,1,21,1,1,1,0,1,
0,0,0,0,0,0,0,0,0,
0,0,0,0,0,0,0,0,0,
0,0,0,0,0,0,0,0,0.
[layer]
type=Tile Layer 2
data=
152,152,152,152,152,152,152,152,0,
158,158,158,158,0,0,0,0,0,
149,149,149,149,149,149,149,149,0,
117,117,0,0,0,0,0,117,117,
107,107,107,107,107,0,0,107,107,
127,127,0,127,127,127,127,127,127,
123,123,0,123,123,0,123,123,123,
113,113,113,0,113,0,0,0,0,
102,102,102,102,102,0,102,102,0,
128,0,0,0,0,0,128,128,128,
0,0,118,118,0,118,118,118,118,
0,108,108,108,0,0,0,0,0,
93,93,93,0,93,93,93,93,93,
0,0,122,0,122,0,0,0,0,
112,112,112,0,112,112,112,0,112,
0,0,0,0,103,103,103,0,103,
89,89,89,0,89,89,89,89,89,
0,0,93,0,93,93,93,0,0,
84,84,84,0,84,84,84,0,84,
83,83,83,0,0,0,0,0,83,
78,78,78,78,78,78,78,0,78,
73,73,73,73,0,73,73,0,0,
72,72,0,0,0,72,72,72,0,
71,71,0,0,71,71,71,71,0,
70,0,70,0,70,70,70,70,0,
69,0,0,0,69,69,69,0,0,
68,68,68,0,68,68,68,0,68,
0,0,0,0,0,0,0,0,0,
0,0,0,0,0,0,0,0,0,
0,0,0,0,0,0,0,0,0.