[layer]
type=Tile Layer 1
data=
1,1,1,0,21,0,0,0,1,
1,1,1,21,1,1,1,0,1,
0,0,1,0,1,1,1,21,1,
1,1,1,21,1,1,1,0,1,
0,21,0,0,1,1,1,0,1,
1,1,1,1,1,1,1,21,1,
1,1,1,0,0,0,21,0,1,
1,1,1,21,1,1,1,1,1,
0,0,1,0,1,0,0,21,0,
1,1,21,0,0,0,0,0,0,
1,21,0,0,0,1,1,1,1,
1,21,1,1,0,0,1,1,1,
1,1,21,1,1,0,1,1,1,
1,1,0,0,21,0,0,1,1,
1,1,1,1,1,1,1,21,1,
1,1,21,0,1,1,1,0,1,
1,1,0,1,0,21,0,1,1,
0,0,0,21,1,1,1,1,1,
0,1,0,1,1,1,1,1,21,
0,1,21,1,1,1,1,1,0,
0,1,21,1,1,1,1,1,0,
0,1,21,1,1,1,1,1,0,
0,1,0,1,1,1,1,1,21,
0,1,0,1,21,0,0,0,0,
1,1,1,1,1,1,1,1,21,
0,0,0,0,21,0,0,1,0,
1,1,1,1,0,1,21,1,0,
1,1,1,1,21,0,0,0,1,
0,1,1,1,21,1,1,1,1,
0,1,1,1,21,1,1,1,1,
0,21,1,1,0,1,1,1,1,
1,21,1,1,0,1,1,1,1,
0,21,1,1,0,0,0,0,1,
0,0,0,0,0,0,0,0,0,
0,0,0,0,0,0,0,0,0,
0,0,0,0,0,0,0,0,0.
[layer]
type=Tile Layer 2
data=
170,170,170,0,0,0,0,0,170,
169,169,169,0,169,169,169,0,169,
0,0,167,0,167,167,167,0,167,
146,146,146,0,146,146,146,0,146,
0,0,0,0,134,134,134,0,134,
117,117,117,117,117,117,117,0,117,
112,112,112,0,0,0,0,0,112,
133,133,133,0,133,133,133,133,133,
0,0,129,0,129,0,0,0,0,
118,118,0,0,0,0,0,0,0,
108,0,0,0,0,108,108,108,108,
134,0,134,134,0,0,134,134,134,
124,124,0,124,124,0,124,124,124,
114,114,0,0,0,0,0,114,114,
99,99,99,99,99,99,99,0,99,
129,129,0,0,129,129,129,0,129,
119,119,0,119,0,0,0,119,119,
0,0,0,0,109,109,109,109,109,
0,99,0,99,99,99,99,99,0,
0,123,0,123,123,123,123,123,0,
0,113,0,113,113,113,113,113,0,
0,104,0,104,104,104,104,104,0,
0,95,0,95,95,95,95,95,0,
0,94,0,94,0,0,0,0,0,
81,81,81,81,81,81,81,81,0,
0,0,0,0,0,0,0,84,0,
83,83,83,83,0,83,0,83,0,
74,74,74,74,0,0,0,0,74,
0,73,73,73,0,73,73,73,73,
0,72,72,72,0,72,72,72,72,
0,0,71,71,0,71,71,71,71,
70,0,70,70,0,70,70,70,70,
0,0,69,69,0,0,0,0,69,
0,0,0,0,0,0,0,0,0,
0,0,0,0,0,0,0,0,0,
0,0,0,0,0,0,0,0,0.