[layer]
type=Tile Layer 1
data=
5,0,3,21,0,0,0,5,6,
0,6,1,1,6,6,0,21,1,
0,0,2,21,0,3,3,0,5,
2,9,2,2,2,2,21,2,0,
4,2,2,5,4,1,21,8,0,
1,5,3,3,21,3,0,2,4,
5,5,1,1,21,4,0,0,0,
4,1,3,21,1,5,3,0,0,
3,4,4,0,0,21,0,0,5,
0,21,0,0,1,0,5,0,3,
6,2,2,21,6,1,3,0,5,
0,2,8,0,0,0,21,0,0,
3,21,2,2,3,1,2,2,1,
2,21,2,0,2,2,2,9,2,
6,21,6,0,5,5,2,2,5,
0,0,1,0,2,2,0,0,21,
5,21,6,2,8,2,6,5,1,
3,0,1,2,2,2,21,0,0,
1,2,2,1,1,21,1,1,3,
6,10,2,4,2,2,21,0,4,
3,0,21,1,2,8,2,0,6,
6,6,3,5,2,21,2,0,1,
1,0,1,1,5,21,5,0,6,
3,21,1,3,5,1,6,0,3,
0,0,0,0,0,0,0,0,0,
0,0,0,0,0,0,0,0,0,
0,0,0,0,0,0,0,0,0.
[layer]
type=Tile Layer 2
data=
138,0,138,0,0,0,0,138,138,
0,136,136,136,136,136,0,0,136,
0,0,135,0,0,135,135,0,135,
109,109,109,109,109,109,0,109,0,
100,100,100,100,100,100,0,100,0,
86,86,86,86,0,86,0,86,86,
113,113,113,113,0,113,0,0,0,
104,104,104,0,104,104,104,0,0,
95,95,95,0,0,0,0,0,95,
0,0,0,0,86,0,86,0,86,
102,102,102,0,102,102,102,0,102,
0,98,98,0,0,0,0,0,0,
81,0,81,81,81,81,81,81,81,
82,0,82,0,82,82,82,82,82,
77,0,77,0,77,77,77,77,77,
0,0,73,0,73,73,0,0,0,
68,0,68,68,68,68,68,68,68,
71,0,3,56,56,56,0,0,0,
63,63,50,3,3,0,3,63,63,
62,62,50,50,50,50,0,0,62,
61,0,0,3,49,49,49,0,61,
57,57,46,46,46,0,46,0,57,
59,0,2,2,47,0,47,0,59,
56,0,56,56,56,56,56,0,56,
0,0,0,0,0,0,0,0,0,
0,0,0,0,0,0,0,0,0,
0,0,0,0,0,0,0,0,0.