[layer]
type=Tile Layer 1
data=
1,1,21,1,5,6,0,1,1,
0,0,0,0,0,1,0,21,0,
1,1,4,1,21,5,0,1,1,
1,0,21,0,0,1,1,1,1,
1,5,21,0,0,0,0,0,0,
4,1,21,1,1,1,3,3,0,
1,3,1,21,0,0,0,0,2,
4,1,1,21,2,0,1,2,10,
1,21,0,2,10,2,1,2,2,
0,1,1,2,2,21,1,1,1,
0,4,5,1,1,21,1,4,1,
0,21,0,0,0,2,2,1,6,
0,0,0,21,2,8,2,0,1,
6,1,4,1,2,2,2,21,1,
1,0,0,0,0,21,1,0,1,
2,21,1,1,1,0,1,4,3,
9,21,2,2,2,2,2,2,0,
2,21,2,2,2,2,9,2,2,
3,0,21,0,1,0,2,2,5,
1,21,1,1,1,0,1,1,3,
4,21,1,2,2,2,1,1,1,
5,1,1,2,10,21,1,1,1,
1,1,3,2,21,2,2,1,1,
1,2,2,2,21,9,2,2,2,
1,1,1,1,2,2,1,21,1,
4,21,0,0,2,2,2,0,1,
5,1,6,1,21,10,2,0,1,
0,0,0,0,0,0,0,0,0,
0,0,0,0,0,0,0,0,0,
0,0,0,0,0,0,0,0,0.
[layer]
type=Tile Layer 2
data=
160,160,0,160,160,160,0,160,160,
0,0,0,0,0,158,0,0,0,
157,157,157,157,0,157,0,157,157,
117,0,0,0,0,117,117,117,117,
107,107,0,0,0,0,0,0,0,
133,133,0,133,133,133,133,133,0,
123,123,123,0,0,0,0,0,123,
113,113,113,0,113,0,113,113,113,
102,0,0,102,102,102,102,102,102,
0,128,128,128,128,0,128,128,128,
0,118,118,118,118,0,118,118,118,
0,0,0,0,0,108,108,108,108,
0,0,0,0,98,98,98,0,98,
116,116,116,116,116,116,116,0,116,
112,0,0,0,0,0,112,0,112,
103,0,103,103,103,0,103,103,103,
94,0,94,94,94,94,94,94,0,
93,0,93,93,93,93,93,93,93,
84,0,0,0,84,0,84,84,84,
83,0,83,83,83,0,83,83,83,
78,0,78,78,78,78,78,78,78,
58,3,58,58,58,0,3,58,58,
3,3,58,58,0,58,58,58,58,
3,57,57,57,0,57,57,57,57,
3,56,56,56,56,56,3,0,56,
69,0,0,0,69,69,69,0,69,
68,68,68,68,0,68,68,0,68,
0,0,0,0,0,0,0,0,0,
0,0,0,0,0,0,0,0,0,
0,0,0,0,0,0,0,0,0.