[layer]
type=Tile Layer 1
data=
1,0,1,21,0,1,1,0,1,
2,2,2,21,2,2,2,20,2,
0,0,3,0,1,0,2,21,0,
1,21,1,1,1,0,5,2,2,
2,0,2,0,2,0,0,21,20,
2,0,2,21,2,7,2,18,2,
2,2,2,2,21,1,1,2,24,
2,2,8,2,1,0,21,0,1,
2,2,2,2,3,21,1,0,6,
9,2,2,2,21,0,2,2,2,
2,2,10,2,0,1,21,3,0,
2,0,21,2,1,0,0,1,0,
0,0,0,0,0,0,0,0,0,
0,0,0,0,0,0,0,0,0,
0,0,0,0,0,0,0,0,0.
[layer]
type=Tile Layer 2
data=
89,0,89,0,0,89,89,0,89,
60,60,60,0,60,60,60,0,60,
0,0,63,0,63,0,63,0,0,
59,0,59,59,59,0,59,59,59,
55,0,55,0,55,0,0,0,0,
54,0,54,0,54,54,54,0,54,
50,50,50,50,0,50,50,50,0,
52,52,52,52,52,0,0,0,52,
49,49,49,49,49,0,49,0,49,
50,50,50,50,0,0,50,50,50,
49,49,49,49,0,49,0,49,0,
48,0,0,48,48,0,0,48,0,
0,0,0,0,0,0,0,0,0,
0,0,0,0,0,0,0,0,0,
0,0,0,0,0,0,0,0,0.