[layer]
type=Tile Layer 1
data=
1,1,1,21,0,0,0,4,1,
1,1,1,21,3,0,1,1,1,
6,1,6,21,0,0,1,1,1,
0,1,1,1,1,0,21,0,1,
0,4,1,1,1,1,21,0,1,
0,0,0,0,5,3,21,1,4,
3,1,1,6,0,21,0,1,1,
0,1,1,1,4,1,21,1,1,
0,21,0,0,0,0,1,1,3,
1,1,1,1,1,0,21,0,0,
1,1,6,1,1,21,6,1,0,
1,4,3,1,1,0,21,0,0,
1,5,6,1,1,21,4,1,0,
1,1,1,1,0,21,0,0,0,
1,5,0,0,21,0,0,1,1,
0,6,0,0,21,1,1,1,1,
0,21,4,1,0,0,0,0,0,
1,21,0,0,0,0,0,0,0,
0,21,0,0,0,0,1,0,5,
1,3,1,1,1,21,1,0,1,
1,0,4,0,0,21,1,0,1,
1,0,5,21,3,6,1,0,1,
0,0,1,0,1,21,0,0,1,
1,21,5,0,1,0,1,1,1,
1,0,0,0,1,21,1,0,1,
1,1,6,6,1,21,5,0,1,
1,0,21,0,0,0,1,0,4,
1,0,0,21,0,0,0,0,1,
1,21,3,1,1,1,1,0,1,
3,21,5,1,1,6,1,0,1,
5,21,1,1,1,1,1,0,1,
0,0,1,1,3,1,1,21,1,
6,1,3,1,1,5,1,21,1,
0,21,0,0,1,0,4,0,0,
1,5,1,6,1,21,1,1,1,
0,21,1,0,0,0,4,1,1,
1,4,1,21,1,0,1,1,1,
1,0,1,21,3,0,0,0,1,
1,1,1,21,6,0,1,3,1,
1,1,1,0,1,21,1,0,1,
6,1,3,21,1,0,1,0,1,
1,1,6,0,4,0,1,21,0,
0,0,0,0,0,0,0,0,0,
0,0,0,0,0,0,0,0,0,
0,0,0,0,0,0,0,0,0.
[layer]
type=Tile Layer 2
data=
203,203,203,0,0,0,0,203,203,
201,201,201,0,201,0,201,201,201,
200,200,200,0,0,0,200,200,200,
0,138,138,138,138,0,0,0,138,
0,173,173,173,173,173,0,0,173,
0,0,0,0,160,160,0,160,160,
147,147,147,147,0,0,0,147,147,
0,134,134,134,134,134,0,134,134,
0,0,0,0,0,0,167,167,167,
154,154,154,154,154,0,0,0,0,
142,142,142,142,142,0,142,142,0,
130,130,130,130,130,0,0,0,0,
162,162,162,162,162,0,162,162,0,
149,149,149,149,0,0,0,0,0,
137,137,0,0,0,0,0,137,137,
0,125,0,0,0,125,125,125,125,
0,0,156,156,0,0,0,0,0,
144,0,0,0,0,0,0,0,0,
0,0,0,0,0,0,132,0,132,
121,121,121,121,121,0,121,0,121,
150,0,150,0,0,0,150,0,150,
139,0,139,0,139,139,139,0,139,
0,0,128,0,128,0,0,0,128,
116,0,116,0,116,0,116,116,116,
145,0,0,0,145,0,145,0,145,
134,134,134,134,134,0,134,0,134,
123,0,0,0,0,0,123,0,123,
112,0,0,0,0,0,0,0,112,
139,0,139,139,139,139,139,0,139,
128,0,128,128,128,128,128,0,128,
118,0,118,118,118,118,118,0,118,
0,0,108,108,108,108,108,0,108,
102,102,102,102,102,102,102,0,102,
0,0,0,0,97,0,97,0,0,
91,91,91,91,91,0,91,91,91,
0,0,95,0,0,0,95,95,95,
85,85,85,0,85,0,85,85,85,
84,0,84,0,84,0,0,0,84,
83,83,83,0,83,0,83,83,83,
82,82,82,0,82,0,82,0,82,
81,81,81,0,81,0,81,0,81,
80,80,80,0,80,0,80,0,0,
0,0,0,0,0,0,0,0,0,
0,0,0,0,0,0,0,0,0,
0,0,0,0,0,0,0,0,0.