[layer]
type=Tile Layer 1
data=
0,21,1,1,4,1,1,1,1,
1,21,0,0,1,5,4,1,1,
1,3,5,21,1,1,1,1,1,
1,1,21,1,0,1,0,3,0,
0,1,0,4,0,5,0,1,21,
1,1,21,1,3,1,0,1,1,
0,0,0,1,0,0,21,0,0,
1,1,21,4,1,1,1,1,0,
6,5,0,0,0,21,0,1,0,
1,1,21,1,1,1,4,1,0,
1,1,0,0,21,1,0,0,0,
1,3,1,4,1,1,21,1,5,
0,0,0,1,1,4,1,0,21,
0,1,0,1,1,1,1,5,21,
1,0,21,1,3,3,1,1,0,
5,21,0,0,1,1,1,3,0,
1,3,4,0,1,1,21,0,0,
1,1,1,21,0,0,0,1,0,
1,1,1,1,1,1,1,6,21,
5,1,1,1,0,21,0,1,0,
1,1,3,6,3,1,0,21,0,
1,1,1,21,6,1,1,0,0,
1,3,1,21,1,1,1,1,0,
1,3,4,21,1,4,1,1,0,
1,1,1,0,0,21,0,0,0,
0,0,21,0,1,1,0,0,1,
0,1,1,1,6,3,5,21,0,
0,5,1,4,1,1,1,1,21,
0,1,1,3,3,1,1,1,21,
0,0,0,0,1,1,1,0,21,
1,4,21,1,0,1,4,1,0,
0,0,0,1,0,0,21,6,0,
1,1,1,1,21,5,1,1,0,
0,21,0,1,0,1,1,5,0,
5,1,21,1,0,1,4,3,1,
1,1,0,1,0,21,0,0,0,
1,1,21,1,1,1,3,1,0,
1,1,0,1,0,21,0,0,0,
6,1,21,1,0,1,3,5,1,
1,5,21,0,0,1,3,1,1,
0,0,0,21,0,4,1,1,1,
0,21,5,1,0,1,1,1,1,
6,21,1,1,0,4,1,1,3,
0,0,1,6,21,1,1,1,1,
0,1,21,0,0,0,1,1,1,
0,0,0,0,0,0,0,0,0,
0,0,0,0,0,0,0,0,0,
0,0,0,0,0,0,0,0,0.
[layer]
type=Tile Layer 2
data=
0,0,208,208,208,208,208,208,208,
206,0,0,0,206,206,206,206,206,
194,194,194,0,194,194,194,194,194,
178,178,0,178,0,178,0,178,0,
0,165,0,165,0,165,0,165,0,
152,152,0,152,152,152,0,152,152,
0,0,0,138,0,0,0,0,0,
173,173,0,173,173,173,173,173,0,
160,160,0,0,0,0,0,160,0,
147,147,0,147,147,147,147,147,0,
134,134,0,0,0,134,0,0,0,
159,159,159,159,159,159,0,159,159,
0,0,0,154,154,154,154,0,0,
0,142,0,142,142,142,142,142,0,
130,0,0,130,130,130,130,130,0,
162,0,0,0,162,162,162,162,0,
149,149,149,0,149,149,0,0,0,
137,137,137,0,0,0,0,137,0,
119,119,119,119,119,119,119,119,0,
156,156,156,156,0,0,0,156,0,
144,144,144,144,144,144,0,0,0,
132,132,132,0,132,132,132,0,0,
121,121,121,0,121,121,121,121,0,
150,150,150,0,150,150,150,150,0,
139,139,139,0,0,0,0,0,0,
0,0,0,0,128,128,0,0,128,
0,116,116,116,116,116,116,0,0,
0,145,145,145,145,145,145,145,0,
0,134,134,134,134,134,134,134,0,
0,0,0,0,123,123,123,0,0,
112,112,0,112,0,112,112,112,0,
0,0,0,139,0,0,0,139,0,
128,128,128,128,0,128,128,128,0,
0,0,0,118,0,118,118,118,0,
108,108,0,108,0,108,108,108,108,
107,107,0,107,0,0,0,0,0,
97,97,0,97,97,97,97,97,0,
96,96,0,96,0,0,0,0,0,
95,95,0,95,0,95,95,95,95,
85,85,0,0,0,85,85,85,85,
0,0,0,0,0,84,84,84,84,
0,0,83,83,0,83,83,83,83,
82,0,82,82,0,82,82,82,82,
0,0,81,81,0,81,81,81,81,
0,80,0,0,0,0,80,80,80,
0,0,0,0,0,0,0,0,0,
0,0,0,0,0,0,0,0,0,
0,0,0,0,0,0,0,0,0.