[layer]
type=Tile Layer 1
data=
1,0,1,0,6,21,0,0,0,
3,1,5,21,1,0,1,5,1,
1,0,1,0,1,0,1,21,0,
1,1,1,1,1,21,1,0,1,
3,1,3,4,0,21,1,0,0,
1,1,5,1,21,0,1,1,0,
1,1,1,0,1,21,0,0,1,
1,5,1,21,0,1,4,0,1,
6,1,1,0,0,6,1,21,0,
1,5,1,0,1,21,0,0,0,
1,1,3,21,1,0,3,1,1,
1,1,21,0,6,0,1,1,1,
0,0,1,0,1,21,1,0,1,
1,0,5,0,1,21,4,0,1,
0,21,1,0,3,0,1,0,1,
3,1,1,21,1,0,1,0,1,
4,0,0,21,1,0,1,0,1,
1,0,1,6,1,21,1,0,6,
0,0,0,0,0,0,0,0,0,
0,0,0,0,0,0,0,0,0,
0,0,0,0,0,0,0,0,0.
[layer]
type=Tile Layer 2
data=
128,0,128,0,128,0,0,0,0,
121,121,121,0,121,0,121,121,121,
125,0,125,0,125,0,125,0,0,
82,82,82,82,82,0,82,0,82,
107,107,107,107,0,0,107,0,0,
98,98,98,98,0,0,98,98,0,
90,90,90,0,90,0,0,0,90,
82,82,82,0,0,82,82,0,82,
81,81,81,0,0,81,81,0,0,
73,73,73,0,73,0,0,0,0,
68,68,68,0,68,0,68,68,68,
71,71,0,0,71,0,71,71,71,
0,0,63,0,63,0,63,0,63,
62,0,62,0,62,0,62,0,62,
0,0,61,0,61,0,61,0,61,
60,60,60,0,60,0,60,0,60,
59,0,0,0,59,0,59,0,59,
58,0,58,58,58,0,58,0,58,
0,0,0,0,0,0,0,0,0,
0,0,0,0,0,0,0,0,0,
0,0,0,0,0,0,0,0,0.