[layer]
type=Tile Layer 1
data=
1,1,5,0,21,0,4,1,1,
1,0,21,1,1,1,1,0,1,
1,3,0,0,1,0,21,0,0,
1,21,3,0,0,0,1,0,0,
0,1,1,1,3,1,1,1,21,
0,0,0,1,1,1,0,0,21,
0,0,0,0,0,0,0,0,0,
0,0,0,0,0,0,0,0,0,
0,0,0,0,0,0,0,0,0.
[layer]
type=Tile Layer 2
data=
33,33,33,0,0,0,33,33,33,
32,0,0,32,32,32,32,0,32,
34,34,0,0,34,0,0,0,0,
33,0,33,0,0,0,33,0,0,
0,29,29,29,29,29,29,29,0,
0,0,0,32,32,32,0,0,0,
0,0,0,0,0,0,0,0,0,
0,0,0,0,0,0,0,0,0,
0,0,0,0,0,0,0,0,0.