[layer]
type=Tile Layer 1
data=
1,21,1,1,1,1,1,1,0,
0,21,1,1,1,1,1,0,0,
1,0,1,0,21,0,0,1,1,
1,1,1,0,21,1,1,1,1,
1,1,1,1,21,0,1,0,0,
1,0,0,21,1,0,1,1,0,
1,21,1,1,1,1,1,0,1,
1,21,1,0,1,0,1,0,1,
1,21,1,1,1,1,1,0,1,
1,0,0,21,1,1,0,0,1,
0,1,21,1,1,1,0,1,0,
0,1,0,0,0,0,21,1,0,
0,0,0,0,0,0,0,0,0,
0,0,0,0,0,0,0,0,0,
0,0,0,0,0,0,0,0,0.
[layer]
type=Tile Layer 2
data=
84,0,84,84,84,84,84,84,0,
0,0,63,63,63,63,63,0,0,
62,0,62,0,0,0,0,62,62,
58,58,58,0,0,58,58,58,58,
54,54,54,54,0,0,54,0,0,
53,0,0,0,53,0,53,53,0,
49,0,49,49,49,49,49,0,49,
51,0,51,0,51,0,51,0,51,
48,0,48,48,48,48,48,0,48,
49,0,0,0,49,49,0,0,49,
0,48,0,48,48,48,0,48,0,
0,47,0,0,0,0,0,47,0,
0,0,0,0,0,0,0,0,0,
0,0,0,0,0,0,0,0,0,
0,0,0,0,0,0,0,0,0.