[layer]
type=Tile Layer 1
data=
0,1,1,1,1,1,1,21,0,
0,1,1,1,1,1,1,1,21,
0,1,1,0,0,0,0,21,0,
1,0,21,0,1,1,1,1,1,
1,0,1,21,0,1,1,1,1,
1,0,1,21,0,1,1,1,1,
1,1,1,21,1,1,1,1,1,
0,0,1,0,0,21,0,0,1,
1,1,1,21,1,1,1,0,1,
0,0,0,21,1,1,1,0,1,
1,1,1,21,1,1,1,1,1,
1,1,1,0,0,0,21,0,1,
1,1,1,21,1,1,1,1,1,
1,1,1,0,1,0,0,21,0,
1,1,1,21,1,1,1,0,1,
1,0,1,21,1,1,1,0,1,
0,21,1,0,1,0,1,0,0,
1,1,1,21,1,0,1,1,1,
0,0,1,21,1,0,1,0,0,
1,0,1,0,1,21,1,0,1,
1,0,21,0,1,0,1,0,0,
1,1,1,1,1,21,1,1,1,
0,0,0,21,1,0,1,0,0,
1,1,1,21,1,0,1,0,1,
1,1,1,21,1,1,1,1,1,
1,21,1,0,0,1,1,0,0,
1,1,21,1,1,1,1,1,1,
1,1,0,1,0,21,0,0,0,
1,1,21,1,0,1,0,1,1,
0,1,0,1,21,1,0,1,1,
0,0,0,0,0,0,0,0,0,
0,0,0,0,0,0,0,0,0,
0,0,0,0,0,0,0,0,0.
[layer]
type=Tile Layer 2
data=
0,166,166,166,166,166,166,0,0,
0,164,164,164,164,164,164,164,0,
0,162,162,0,0,0,0,0,0,
112,0,0,0,112,112,112,112,112,
140,0,140,0,0,140,140,140,140,
129,0,129,0,0,129,129,129,129,
113,113,113,0,113,113,113,113,113,
0,0,108,0,0,0,0,0,108,
134,134,134,0,134,134,134,0,134,
0,0,0,0,124,124,124,0,124,
108,108,108,0,108,108,108,108,108,
103,103,103,0,0,0,0,0,103,
123,123,123,0,123,123,123,123,123,
119,119,119,0,119,0,0,0,0,
109,109,109,0,109,109,109,0,109,
99,0,99,0,99,99,99,0,99,
0,0,123,0,123,0,123,0,0,
113,113,113,0,113,0,113,113,113,
0,0,104,0,104,0,104,0,0,
95,0,95,0,95,0,95,0,95,
94,0,0,0,94,0,94,0,0,
81,81,81,81,81,0,81,81,81,
0,0,0,0,84,0,84,0,0,
83,83,83,0,83,0,83,0,83,
70,70,70,0,70,70,70,70,70,
73,0,73,0,0,73,73,0,0,
69,69,0,69,69,69,69,69,69,
71,71,0,71,0,0,0,0,0,
70,70,0,70,0,70,0,70,70,
0,69,0,69,0,69,0,69,69,
0,0,0,0,0,0,0,0,0,
0,0,0,0,0,0,0,0,0,
0,0,0,0,0,0,0,0,0.