[layer]
type=Tile Layer 1
data=
0,6,21,0,0,0,0,1,0,
1,3,21,1,5,1,0,5,1,
0,1,0,1,1,1,0,1,21,
1,6,1,1,1,1,21,0,0,
6,1,1,0,21,0,0,0,0,
0,0,0,21,3,1,1,1,4,
0,21,4,1,1,1,1,4,1,
1,21,0,1,1,1,5,3,1,
1,1,0,0,21,0,1,1,3,
1,1,1,1,1,21,0,0,1,
6,1,3,21,0,0,0,0,1,
1,1,1,21,1,6,1,5,1,
5,21,1,0,1,1,6,0,1,
6,0,1,21,1,1,1,0,1,
0,0,1,21,1,1,4,0,1,
1,1,1,21,1,4,1,0,3,
0,0,0,0,1,21,0,0,0,
1,6,1,6,1,1,1,21,1,
1,4,4,21,0,0,0,0,6,
1,1,1,1,1,1,1,21,1,
1,1,3,21,1,6,1,0,1,
1,1,0,21,1,0,0,0,1,
5,1,6,21,0,0,0,0,6,
1,1,3,1,21,0,1,1,1,
0,21,3,3,1,1,0,1,1,
5,0,0,0,21,1,0,0,1,
1,1,21,0,0,6,1,0,1,
0,0,0,0,0,0,0,0,0,
0,0,0,0,0,0,0,0,0,
0,0,0,0,0,0,0,0,0.
[layer]
type=Tile Layer 2
data=
0,160,0,0,0,0,0,160,0,
158,158,0,158,158,158,0,158,158,
0,157,0,157,157,157,0,157,0,
117,117,117,117,117,117,0,0,0,
107,107,107,0,0,0,0,0,0,
0,0,0,0,133,133,133,133,133,
0,0,123,123,123,123,123,123,123,
113,0,0,113,113,113,113,113,113,
102,102,0,0,0,0,102,102,102,
128,128,128,128,128,0,0,0,128,
118,118,118,0,0,0,0,0,118,
103,103,103,0,103,103,103,103,103,
98,0,98,0,98,98,98,0,98,
122,0,122,0,122,122,122,0,122,
0,0,112,0,112,112,112,0,112,
103,103,103,0,103,103,103,0,103,
0,0,0,0,94,0,0,0,0,
88,88,88,88,88,88,88,0,88,
84,84,84,0,0,0,0,0,84,
79,79,79,79,79,79,79,0,79,
82,82,82,0,82,82,82,0,82,
73,73,0,0,73,0,0,0,73,
72,72,72,0,0,0,0,0,72,
71,71,71,71,0,0,71,71,71,
0,0,70,70,70,70,0,70,70,
69,0,0,0,0,69,0,0,69,
68,68,0,0,0,68,68,0,68,
0,0,0,0,0,0,0,0,0,
0,0,0,0,0,0,0,0,0,
0,0,0,0,0,0,0,0,0.