[layer]
type=Tile Layer 1
data=
3,21,5,0,3,1,5,1,6,
1,21,1,0,1,1,1,1,1,
1,21,1,0,1,1,1,1,1,
0,0,0,0,21,1,0,0,0,
1,1,21,6,1,1,1,4,1,
1,21,0,0,0,0,5,1,1,
1,21,1,5,1,0,1,1,1,
6,0,1,0,1,0,0,21,0,
1,1,1,21,1,0,1,4,5,
1,6,6,1,0,21,0,1,1,
1,3,1,1,1,0,1,21,0,
4,1,1,1,1,0,0,21,0,
0,0,0,21,0,0,1,1,1,
0,0,1,0,0,0,21,0,0,
1,0,21,0,6,4,1,1,1,
0,1,21,1,1,1,6,1,1,
0,1,21,3,1,1,3,5,1,
0,21,0,1,1,1,6,1,1,
1,1,0,0,0,0,21,1,0,
6,1,1,1,1,1,21,1,0,
6,1,0,1,4,1,21,3,0,
3,1,21,1,1,1,1,1,0,
0,4,0,1,1,1,0,1,21,
0,1,21,3,5,1,0,1,0,
0,1,0,0,0,0,0,1,21,
4,1,21,1,1,1,0,4,6,
0,1,21,1,3,1,0,1,0,
1,0,21,1,1,1,0,1,1,
1,21,1,0,3,1,3,1,1,
1,0,21,0,0,0,1,4,6,
1,1,21,1,1,0,0,0,5,
1,6,21,0,1,1,1,0,1,
1,1,0,21,5,3,0,0,1,
0,0,0,0,0,0,0,0,0,
0,0,0,0,0,0,0,0,0,
0,0,0,0,0,0,0,0,0.
[layer]
type=Tile Layer 2
data=
170,0,170,0,170,170,170,170,170,
169,0,169,0,169,169,169,169,169,
167,0,167,0,167,167,167,167,167,
0,0,0,0,0,146,0,0,0,
128,128,0,128,128,128,128,128,128,
123,0,0,0,0,0,123,123,123,
112,0,112,112,112,0,112,112,112,
140,0,140,0,140,0,0,0,0,
129,129,129,0,129,0,129,129,129,
118,118,118,118,0,0,0,118,118,
108,108,108,108,108,0,108,0,0,
134,134,134,134,134,0,0,0,0,
0,0,0,0,0,0,124,124,124,
0,0,114,0,0,0,0,0,0,
103,0,0,0,103,103,103,103,103,
0,129,0,129,129,129,129,129,129,
0,119,0,119,119,119,119,119,119,
0,0,0,109,109,109,109,109,109,
99,99,0,0,0,0,0,99,0,
123,123,123,123,123,123,0,123,0,
113,113,0,113,113,113,0,113,0,
104,104,0,104,104,104,104,104,0,
0,95,0,95,95,95,0,95,0,
0,94,0,94,94,94,0,94,0,
0,85,0,0,0,0,0,85,0,
84,84,0,84,84,84,0,84,84,
0,83,0,83,83,83,0,83,0,
74,0,0,74,74,74,0,74,74,
73,0,73,0,73,73,73,73,73,
72,0,0,0,0,0,72,72,72,
71,71,0,71,71,0,0,0,71,
70,70,0,0,70,70,70,0,70,
69,69,0,0,69,69,0,0,69,
0,0,0,0,0,0,0,0,0,
0,0,0,0,0,0,0,0,0,
0,0,0,0,0,0,0,0,0.