[layer]
type=Tile Layer 1
data=
0,21,0,0,1,0,1,1,1,
1,1,1,1,1,21,1,1,1,
0,0,21,0,0,0,1,1,1,
1,1,1,1,1,21,1,1,1,
1,1,1,1,1,0,1,21,0,
1,1,1,1,1,21,1,1,1,
0,0,1,0,21,0,1,1,1,
21,1,1,1,1,1,1,1,1,
0,0,1,1,1,21,1,1,1,
1,1,1,1,21,1,1,1,0,
1,1,1,1,21,0,1,0,0,
1,0,0,21,0,0,0,0,1,
1,0,0,1,1,21,0,1,1,
1,1,21,1,1,0,0,1,1,
1,1,0,21,1,1,0,0,1,
0,0,0,0,1,1,1,21,1,
0,1,1,1,1,1,1,21,1,
0,0,0,0,21,0,1,0,1,
1,1,1,1,1,21,1,1,1,
1,1,1,1,1,21,1,1,1,
1,1,1,1,1,21,1,1,1,
0,0,0,21,0,0,0,0,1,
1,1,1,21,1,1,1,1,1,
1,1,1,0,1,0,21,0,1,
1,1,1,1,1,21,1,1,1,
1,0,0,0,21,0,1,1,1,
1,1,1,1,1,21,1,1,1,
1,21,1,1,1,1,1,0,1,
1,21,1,1,1,1,1,1,1,
1,21,1,1,1,1,1,0,1,
1,21,1,1,1,1,1,0,1,
0,21,0,0,0,0,0,0,1,
1,1,1,1,1,21,1,1,1,
1,0,1,1,1,21,1,0,0,
1,21,1,1,1,0,1,1,1,
0,0,1,1,1,21,1,1,1,
0,0,0,0,1,1,21,0,0,
1,1,1,21,1,1,1,1,0,
1,1,1,0,0,0,21,0,1,
1,1,0,1,1,1,1,21,0,
1,21,0,0,0,0,0,0,0,
0,21,1,0,1,1,1,1,1,
1,21,1,0,0,0,1,1,1,
0,1,1,1,1,1,1,21,1,
0,0,0,0,0,21,0,0,1,
0,0,0,21,0,0,1,1,1,
1,1,21,1,1,1,1,1,1,
1,21,0,1,1,1,0,0,1,
1,21,1,1,1,1,1,1,1,
0,0,0,21,1,0,1,0,0,
1,1,1,21,1,0,1,1,1,
0,0,0,0,0,0,0,0,0,
0,0,0,0,0,0,0,0,0,
0,0,0,0,0,0,0,0,0.
[layer]
type=Tile Layer 2
data=
0,0,0,0,234,0,234,234,234,
221,221,221,221,221,0,221,221,221,
0,0,0,0,0,0,231,231,231,
166,166,166,166,166,0,166,166,166,
159,159,159,159,159,0,159,0,0,
189,189,189,189,189,0,189,189,189,
0,0,184,0,0,0,184,184,184,
0,161,161,161,161,161,161,161,161,
0,0,155,155,155,0,155,155,155,
193,193,193,193,0,193,193,193,0,
179,179,179,179,0,0,179,0,0,
165,0,0,0,0,0,0,0,165,
150,0,0,150,150,0,0,150,150,
188,188,0,188,188,0,0,188,188,
174,174,0,0,174,174,0,0,174,
0,0,0,0,160,160,160,0,160,
0,146,146,146,146,146,146,0,146,
0,0,0,0,0,0,182,0,182,
160,160,160,160,160,0,160,160,160,
148,148,148,148,148,0,148,148,148,
135,135,135,135,135,0,135,135,135,
0,0,0,0,0,0,0,0,177,
155,155,155,0,155,155,155,155,155,
150,150,150,0,150,0,0,0,150,
131,131,131,131,131,0,131,131,131,
171,0,0,0,0,0,171,171,171,
151,151,151,151,151,0,151,151,151,
145,0,145,145,145,145,145,0,145,
127,0,127,127,127,127,127,127,127,
165,0,165,165,165,165,165,0,165,
153,0,153,153,153,153,153,0,153,
0,0,0,0,0,0,0,0,141,
122,122,122,122,122,0,122,122,122,
160,0,160,160,160,0,160,0,0,
148,0,148,148,148,0,148,148,148,
0,0,136,136,136,0,136,136,136,
0,0,0,0,124,124,0,0,0,
154,154,154,0,154,154,154,154,0,
142,142,142,0,0,0,0,0,142,
131,131,0,131,131,131,131,0,0,
120,0,0,0,0,0,0,0,0,
0,0,119,0,119,119,119,119,119,
108,0,108,0,0,0,108,108,108,
0,107,107,107,107,107,107,0,107,
0,0,0,0,0,0,0,0,106,
0,0,0,0,0,0,95,95,95,
90,90,0,90,90,90,90,90,90,
93,0,0,93,93,93,0,0,93,
88,0,88,88,88,88,88,88,88,
0,0,0,0,91,0,91,0,0,
90,90,90,0,90,0,90,90,90,
0,0,0,0,0,0,0,0,0,
0,0,0,0,0,0,0,0,0,
0,0,0,0,0,0,0,0,0.