[layer]
type=Tile Layer 1
data=
6,1,1,1,1,1,21,3,0,
0,1,1,1,5,1,21,1,0,
21,1,6,1,1,1,1,1,5,
0,1,0,0,21,1,0,0,0,
0,4,0,1,1,1,1,1,21,
0,1,21,1,3,1,4,5,0,
0,1,0,1,1,1,1,6,21,
0,1,21,4,1,1,4,1,0,
1,5,21,1,1,6,1,1,0,
0,0,0,1,0,0,0,21,0,
1,1,4,1,1,1,3,1,21,
0,0,21,0,0,0,0,1,0,
1,21,4,0,5,1,1,1,1,
0,0,21,0,1,0,0,0,1,
6,1,1,1,1,21,1,0,5,
1,0,0,0,0,0,1,21,0,
3,21,1,1,1,1,6,1,1,
0,0,1,0,21,0,0,0,5,
1,1,1,21,1,1,6,0,5,
1,0,0,21,1,0,0,0,6,
1,21,1,1,1,1,3,0,1,
1,1,0,0,1,21,0,5,1,
1,0,21,0,1,0,1,1,1,
1,3,1,21,6,1,0,5,1,
6,3,1,21,3,1,0,1,5,
1,0,21,6,1,0,1,1,1,
0,1,1,1,1,21,1,1,1,
0,6,1,1,0,21,0,1,1,
0,1,5,0,1,4,21,0,0,
0,0,0,1,1,0,0,21,0,
1,0,1,0,21,0,1,4,1,
0,1,1,1,1,6,1,21,1,
1,21,1,1,1,1,1,1,3,
1,1,1,4,21,1,1,1,0,
3,5,1,1,1,1,21,1,0,
3,1,1,1,21,1,1,1,1,
0,0,0,0,0,0,0,0,0,
0,0,0,0,0,0,0,0,0,
0,0,0,0,0,0,0,0,0.
[layer]
type=Tile Layer 2
data=
176,176,176,176,176,176,0,176,0,
0,175,175,175,175,175,0,175,0,
0,165,165,165,165,165,165,165,165,
0,140,0,0,0,140,0,0,0,
0,129,0,129,129,129,129,129,0,
0,118,0,118,118,118,118,118,0,
0,147,0,147,147,147,147,147,0,
0,135,0,135,135,135,135,135,0,
124,124,0,124,124,124,124,124,0,
0,0,0,113,0,0,0,0,0,
134,134,134,134,134,134,134,134,0,
0,0,0,0,0,0,0,130,0,
119,0,119,0,119,119,119,119,119,
0,0,0,0,109,0,0,0,109,
135,135,135,135,135,0,135,0,135,
125,0,0,0,0,0,125,0,0,
109,0,109,109,109,109,109,109,109,
0,0,104,0,0,0,0,0,104,
130,130,130,0,130,130,130,0,130,
120,0,0,0,120,0,0,0,120,
110,0,110,110,110,110,110,0,110,
100,100,0,0,100,0,0,100,100,
124,0,0,0,124,0,124,124,124,
114,114,114,0,114,114,0,114,114,
105,105,105,0,105,105,0,105,105,
96,0,0,96,96,0,96,96,96,
0,95,95,95,95,0,95,95,95,
0,86,86,86,0,0,0,86,86,
0,85,85,0,85,85,0,0,0,
0,0,0,84,84,0,0,0,0,
75,0,60,0,0,0,3,75,75,
0,59,59,59,74,59,3,0,74,
3,0,3,3,3,58,58,3,58,
72,58,58,58,0,3,3,3,0,
71,71,57,71,71,71,0,71,0,
70,56,56,56,0,56,3,56,70,
0,0,0,0,0,0,0,0,0,
0,0,0,0,0,0,0,0,0,
0,0,0,0,0,0,0,0,0.