[layer]
type=Tile Layer 1
data=
1,1,1,21,1,1,1,1,1,
2,21,2,18,2,2,2,2,2,
1,21,2,0,2,1,1,1,1,
1,21,2,24,2,1,1,1,1,
1,21,1,0,1,1,1,1,1,
0,0,0,0,1,0,21,0,0,
1,1,1,21,1,1,1,1,1,
0,0,1,21,1,1,1,1,1,
1,2,2,21,1,1,1,1,1,
1,19,2,1,21,0,0,0,0,
1,2,2,1,21,1,1,1,0,
1,1,1,1,0,1,21,1,0,
2,2,2,2,0,2,21,2,18,
1,0,0,0,0,21,0,1,0,
1,0,1,1,1,21,1,1,0,
2,0,21,0,2,0,0,18,0,
0,0,1,21,0,1,1,0,1,
0,1,1,1,0,21,0,0,1,
0,21,0,0,0,0,0,0,1,
1,21,1,1,1,2,19,0,1,
1,21,1,1,1,2,2,0,0,
1,21,1,1,1,1,1,0,1,
2,18,2,0,0,0,2,21,0,
1,21,1,0,1,1,1,1,1,
1,21,1,0,1,1,1,1,1,
1,21,1,1,1,1,1,1,1,
2,18,21,0,2,2,2,2,2,
1,1,2,2,2,1,21,1,1,
0,1,2,19,2,1,0,21,0,
1,2,2,2,2,1,21,1,1,
0,2,19,2,1,1,21,1,1,
0,2,2,2,1,1,21,1,1,
0,0,0,21,0,2,18,0,0,
1,1,1,1,21,2,2,2,1,
0,1,1,1,21,2,19,2,1,
0,1,1,1,1,2,21,2,1,
0,21,1,1,1,1,0,1,1,
1,0,21,1,1,1,0,0,1,
1,1,21,1,1,1,1,0,1,
0,0,1,1,21,0,1,0,1,
0,1,21,1,1,0,0,0,1,
0,0,0,1,1,21,1,1,1,
1,0,2,1,0,21,1,1,0,
0,24,2,1,1,0,0,21,0,
0,0,1,1,21,0,1,1,1,
1,1,1,21,0,0,0,0,1,
1,1,1,21,2,2,2,1,1,
1,1,1,0,0,19,21,0,1,
2,2,1,1,2,2,2,21,1,
24,0,21,0,1,1,1,0,1,
1,1,1,1,1,1,1,21,1,
0,0,0,0,0,0,0,0,0,
0,0,0,0,0,0,0,0,0,
0,0,0,0,0,0,0,0,0.
[layer]
type=Tile Layer 2
data=
223,223,223,0,223,223,223,223,223,
233,0,233,0,233,233,233,233,233,
231,0,231,0,231,231,231,231,231,
174,0,174,0,174,174,174,174,174,
159,0,159,0,159,159,159,159,159,
0,0,0,0,199,0,0,0,0,
175,175,175,0,175,175,175,175,175,
0,0,169,0,169,169,169,169,169,
147,147,147,0,147,147,147,147,147,
193,0,193,193,0,0,0,0,0,
179,179,179,179,0,179,179,179,0,
165,165,165,165,0,165,0,165,0,
150,150,150,150,0,150,0,150,0,
188,0,0,0,0,0,0,188,0,
174,0,174,174,174,0,174,174,0,
160,0,0,0,160,0,0,0,0,
0,0,146,0,0,146,146,0,146,
0,182,182,182,0,0,0,0,182,
0,0,0,0,0,0,0,0,168,
155,0,155,155,155,155,0,0,155,
142,0,142,142,142,142,142,0,0,
177,0,177,177,177,177,177,0,177,
163,0,163,0,0,0,163,0,0,
150,0,150,0,150,150,150,150,150,
137,0,137,0,137,137,137,137,137,
163,0,163,163,163,163,163,163,163,
158,0,0,0,158,158,158,158,158,
138,138,138,138,138,138,0,138,138,
0,133,133,0,133,133,0,0,0,
157,157,157,157,157,157,0,157,157,
0,153,0,153,153,153,0,153,153,
0,141,141,141,141,141,0,141,141,
0,0,0,0,0,128,0,0,0,
152,152,152,152,0,152,152,152,152,
0,148,148,148,0,148,0,148,148,
0,136,136,136,136,136,0,136,136,
0,0,124,124,124,124,0,124,124,
154,0,0,154,154,154,0,0,154,
142,142,0,142,142,142,142,0,142,
0,0,131,131,0,0,131,0,131,
0,120,0,120,120,0,0,0,120,
0,0,0,119,119,0,119,119,119,
108,0,108,108,0,0,108,108,0,
0,0,107,107,107,0,0,0,0,
0,0,106,106,0,0,106,106,106,
95,95,95,0,0,0,0,0,95,
90,90,90,0,90,90,90,90,90,
93,93,93,0,0,0,0,0,93,
88,88,88,88,88,88,88,0,88,
0,0,0,0,91,91,91,0,91,
86,86,86,86,86,86,86,0,86,
0,0,0,0,0,0,0,0,0,
0,0,0,0,0,0,0,0,0,
0,0,0,0,0,0,0,0,0.