[layer]
type=Tile Layer 1
data=
3,1,1,1,5,21,0,0,0,
1,1,3,1,1,1,21,0,1,
1,1,1,6,1,6,21,0,1,
1,1,1,1,0,0,0,21,0,
1,0,0,0,21,3,1,4,0,
5,0,1,1,1,1,3,21,0,
0,1,0,1,1,6,1,1,21,
1,3,21,1,5,5,1,1,0,
0,1,21,1,0,0,0,0,0,
1,1,21,1,1,1,1,1,0,
0,0,0,0,0,3,21,1,0,
0,1,21,4,1,4,6,1,0,
0,1,21,1,4,1,1,1,0,
5,6,21,6,1,1,1,1,0,
0,1,0,0,0,1,0,0,21,
0,0,0,0,1,1,5,0,21,
0,6,1,1,0,21,0,1,0,
0,0,21,1,1,1,1,3,0,
0,21,1,1,4,1,1,1,0,
0,1,0,1,5,21,1,0,1,
0,5,1,0,0,1,21,3,1,
0,0,0,0,0,0,0,0,0,
0,0,0,0,0,0,0,0,0,
0,0,0,0,0,0,0,0,0.
[layer]
type=Tile Layer 2
data=
133,133,133,133,133,0,0,0,0,
125,125,125,125,125,125,0,0,125,
124,124,124,124,124,124,0,0,124,
113,113,113,113,0,0,0,0,0,
104,0,0,0,0,104,104,104,0,
95,0,95,95,95,95,95,0,0,
0,86,0,86,86,86,86,86,0,
102,102,0,102,102,102,102,102,0,
0,98,0,98,0,0,0,0,0,
86,86,0,86,86,86,86,86,0,
0,0,0,0,0,82,0,82,0,
0,81,0,81,81,81,81,81,0,
0,73,0,73,73,73,73,73,0,
68,68,0,68,68,68,68,68,0,
0,71,0,0,0,71,0,0,0,
0,0,0,0,63,63,63,0,0,
0,62,62,62,0,0,0,62,0,
0,0,0,61,61,61,61,61,0,
0,0,60,60,60,60,60,60,0,
0,59,0,59,59,0,59,0,59,
0,58,58,0,0,58,0,58,58,
0,0,0,0,0,0,0,0,0,
0,0,0,0,0,0,0,0,0,
0,0,0,0,0,0,0,0,0.