[layer]
type=Tile Layer 1
data=
1,1,1,0,21,1,0,0,0,
1,1,1,1,21,1,0,1,1,
1,1,1,0,21,1,1,0,1,
1,1,1,1,1,1,1,1,21,
1,1,21,0,0,0,0,0,0,
1,1,21,0,1,1,1,1,0,
1,21,0,1,1,1,1,1,1,
1,1,21,1,1,1,1,1,1,
1,21,0,1,1,1,1,1,1,
1,0,0,0,0,0,21,0,0,
1,1,1,1,1,1,1,1,21,
1,1,0,0,0,21,0,0,0,
1,1,21,0,1,1,1,1,1,
1,1,1,0,0,0,21,0,0,
1,1,1,1,1,1,1,1,21,
1,1,1,1,1,1,21,1,1,
0,0,0,0,1,0,21,0,1,
1,1,1,21,1,0,1,1,1,
1,0,0,0,0,0,1,21,0,
1,1,1,1,1,1,1,21,1,
0,0,0,21,0,0,0,0,1,
1,1,1,1,1,1,21,0,1,
1,0,0,0,1,21,0,0,0,
1,0,1,21,1,0,1,0,1,
1,1,1,1,1,1,1,21,1,
0,0,1,1,1,1,1,21,1,
1,21,1,1,1,1,1,0,1,
0,0,1,0,0,0,0,0,21,
1,1,1,21,1,0,1,1,1,
1,1,1,21,1,0,1,1,1,
1,1,1,21,1,0,1,1,1,
1,1,1,0,1,0,1,21,0,
1,1,1,21,1,1,1,0,1,
0,1,0,1,1,1,1,1,21,
0,1,21,1,1,1,1,1,0,
0,1,0,1,1,1,1,1,21,
0,1,0,1,1,1,1,1,21,
0,1,0,1,1,1,1,1,21,
0,1,0,1,0,21,0,0,0,
0,0,0,0,0,0,0,0,0,
0,0,0,0,0,0,0,0,0,
0,0,0,0,0,0,0,0,0.
[layer]
type=Tile Layer 2
data=
197,197,197,0,0,197,0,0,0,
195,195,195,195,0,195,0,195,195,
194,194,194,0,0,194,194,0,194,
139,139,139,139,139,139,139,139,0,
133,133,0,0,0,0,0,0,0,
166,166,0,0,166,166,166,166,0,
153,0,0,153,153,153,153,153,153,
134,134,0,134,134,134,134,134,134,
129,0,0,129,129,129,129,129,129,
161,0,0,0,0,0,0,0,0,
141,141,141,141,141,141,141,141,0,
136,136,0,0,0,0,0,0,0,
124,124,0,0,124,124,124,124,124,
155,155,155,0,0,0,0,0,0,
136,136,136,136,136,136,136,136,0,
125,125,125,125,125,125,0,125,125,
0,0,0,0,120,0,0,0,120,
149,149,149,0,149,0,149,149,149,
138,0,0,0,0,0,138,0,0,
121,121,121,121,121,121,121,0,121,
0,0,0,0,0,0,0,0,115,
144,144,144,144,144,144,0,0,144,
133,0,0,0,133,0,0,0,0,
122,0,122,0,122,0,122,0,122,
106,106,106,106,106,106,106,0,106,
0,0,138,138,138,138,138,0,138,
127,0,127,127,127,127,127,0,127,
0,0,117,0,0,0,0,0,0,
107,107,107,0,107,0,107,107,107,
106,106,106,0,106,0,106,106,106,
96,96,96,0,96,0,96,96,96,
95,95,95,0,95,0,95,0,0,
94,94,94,0,94,94,94,0,94,
0,84,0,84,84,84,84,84,0,
0,83,0,83,83,83,83,83,0,
0,82,0,82,82,82,82,82,0,
0,81,0,81,81,81,81,81,0,
0,80,0,80,80,80,80,80,0,
0,79,0,79,0,0,0,0,0,
0,0,0,0,0,0,0,0,0,
0,0,0,0,0,0,0,0,0,
0,0,0,0,0,0,0,0,0.