[layer]
type=Tile Layer 1
data=
1,1,0,0,0,21,1,1,0,
1,21,1,1,2,2,2,1,1,
1,21,0,1,2,10,2,1,1,
1,1,1,21,2,2,0,1,1,
1,1,1,0,0,1,21,0,0,
2,2,1,1,0,0,0,21,0,
8,2,1,1,21,0,1,1,1,
2,2,1,1,21,0,1,1,1,
1,1,1,1,21,0,0,0,0,
1,1,1,1,2,2,2,1,21,
1,1,1,1,2,8,21,0,2,
0,0,0,2,2,0,21,2,10,
0,21,2,10,2,1,1,2,2,
1,0,2,21,2,0,0,0,0,
1,1,1,1,1,1,1,1,21,
1,21,1,0,1,1,1,0,1,
0,0,1,21,1,0,0,0,0,
1,1,1,21,1,0,1,1,1,
0,0,1,0,1,21,1,0,1,
1,0,1,21,1,0,1,0,1,
1,0,1,0,2,21,2,0,1,
2,2,2,21,2,9,2,0,2,
1,0,1,0,21,0,2,0,1,
1,21,1,1,1,0,1,1,1,
1,1,1,21,1,1,1,1,1,
1,1,1,21,2,2,2,1,1,
0,0,21,0,2,10,2,2,1,
1,1,1,21,2,2,10,2,1,
7,21,2,2,2,2,2,2,0,
7,2,2,2,2,2,2,21,2,
0,0,21,0,0,0,0,0,1,
1,2,2,1,1,1,1,21,1,
1,8,2,1,1,0,21,0,0,
0,2,2,1,2,2,21,0,0,
0,1,1,1,2,8,21,1,1,
0,0,0,1,2,2,0,21,0,
1,1,21,1,0,1,1,1,0,
1,1,0,1,21,1,1,1,0,
1,1,21,1,1,1,1,1,0,
0,0,0,0,0,0,0,0,0,
0,0,0,0,0,0,0,0,0,
0,0,0,0,0,0,0,0,0.
[layer]
type=Tile Layer 2
data=
197,197,0,0,0,0,197,197,0,
186,0,186,186,186,186,186,186,186,
194,0,0,194,194,194,194,194,194,
146,146,146,0,146,146,0,146,146,
133,133,133,0,0,133,0,0,0,
166,166,166,166,0,0,0,0,0,
153,153,153,153,0,0,153,153,153,
141,141,141,141,0,0,141,141,141,
129,129,129,129,0,0,0,0,0,
153,153,153,153,153,153,153,153,0,
148,148,148,148,148,148,0,0,148,
0,0,0,136,136,0,0,136,136,
0,0,124,124,124,124,124,124,124,
155,0,155,0,155,0,0,0,0,
136,136,136,136,136,136,136,136,0,
131,0,131,0,131,131,131,0,131,
0,0,120,0,120,0,0,0,0,
149,149,149,0,149,0,149,149,149,
0,0,138,0,138,0,138,0,138,
127,0,127,0,127,0,127,0,127,
115,0,115,0,115,0,115,0,115,
144,144,144,0,144,144,144,0,144,
133,0,133,0,0,0,133,0,133,
122,0,122,122,122,0,122,122,122,
106,106,106,0,106,106,106,106,106,
132,132,132,0,132,132,132,132,132,
0,0,0,0,127,127,127,127,127,
117,117,117,0,117,117,117,117,117,
107,0,107,107,107,107,107,107,0,
106,106,106,106,106,106,106,0,106,
0,0,0,0,0,0,0,0,96,
90,90,90,90,90,90,90,0,90,
94,94,94,94,94,0,0,0,0,
0,84,84,84,84,84,0,0,0,
0,83,83,83,83,83,0,83,83,
0,0,0,82,82,82,0,0,0,
81,81,0,81,0,81,81,81,0,
80,80,0,80,0,80,80,80,0,
79,79,0,79,79,79,79,79,0,
0,0,0,0,0,0,0,0,0,
0,0,0,0,0,0,0,0,0,
0,0,0,0,0,0,0,0,0.