[layer]
type=Tile Layer 1
data=
1,1,21,0,0,0,19,2,3,
1,1,21,1,5,2,2,2,1,
1,1,21,0,4,2,2,2,1,
4,1,1,21,1,2,19,2,6,
1,6,5,21,0,2,2,2,1,
1,1,1,1,21,0,1,1,1,
1,0,0,0,21,0,6,1,1,
2,18,0,0,0,0,0,21,0,
1,1,1,1,5,1,1,3,21,
0,21,0,1,0,1,1,1,1,
3,1,3,1,21,1,1,1,5,
0,0,0,21,1,4,0,0,0,
0,1,1,1,21,1,1,1,0,
0,2,1,1,21,0,0,1,0,
24,2,4,6,3,1,1,3,21,
0,1,0,0,0,0,0,0,21,
21,1,1,1,1,1,1,1,4,
0,0,0,0,21,0,0,5,0,
6,1,1,3,1,1,21,0,0,
0,0,0,0,21,0,0,1,1,
0,1,1,0,1,3,21,1,5,
0,1,1,21,1,1,0,1,1,
4,0,1,5,21,0,0,0,0,
4,3,1,1,1,1,1,21,0,
6,5,1,1,1,1,1,21,0,
1,3,1,3,1,5,21,0,0,
1,1,1,1,2,2,21,1,1,
1,0,0,0,21,24,2,1,1,
1,1,21,0,0,5,1,4,1,
2,2,21,18,0,2,2,2,2,
1,1,0,0,0,21,0,2,3,
2,2,21,2,2,0,20,2,2,
1,1,21,0,0,0,2,2,5,
0,0,21,0,24,2,4,3,1,
0,21,0,1,2,2,2,1,1,
0,0,21,1,2,19,2,1,1,
0,1,21,1,2,2,2,1,3,
0,2,0,0,21,0,0,0,18,
0,1,21,1,6,1,1,1,0,
0,1,0,0,0,0,0,1,21,
21,1,1,3,5,1,2,2,1,
0,2,21,2,2,2,0,20,2,
1,1,21,4,1,1,2,2,0,
5,5,21,1,0,0,0,1,0,
1,1,0,1,21,1,1,6,0,
1,1,2,0,21,0,0,4,1,
1,21,0,19,2,0,2,2,6,
1,21,2,2,2,0,2,19,1,
1,0,0,0,21,0,2,2,1,
3,0,6,1,5,21,0,1,1,
1,21,6,1,1,1,0,1,1,
0,0,0,0,0,0,0,0,0,
0,0,0,0,0,0,0,0,0,
0,0,0,0,0,0,0,0,0.
[layer]
type=Tile Layer 2
data=
234,234,0,0,0,0,0,234,234,
221,221,0,221,221,221,221,221,221,
231,231,0,0,231,231,231,231,231,
174,174,174,0,174,174,0,174,174,
159,159,159,0,0,159,159,159,159,
199,199,199,199,0,0,199,199,199,
184,0,0,0,0,0,184,184,184,
169,0,0,0,0,0,0,0,0,
147,147,147,147,147,147,147,147,0,
0,0,0,193,0,193,193,193,193,
170,170,170,170,0,170,170,170,170,
0,0,0,0,165,165,0,0,0,
0,150,150,150,0,150,150,150,0,
0,188,188,188,0,0,0,188,0,
0,174,174,174,174,174,174,174,0,
0,160,0,0,0,0,0,0,0,
0,139,139,139,139,139,139,139,139,
0,0,0,0,0,0,0,182,0,
168,168,168,168,168,168,0,0,0,
0,0,0,0,0,0,0,155,155,
0,142,142,0,142,142,0,142,142,
0,177,177,0,177,177,0,177,177,
163,0,163,163,0,0,0,0,0,
150,150,150,150,150,150,150,0,0,
137,137,137,137,137,137,137,0,0,
171,171,171,171,171,171,0,0,0,
151,151,151,151,151,151,0,151,151,
145,0,0,0,0,0,145,145,145,
133,133,0,0,0,133,133,133,133,
165,165,0,0,0,165,165,165,165,
153,153,0,0,0,0,0,153,153,
141,141,0,141,141,0,0,141,141,
128,128,0,0,0,0,128,128,128,
0,0,0,0,0,160,160,160,160,
0,0,0,148,148,148,148,148,148,
0,0,0,136,136,0,136,136,136,
0,124,0,124,124,124,124,124,124,
0,154,0,0,0,0,0,0,0,
0,142,0,142,142,142,142,142,0,
0,131,0,0,0,0,0,131,0,
0,114,114,114,114,114,114,114,114,
0,119,0,119,119,119,0,0,119,
108,108,0,108,108,108,108,108,0,
107,107,0,107,0,0,0,107,0,
106,106,0,106,0,106,106,106,0,
95,95,95,0,0,0,0,95,95,
94,0,0,0,94,0,94,94,94,
93,0,93,93,93,0,93,0,93,
92,0,0,0,0,0,92,92,92,
91,0,91,91,91,0,0,91,91,
90,0,90,90,90,90,0,90,90,
0,0,0,0,0,0,0,0,0,
0,0,0,0,0,0,0,0,0,
0,0,0,0,0,0,0,0,0.