[layer]
type=Tile Layer 1
data=
1,1,1,1,1,1,21,0,0,
1,1,1,1,0,0,0,21,0,
1,1,1,1,21,1,1,1,1,
1,1,1,1,1,1,21,0,1,
1,1,1,0,0,0,21,0,1,
1,1,1,21,0,1,0,0,0,
1,1,1,1,21,1,0,1,1,
1,1,1,1,21,1,0,0,1,
1,21,0,0,0,1,1,0,1,
1,0,1,1,1,21,0,1,1,
1,0,0,0,21,1,0,0,1,
1,21,0,1,1,1,1,0,1,
0,0,0,0,21,1,1,1,1,
1,1,1,1,0,21,0,0,1,
1,1,1,1,1,1,1,21,0,
1,1,1,1,1,1,1,1,21,
1,1,1,1,1,1,1,1,21,
1,1,1,0,0,0,21,0,0,
1,21,0,0,1,1,1,1,1,
0,21,1,1,1,1,1,1,1,
21,1,1,1,1,1,1,1,1,
0,21,0,1,1,1,1,1,1,
1,1,0,21,0,0,1,1,1,
1,1,1,1,21,0,1,1,1,
1,1,1,1,0,0,21,0,0,
1,1,1,1,1,0,0,21,0,
1,1,1,21,0,0,1,1,1,
1,1,1,0,21,0,0,1,1,
1,1,1,1,1,21,0,1,1,
1,1,1,1,1,21,1,1,1,
1,1,1,1,1,0,1,21,0,
1,1,1,1,1,21,1,0,0,
1,1,1,1,1,21,1,1,0,
1,1,1,1,21,0,1,1,0,
1,0,21,0,0,1,1,1,0,
0,0,1,1,0,0,0,21,0,
0,1,21,0,0,1,1,1,1,
0,1,1,1,21,0,0,1,1,
1,0,0,21,1,0,0,1,1,
1,21,0,0,1,0,1,0,1,
1,1,1,1,1,21,1,1,1,
1,1,1,1,1,0,21,0,0,
1,1,1,1,1,21,1,1,1,
1,1,1,1,1,21,1,0,1,
1,1,1,1,1,21,1,0,1,
1,21,0,1,0,0,1,1,1,
1,21,1,1,1,1,1,1,1,
0,0,0,1,1,0,1,0,21,
1,1,1,0,1,0,0,21,0,
1,1,1,21,1,1,1,1,1,
0,0,1,0,1,21,1,1,1,
1,1,1,21,1,0,1,1,1,
1,1,1,21,0,0,1,0,0,
1,1,1,21,1,1,1,0,1,
0,0,0,0,0,0,0,0,0,
0,0,0,0,0,0,0,0,0,
0,0,0,0,0,0,0,0,0.
[layer]
type=Tile Layer 2
data=
239,239,239,239,239,239,0,0,0,
237,237,237,237,0,0,0,0,0,
224,224,224,224,0,224,224,224,224,
164,164,164,164,164,164,0,0,164,
205,205,205,0,0,0,0,0,205,
189,189,189,0,0,189,0,0,0,
174,174,174,174,0,174,0,174,174,
159,159,159,159,0,159,0,0,159,
199,0,0,0,0,199,199,0,199,
184,0,184,184,184,0,0,184,184,
169,0,0,0,0,169,0,0,169,
155,0,0,155,155,155,155,0,155,
0,0,0,0,0,193,193,193,193,
179,179,179,179,0,0,0,0,179,
165,165,165,165,165,165,165,0,0,
143,143,143,143,143,143,143,143,0,
179,179,179,179,179,179,179,179,0,
174,174,174,0,0,0,0,0,0,
160,0,0,0,160,160,160,160,160,
0,0,146,146,146,146,146,146,146,
0,173,173,173,173,173,173,173,173,
0,0,0,168,168,168,168,168,168,
155,155,0,0,0,0,155,155,155,
142,142,142,142,0,0,142,142,142,
177,177,177,177,0,0,0,0,0,
163,163,163,163,163,0,0,0,0,
150,150,150,0,0,0,150,150,150,
137,137,137,0,0,0,0,137,137,
171,171,171,171,171,0,0,171,171,
151,151,151,151,151,0,151,151,151,
145,145,145,145,145,0,145,0,0,
133,133,133,133,133,0,133,0,0,
165,165,165,165,165,0,165,165,0,
153,153,153,153,0,0,153,153,0,
141,0,0,0,0,141,141,141,0,
0,0,128,128,0,0,0,0,0,
0,160,0,0,0,160,160,160,160,
0,148,148,148,0,0,0,148,148,
136,0,0,0,136,0,0,136,136,
124,0,0,0,124,0,124,0,124,
147,147,147,147,147,0,147,147,147,
142,142,142,142,142,0,0,0,0,
125,125,125,125,125,0,125,125,125,
120,120,120,120,120,0,120,0,120,
119,119,119,119,119,0,119,0,119,
108,0,0,108,0,0,108,108,108,
102,0,102,102,102,102,102,102,102,
0,0,0,106,106,0,106,0,0,
95,95,95,0,95,0,0,0,0,
90,90,90,0,90,90,90,90,90,
0,0,93,0,93,0,93,93,93,
92,92,92,0,92,0,92,92,92,
91,91,91,0,0,0,91,0,0,
90,90,90,0,90,90,90,0,90,
0,0,0,0,0,0,0,0,0,
0,0,0,0,0,0,0,0,0,
0,0,0,0,0,0,0,0,0.