[layer]
type=Tile Layer 1
data=
1,1,1,1,1,1,1,21,5,
6,0,21,0,2,0,1,0,3,
2,2,2,20,2,21,2,0,2,
0,1,2,2,0,21,0,2,4,
0,1,1,1,1,2,24,21,1,
0,21,0,0,1,3,1,0,5,
3,1,1,21,0,1,4,0,1,
0,0,0,0,21,1,1,1,1,
0,1,0,5,0,0,21,0,1,
18,0,2,2,0,2,2,21,2,
3,0,21,0,1,1,0,6,1,
0,21,0,0,0,0,0,1,1,
18,0,0,0,2,2,2,21,2,
5,1,1,1,1,4,1,21,6,
1,1,1,21,1,4,2,0,1,
2,2,2,21,2,2,2,20,2,
1,1,5,21,0,0,0,0,4,
1,1,1,21,2,24,2,1,1,
2,21,0,0,2,18,2,2,2,
1,21,1,1,1,0,3,1,1,
5,0,6,21,1,0,1,0,0,
0,21,3,0,0,0,0,0,1,
2,21,2,2,2,2,2,20,2,
1,21,5,1,1,1,2,0,1,
1,21,1,3,1,1,1,1,1,
0,0,0,0,1,0,21,0,1,
1,5,3,1,4,21,1,1,1,
1,1,3,1,1,21,6,1,1,
6,1,1,4,1,21,2,2,1,
0,21,0,0,1,0,24,0,0,
0,1,21,1,6,1,1,1,1,
0,2,21,0,18,0,0,0,0,
0,3,1,1,1,3,5,1,21,
0,18,21,0,0,2,2,2,2,
0,1,0,0,21,1,1,1,1,
0,3,21,1,1,2,2,2,5,
1,21,0,0,0,0,24,0,4,
1,0,21,0,0,1,1,0,0,
5,1,1,1,21,0,0,0,0,
1,1,21,6,0,4,0,3,1,
1,1,21,1,0,1,0,1,1,
1,1,0,1,21,6,0,1,1,
0,3,0,1,0,1,0,21,0,
1,1,1,1,21,1,4,1,0,
2,2,2,2,0,2,21,2,18,
0,0,0,0,0,0,0,0,0,
0,0,0,0,0,0,0,0,0,
0,0,0,0,0,0,0,0,0.
[layer]
type=Tile Layer 2
data=
198,198,198,198,198,198,198,0,198,
206,0,0,0,206,0,206,0,206,
204,204,204,0,204,0,204,0,204,
0,178,178,178,0,0,0,178,178,
0,165,165,165,165,165,0,0,165,
0,0,0,0,152,152,152,0,152,
138,138,138,0,0,138,138,0,138,
0,0,0,0,0,173,173,173,173,
0,160,0,160,0,0,0,0,160,
0,0,147,147,0,147,147,0,147,
134,0,0,0,134,134,0,134,134,
0,0,0,0,0,0,0,167,167,
0,0,0,0,154,154,154,0,154,
135,135,135,135,135,135,135,0,135,
130,130,130,0,130,130,130,0,130,
162,162,162,0,162,162,162,0,162,
149,149,149,0,0,0,0,0,149,
137,137,137,0,137,0,137,137,137,
125,0,0,0,125,0,125,125,125,
156,0,156,156,156,0,156,156,156,
144,0,144,0,144,0,144,0,0,
0,0,132,0,0,0,0,0,132,
121,0,121,121,121,121,121,0,121,
150,0,150,150,150,150,150,0,150,
132,0,132,132,132,132,132,132,132,
0,0,0,0,128,0,0,0,128,
111,111,111,111,111,0,111,111,111,
138,138,138,138,138,0,138,138,138,
127,127,127,127,127,0,127,127,127,
0,0,0,0,123,0,0,0,0,
0,112,0,112,112,112,112,112,112,
0,139,0,0,0,0,0,0,0,
0,128,128,128,128,128,128,128,0,
0,0,0,0,0,118,118,118,118,
0,108,0,0,0,108,108,108,108,
0,107,0,107,107,107,107,107,107,
97,0,0,0,0,0,0,0,97,
96,0,0,0,0,96,96,0,0,
95,95,95,95,0,0,0,0,0,
85,85,0,85,0,85,0,85,85,
84,84,0,84,0,84,0,84,84,
83,83,0,83,0,83,0,83,83,
0,82,0,82,0,82,0,0,0,
81,81,81,81,0,81,81,81,0,
80,80,80,80,0,80,0,80,0,
0,0,0,0,0,0,0,0,0,
0,0,0,0,0,0,0,0,0,
0,0,0,0,0,0,0,0,0.