[layer]
type=Tile Layer 1
data=
1,21,1,1,1,1,1,0,1,
1,0,0,0,0,21,0,0,1,
1,1,1,1,1,1,21,1,1,
1,1,1,1,1,1,21,1,1,
0,0,0,1,0,1,21,1,0,
1,1,1,1,21,1,1,1,0,
1,1,1,1,0,1,21,0,0,
1,1,1,1,21,1,1,1,0,
1,0,0,0,0,21,0,0,1,
1,1,1,1,1,21,1,0,1,
1,1,1,1,1,21,1,0,1,
1,1,1,1,1,21,1,0,1,
0,0,0,0,0,21,1,0,0,
1,21,1,1,1,1,1,1,1,
1,0,1,1,1,21,0,0,0,
1,21,1,1,1,0,1,1,1,
1,0,1,1,1,21,1,0,0,
1,21,1,1,1,0,1,1,1,
0,0,1,21,1,0,0,0,1,
1,1,1,21,1,1,1,1,1,
0,0,1,21,0,0,1,0,0,
1,0,1,1,1,21,1,0,1,
1,0,0,21,1,0,1,0,1,
1,1,1,0,1,21,1,0,1,
0,0,1,0,21,0,1,0,0,
1,21,1,1,1,1,1,1,1,
1,0,1,21,0,0,1,0,0,
0,1,1,1,1,1,0,0,21,
0,0,1,1,1,21,0,0,0,
0,0,1,1,0,21,1,1,1,
0,1,0,0,21,1,1,1,1,
21,1,1,1,1,1,1,1,1,
0,1,1,1,21,1,1,1,1,
0,0,1,1,21,1,1,1,1,
1,1,0,0,0,0,21,0,1,
1,1,1,1,21,0,0,0,1,
1,1,1,0,0,0,21,0,1,
1,1,1,1,0,21,1,0,1,
1,1,1,0,21,1,1,0,1,
0,0,0,21,1,1,0,0,1,
0,0,1,1,1,1,21,1,1,
1,0,21,1,0,0,0,1,1,
0,0,0,0,0,0,0,0,0,
0,0,0,0,0,0,0,0,0,
0,0,0,0,0,0,0,0,0.
[layer]
type=Tile Layer 2
data=
203,0,203,203,203,203,203,0,203,
201,0,0,0,0,0,0,0,201,
190,190,190,190,190,190,0,190,190,
132,132,132,132,132,132,0,132,132,
0,0,0,173,0,173,0,173,0,
160,160,160,160,0,160,160,160,0,
147,147,147,147,0,147,0,0,0,
134,134,134,134,0,134,134,134,0,
167,0,0,0,0,0,0,0,167,
154,154,154,154,154,0,154,0,154,
142,142,142,142,142,0,142,0,142,
130,130,130,130,130,0,130,0,130,
0,0,0,0,0,0,162,0,0,
142,0,142,142,142,142,142,142,142,
137,0,137,137,137,0,0,0,0,
125,0,125,125,125,0,125,125,125,
156,0,156,156,156,0,156,0,0,
144,0,144,144,144,0,144,144,144,
0,0,132,0,132,0,0,0,132,
115,115,115,0,115,115,115,115,115,
0,0,150,0,0,0,150,0,0,
139,0,139,139,139,0,139,0,139,
128,0,0,0,128,0,128,0,128,
116,116,116,0,116,0,116,0,116,
0,0,145,0,0,0,145,0,0,
127,0,127,127,127,127,127,127,127,
123,0,123,0,0,0,123,0,0,
0,112,112,112,112,112,0,0,0,
0,0,139,139,139,0,0,0,0,
0,0,128,128,0,0,128,128,128,
0,118,0,0,0,118,118,118,118,
0,103,103,103,103,103,103,103,103,
0,107,107,107,0,107,107,107,107,
0,0,97,97,0,97,97,97,97,
96,96,0,0,0,0,0,0,96,
95,95,95,95,0,0,0,0,95,
85,85,85,0,0,0,0,0,85,
84,84,84,84,0,0,84,0,84,
83,83,83,0,0,83,83,0,83,
0,0,0,0,82,82,0,0,82,
0,0,81,81,81,81,0,81,81,
80,0,0,80,0,0,0,80,80,
0,0,0,0,0,0,0,0,0,
0,0,0,0,0,0,0,0,0,
0,0,0,0,0,0,0,0,0.