[layer]
type=Tile Layer 1
data=
2,2,2,21,2,0,2,20,2,
1,1,1,21,0,0,2,0,0,
5,1,1,21,1,4,1,2,2,
0,2,2,21,2,2,2,2,9,
2,2,2,21,2,2,2,2,7,
1,1,1,21,4,6,1,0,1,
1,1,5,1,1,5,1,21,1,
1,0,21,0,0,0,4,0,1,
1,21,1,4,1,1,1,1,3,
1,1,21,6,1,5,4,6,0,
0,1,21,1,1,1,1,1,0,
1,1,21,2,2,1,1,1,0,
2,2,21,20,0,0,2,0,0,
1,1,21,2,2,1,3,5,1,
0,0,0,1,0,0,2,2,21,
1,6,21,2,2,2,10,2,0,
0,1,21,10,2,2,2,2,0,
0,1,2,2,0,1,2,8,21,
1,21,6,1,3,1,2,0,1,
0,0,1,0,21,0,1,0,1,
1,1,1,21,5,0,1,0,3,
2,2,7,21,2,2,2,0,2,
1,0,1,21,1,0,1,0,4,
1,0,1,0,1,21,1,0,3,
2,2,2,21,2,2,2,0,7,
0,2,0,0,2,21,1,0,1,
10,2,2,2,19,21,2,18,2,
24,2,2,2,2,21,0,1,1,
0,2,2,9,2,2,21,2,2,
0,1,2,2,2,4,0,21,0,
0,0,2,2,2,1,21,1,4,
2,2,2,9,21,2,0,2,2,
0,24,2,2,21,2,2,2,2,
0,2,21,2,2,9,2,2,19,
24,2,0,21,2,2,2,2,2,
0,2,2,21,0,0,0,18,2,
0,2,2,2,2,2,21,2,7,
0,1,0,3,1,1,21,0,0,
18,21,2,2,2,2,2,2,0,
0,2,2,2,20,2,2,0,21,
2,2,2,2,21,2,0,2,9,
1,1,21,0,0,1,5,2,2,
0,0,0,0,0,0,0,0,0,
0,0,0,0,0,0,0,0,0,
0,0,0,0,0,0,0,0,0.
[layer]
type=Tile Layer 2
data=
203,203,203,0,203,0,203,0,203,
201,201,201,0,0,0,201,0,0,
190,190,190,0,190,190,190,190,190,
0,138,138,0,138,138,138,138,138,
173,173,173,0,173,173,173,173,173,
160,160,160,0,160,160,160,0,160,
140,140,140,140,140,140,140,0,140,
134,0,0,0,0,0,134,0,134,
159,0,159,159,159,159,159,159,159,
154,154,0,154,154,154,154,154,0,
0,142,0,142,142,142,142,142,0,
130,130,0,130,130,130,130,130,0,
162,162,0,0,0,0,162,0,0,
142,142,0,142,142,142,142,142,142,
0,0,0,137,0,0,137,137,0,
125,125,0,125,125,125,125,125,0,
0,156,0,156,156,156,156,156,0,
0,144,144,144,0,144,144,144,0,
132,0,132,132,132,132,132,0,132,
0,0,121,0,0,0,121,0,121,
150,150,150,0,150,0,150,0,150,
139,139,139,0,139,139,139,0,139,
128,0,128,0,128,0,128,0,128,
116,0,116,0,116,0,116,0,116,
145,145,145,0,145,145,145,0,145,
0,134,0,0,134,0,134,0,134,
123,123,123,123,0,0,123,0,123,
0,112,112,112,112,0,0,112,112,
0,139,139,139,139,139,0,139,139,
0,128,128,128,128,128,0,0,0,
0,0,118,118,118,118,0,118,118,
108,108,108,108,0,108,0,108,108,
0,0,107,107,0,107,107,107,107,
0,97,0,97,97,97,97,97,0,
0,96,0,0,96,96,96,96,96,
0,95,95,0,0,0,0,0,95,
0,85,85,85,85,85,0,85,85,
0,84,0,84,84,84,0,0,0,
0,0,83,83,83,83,83,83,0,
0,82,82,82,0,82,82,0,0,
81,81,81,81,0,81,0,81,81,
80,80,0,0,0,80,80,80,80,
0,0,0,0,0,0,0,0,0,
0,0,0,0,0,0,0,0,0,
0,0,0,0,0,0,0,0,0.