[layer]
type=Tile Layer 1
data=
1,1,1,1,1,21,0,6,1,
4,1,21,0,0,1,1,0,0,
1,3,21,6,1,1,1,1,0,
1,1,1,0,0,21,1,1,0,
0,1,0,0,5,1,1,0,21,
1,21,1,0,1,1,0,1,4,
1,4,1,1,21,1,3,1,0,
0,1,1,3,5,1,1,21,0,
0,1,1,1,1,21,1,1,0,
1,3,5,1,1,6,4,6,21,
0,1,1,1,1,1,1,1,21,
0,0,3,5,1,1,0,0,21,
0,0,0,0,0,0,0,0,0,
0,0,0,0,0,0,0,0,0,
0,0,0,0,0,0,0,0,0.
[layer]
type=Tile Layer 2
data=
84,84,84,84,84,0,0,84,84,
63,63,0,0,0,63,63,0,0,
59,59,0,59,59,59,59,59,0,
61,61,61,0,0,0,61,61,0,
0,54,0,0,54,54,54,0,0,
53,0,53,0,2,53,0,53,53,
52,52,52,2,0,41,52,52,0,
0,51,2,41,41,2,41,0,0,
0,2,2,40,40,0,2,2,0,
35,35,35,35,35,35,35,35,0,
0,39,2,2,2,2,39,2,0,
0,0,47,47,47,47,0,0,0,
0,0,0,0,0,0,0,0,0,
0,0,0,0,0,0,0,0,0,
0,0,0,0,0,0,0,0,0.