[layer]
type=Tile Layer 1
data=
1,1,1,3,21,1,1,5,1,
1,1,1,1,21,1,4,1,1,
0,0,21,0,0,5,1,3,1,
21,1,3,1,1,1,1,1,1,
0,0,21,0,0,0,1,4,1,
0,0,0,5,1,0,0,21,0,
1,1,6,1,1,21,0,0,0,
1,1,1,21,0,0,3,1,1,
1,1,4,21,1,1,6,1,4,
1,1,3,21,1,1,1,1,6,
0,21,1,0,1,1,1,1,1,
1,21,4,0,1,4,1,1,6,
1,21,1,0,0,0,0,0,0,
1,21,1,1,1,5,3,4,1,
1,0,0,0,0,21,0,0,0,
1,1,4,1,1,1,6,21,1,
0,21,1,1,5,1,1,0,1,
1,21,1,4,5,6,1,1,1,
1,0,0,21,0,0,1,0,1,
1,1,6,1,1,1,1,21,1,
0,0,0,0,0,21,5,0,4,
4,1,1,21,3,0,1,0,1,
6,0,0,21,1,0,1,0,1,
1,0,1,1,1,21,1,0,6,
1,0,21,0,1,0,5,0,0,
1,6,3,21,1,1,1,1,1,
0,0,0,21,1,0,0,0,1,
0,1,0,0,0,4,0,21,0,
0,1,1,1,21,1,1,1,1,
0,0,0,5,0,0,0,21,0,
1,1,1,6,21,1,1,1,1,
0,0,0,21,0,3,3,0,1,
1,1,4,21,1,6,1,1,1,
0,0,0,0,0,0,0,0,0,
0,0,0,0,0,0,0,0,0,
0,0,0,0,0,0,0,0,0.
[layer]
type=Tile Layer 2
data=
162,162,162,162,0,162,162,162,162,
161,161,161,161,0,161,161,161,161,
0,0,0,0,0,167,167,167,167,
0,139,139,139,139,139,139,139,139,
0,0,0,0,0,0,134,134,134,
0,0,0,123,123,0,0,0,0,
112,112,112,112,112,0,0,0,0,
140,140,140,0,0,0,140,140,140,
123,123,123,0,123,123,123,123,123,
113,113,113,0,113,113,113,113,113,
0,0,108,0,108,108,108,108,108,
134,0,134,0,134,134,134,134,134,
124,0,124,0,0,0,0,0,0,
108,0,108,108,108,108,108,108,108,
103,0,0,0,0,0,0,0,0,
123,123,123,123,123,123,123,0,123,
0,0,119,119,119,119,119,0,119,
104,0,104,104,104,104,104,104,104,
99,0,0,0,0,0,99,0,99,
117,117,117,117,117,117,117,0,117,
0,0,0,0,0,0,113,0,113,
104,104,104,0,104,0,104,0,104,
95,0,0,0,95,0,95,0,95,
94,0,94,94,94,0,94,0,94,
85,0,0,0,85,0,85,0,0,
80,80,80,0,80,80,80,80,80,
0,0,0,0,83,0,0,0,83,
0,74,0,0,0,74,0,0,0,
0,73,73,73,0,73,73,73,73,
0,0,0,72,0,0,0,0,0,
68,68,68,68,0,68,68,68,68,
0,0,0,0,0,70,70,0,70,
66,66,66,0,66,66,66,66,66,
0,0,0,0,0,0,0,0,0,
0,0,0,0,0,0,0,0,0,
0,0,0,0,0,0,0,0,0.