[layer]
type=Tile Layer 1
data=
2,2,2,2,2,2,21,2,20,
1,0,21,0,0,1,1,0,0,
1,19,0,1,1,1,1,21,0,
1,2,0,21,0,2,2,1,0,
1,1,1,1,21,24,0,1,0,
1,1,1,1,1,1,21,1,0,
0,21,1,1,1,1,1,1,1,
0,21,1,1,1,1,1,0,1,
9,21,2,2,2,2,2,18,2,
8,2,21,0,0,0,2,2,0,
2,21,2,2,2,2,9,2,2,
0,0,0,0,1,21,2,2,1,
2,21,2,2,2,2,9,18,2,
0,0,1,1,1,2,2,21,1,
1,1,1,1,1,1,1,21,1,
1,0,1,0,1,21,1,0,1,
0,0,1,21,1,0,1,0,1,
1,1,1,0,1,21,1,0,2,
1,0,2,21,1,0,0,2,10,
1,2,8,21,1,0,1,2,2,
1,21,2,2,1,0,2,2,19,
1,0,1,21,1,2,8,2,2,
1,0,2,0,2,21,2,2,0,
1,21,2,24,2,2,2,1,1,
0,2,21,2,20,9,2,2,2,
1,1,21,2,0,2,2,2,1,
1,1,0,1,0,21,19,0,0,
1,2,21,1,0,2,2,2,1,
1,8,0,1,0,21,0,0,0,
1,2,21,1,1,1,1,1,1,
0,0,0,0,0,0,0,0,0,
0,0,0,0,0,0,0,0,0,
0,0,0,0,0,0,0,0,0.
[layer]
type=Tile Layer 2
data=
166,166,166,166,166,166,0,166,0,
164,0,0,0,0,164,164,0,0,
162,0,0,162,162,162,162,0,0,
112,112,0,0,0,112,112,112,0,
140,140,140,140,0,0,0,140,0,
129,129,129,129,129,129,0,129,0,
0,0,118,118,118,118,118,118,118,
0,0,108,108,108,108,108,0,108,
134,0,134,134,134,134,134,0,134,
124,124,0,0,0,0,124,124,0,
114,0,114,114,114,114,114,114,114,
0,0,0,0,103,0,103,103,103,
129,0,129,129,129,129,129,0,129,
0,0,119,119,119,119,119,0,119,
104,104,104,104,104,104,104,0,104,
99,0,99,0,99,0,99,0,99,
0,0,123,0,123,0,123,0,123,
113,113,113,0,113,0,113,0,113,
104,0,104,0,104,0,0,104,104,
95,95,95,0,95,0,95,95,95,
94,0,94,94,94,0,94,94,0,
85,0,85,0,85,85,85,85,85,
84,0,84,0,84,0,84,84,0,
83,0,83,0,83,83,83,83,83,
0,74,0,74,0,74,74,74,74,
73,73,0,73,0,73,73,73,73,
72,72,0,72,0,0,0,0,0,
71,71,0,71,0,71,71,71,71,
70,70,0,70,0,0,0,0,0,
66,66,0,66,66,66,66,66,66,
0,0,0,0,0,0,0,0,0,
0,0,0,0,0,0,0,0,0,
0,0,0,0,0,0,0,0,0.