[layer]
type=Tile Layer 1
data=
1,1,21,1,0,1,1,1,0,
1,4,21,1,0,1,1,2,0,
1,6,5,6,21,1,1,2,24,
0,0,0,0,0,0,21,2,20,
1,1,6,1,1,1,21,2,0,
0,0,21,0,0,1,0,3,0,
0,1,1,1,1,1,21,1,1,
0,1,1,6,1,1,21,1,5,
0,5,1,1,1,6,21,3,1,
1,3,1,1,21,1,1,1,1,
6,1,1,1,0,21,0,0,0,
1,1,6,1,4,1,3,1,21,
2,2,2,2,0,18,21,0,0,
4,6,1,1,21,1,1,1,1,
0,0,21,1,0,0,0,0,0,
1,2,2,2,1,6,4,1,21,
0,21,24,2,0,0,0,1,0,
0,1,1,5,0,1,21,1,1,
1,0,2,21,1,1,1,0,1,
0,0,19,21,1,0,1,0,0,
5,2,2,21,3,0,1,6,1,
0,21,1,0,3,0,1,0,0,
6,0,1,0,1,21,1,0,1,
4,21,0,0,1,0,1,0,0,
1,6,1,4,1,21,1,1,1,
0,0,0,0,2,21,2,0,0,
2,2,2,21,2,20,2,0,2,
0,1,21,1,2,2,2,1,1,
18,2,21,2,2,2,2,2,2,
0,5,1,21,0,1,6,1,1,
0,1,3,1,21,1,0,1,5,
0,0,0,21,0,1,0,0,1,
2,2,2,2,21,2,2,18,2,
1,1,1,0,0,0,21,0,1,
1,1,4,21,3,0,0,0,0,
4,6,1,21,1,1,1,1,0,
2,2,2,0,21,2,0,18,2,
2,2,2,2,21,2,2,20,2,
1,21,1,1,3,6,2,0,1,
0,21,1,0,0,0,0,0,1,
0,3,1,21,1,1,1,1,1,
0,4,1,21,6,1,1,1,3,
0,0,0,0,0,0,0,0,0,
0,0,0,0,0,0,0,0,0,
0,0,0,0,0,0,0,0,0.
[layer]
type=Tile Layer 2
data=
203,203,0,203,0,203,203,203,0,
201,201,0,201,0,201,201,201,0,
200,200,200,200,0,200,200,200,0,
0,0,0,0,0,0,0,138,0,
173,173,173,173,173,173,0,173,0,
0,0,0,0,0,160,0,160,0,
0,147,147,147,147,147,0,147,147,
0,134,134,134,134,134,0,134,134,
0,167,167,167,167,167,0,167,167,
147,147,147,147,0,147,147,147,147,
142,142,142,142,0,0,0,0,0,
123,123,123,123,123,123,123,123,0,
162,162,162,162,0,0,0,0,0,
142,142,142,142,0,142,142,142,142,
0,0,0,137,0,0,0,0,0,
119,119,119,119,119,119,119,119,0,
0,0,0,156,0,0,0,156,0,
0,144,144,144,0,144,0,144,144,
132,0,132,0,132,132,132,0,132,
0,0,0,0,121,0,121,0,0,
150,150,150,0,150,0,150,150,150,
0,0,139,0,139,0,139,0,0,
128,0,128,0,128,0,128,0,128,
116,0,0,0,116,0,116,0,0,
138,138,138,138,138,0,138,138,138,
0,0,0,0,134,0,134,0,0,
123,123,123,0,123,0,123,0,123,
0,112,0,112,112,112,112,112,112,
0,139,0,139,139,139,139,139,139,
0,128,128,0,0,128,128,128,128,
0,118,118,118,0,118,0,118,118,
0,0,0,0,0,108,0,0,108,
107,107,107,107,0,107,107,0,107,
97,97,97,0,0,0,0,0,97,
96,96,96,0,96,0,0,0,0,
95,95,95,0,95,95,95,95,0,
85,85,85,0,0,85,0,0,85,
84,84,84,84,0,84,84,0,84,
83,0,83,83,83,83,83,0,83,
0,0,82,0,0,0,0,0,82,
0,81,81,0,81,81,81,81,81,
0,80,80,0,80,80,80,80,80,
0,0,0,0,0,0,0,0,0,
0,0,0,0,0,0,0,0,0,
0,0,0,0,0,0,0,0,0.