[layer]
type=Tile Layer 1
data=
0,1,1,1,1,4,21,1,1,
0,0,21,0,0,1,0,3,1,
0,1,1,1,6,4,21,1,0,
0,0,1,1,1,0,21,1,0,
21,1,1,1,5,1,1,4,1,
0,0,0,1,0,0,21,0,0,
1,1,21,5,0,1,3,1,0,
1,1,21,4,0,1,1,0,0,
0,1,0,4,21,1,0,1,1,
0,0,1,6,0,0,21,1,1,
0,0,1,21,0,1,4,1,5,
0,1,1,21,1,1,1,1,1,
1,6,1,0,1,0,21,0,0,
3,1,1,0,1,1,5,1,21,
0,0,0,0,1,6,0,1,21,
0,0,0,0,0,0,0,0,0,
0,0,0,0,0,0,0,0,0,
0,0,0,0,0,0,0,0,0.
[layer]
type=Tile Layer 2
data=
0,102,102,102,102,102,0,102,102,
0,0,0,0,0,84,0,84,84,
0,83,83,83,83,83,0,83,0,
0,0,82,82,82,0,0,82,0,
0,66,66,66,66,66,66,66,66,
0,0,0,73,0,0,0,0,0,
72,72,0,72,0,72,72,72,0,
64,64,0,64,0,64,64,0,0,
0,63,0,63,0,63,0,63,63,
0,0,62,62,0,0,0,62,62,
0,0,61,0,0,61,61,61,61,
0,57,57,0,57,57,57,57,57,
59,59,59,0,59,0,0,0,0,
56,56,56,0,56,56,56,56,0,
0,0,0,0,57,57,0,57,0,
0,0,0,0,0,0,0,0,0,
0,0,0,0,0,0,0,0,0,
0,0,0,0,0,0,0,0,0.