[layer]
type=Tile Layer 1
data=
0,21,1,1,6,1,1,1,0,
0,0,0,1,1,1,0,0,21,
1,6,21,1,1,5,0,4,0,
1,6,1,21,0,0,0,0,1,
4,1,21,1,5,1,1,0,1,
1,6,0,0,0,21,0,0,1,
0,1,1,1,1,1,21,1,0,
0,5,1,1,1,3,0,1,21,
0,3,0,0,0,1,21,4,0,
0,1,21,4,1,5,1,1,1,
0,1,21,4,0,1,6,5,1,
1,1,21,1,0,1,1,1,1,
0,6,0,0,0,0,0,0,21,
0,1,21,5,1,1,1,1,1,
0,1,21,1,1,4,0,1,0,
1,21,1,1,1,4,5,0,1,
0,1,1,1,1,1,5,1,21,
0,21,1,0,0,0,6,0,0,
0,0,1,6,21,3,1,0,0,
0,0,0,0,1,0,0,0,21,
0,1,1,1,21,1,1,5,0,
0,0,0,0,0,0,0,0,0,
0,0,0,0,0,0,0,0,0,
0,0,0,0,0,0,0,0,0.
[layer]
type=Tile Layer 2
data=
0,0,133,133,133,133,133,133,0,
0,0,0,132,132,132,0,0,0,
130,130,0,130,130,130,0,130,0,
113,113,113,0,0,0,0,0,113,
99,99,0,99,99,99,99,0,99,
95,95,0,0,0,0,0,0,95,
0,86,86,86,86,86,0,86,0,
0,107,107,107,107,107,0,107,0,
0,98,0,0,0,98,0,98,0,
0,86,0,86,86,86,86,86,86,
0,82,0,82,0,82,82,82,82,
77,77,0,77,0,77,77,77,77,
0,73,0,0,0,0,0,0,0,
0,68,0,68,68,68,68,68,68,
0,71,0,71,71,71,0,71,0,
60,0,60,60,60,60,60,0,60,
0,59,59,59,59,59,59,59,0,
0,0,61,0,0,0,61,0,0,
0,0,60,60,0,60,60,0,0,
0,0,0,0,59,0,0,0,0,
0,58,58,58,0,58,58,58,0,
0,0,0,0,0,0,0,0,0,
0,0,0,0,0,0,0,0,0,
0,0,0,0,0,0,0,0,0.