[layer]
type=Tile Layer 1
data=
1,1,0,0,0,0,21,0,0,
1,1,1,21,1,1,1,1,1,
1,1,1,0,0,21,0,0,0,
1,1,0,21,1,1,0,1,0,
1,1,21,1,1,1,0,0,1,
1,1,21,2,2,2,2,19,1,
1,1,1,2,19,21,0,0,0,
1,1,1,2,2,2,1,1,21,
1,1,1,1,21,0,0,1,0,
1,1,1,1,1,1,21,1,1,
0,21,0,0,0,2,0,2,1,
1,1,1,1,21,2,24,2,1,
0,0,21,1,0,2,0,0,0,
0,2,2,2,21,2,20,2,2,
0,1,0,0,0,2,21,2,1,
1,2,2,1,21,1,1,1,1,
1,19,0,1,21,1,0,0,1,
0,2,0,0,1,0,21,1,0,
1,1,1,1,1,1,1,1,1,
0,1,0,0,1,0,0,1,21,
1,21,0,1,0,1,0,0,1,
0,0,0,0,0,0,0,0,0,
0,0,0,0,0,0,0,0,0,
0,0,0,0,0,0,0,0,0.
[layer]
type=Tile Layer 2
data=
132,132,0,0,0,0,0,0,0,
117,117,117,0,117,117,117,117,117,
128,128,128,0,0,0,0,0,0,
111,111,0,0,111,111,0,111,0,
102,102,0,102,102,102,0,0,102,
89,89,0,89,89,89,89,0,89,
85,85,85,85,0,0,0,0,0,
95,95,95,95,95,95,95,95,0,
97,97,97,97,0,0,0,97,0,
80,80,80,80,80,80,0,80,80,
0,0,0,0,0,81,0,81,81,
76,76,76,76,0,76,0,76,76,
0,0,0,72,0,72,0,0,0,
0,71,71,71,0,71,0,71,71,
0,70,0,0,0,70,0,70,70,
56,56,56,56,0,56,56,56,56,
61,0,0,61,0,61,0,0,61,
0,60,0,0,60,0,0,60,0,
51,51,51,51,51,51,51,51,51,
0,59,0,0,59,0,0,59,0,
58,0,0,58,0,58,0,0,58,
0,0,0,0,0,0,0,0,0,
0,0,0,0,0,0,0,0,0,
0,0,0,0,0,0,0,0,0.