[layer]
type=Tile Layer 1
data=
0,1,5,21,1,1,1,1,6,
1,4,1,21,1,1,1,1,1,
1,4,1,21,1,1,1,0,0,
5,1,21,1,1,1,1,3,0,
6,0,21,1,1,1,1,0,1,
1,0,1,1,21,1,1,0,3,
1,1,0,0,1,1,6,21,0,
1,1,5,0,1,6,21,0,0,
1,1,1,21,0,0,0,3,1,
0,0,0,1,21,0,1,5,1,
0,0,0,0,21,1,1,1,3,
1,0,21,0,1,6,1,1,0,
6,1,0,0,1,1,1,21,0,
0,1,4,0,1,1,0,0,21,
0,0,3,1,1,0,21,0,0,
0,0,0,0,0,0,0,0,0,
0,0,0,0,0,0,0,0,0,
0,0,0,0,0,0,0,0,0.
[layer]
type=Tile Layer 2
data=
0,123,98,0,6,6,98,123,123,
115,115,92,0,92,5,92,115,115,
119,119,5,0,95,5,5,0,0,
85,85,0,68,68,68,68,85,0,
81,0,0,64,64,64,64,0,81,
80,0,4,64,0,4,4,0,80,
72,72,0,0,72,72,72,0,0,
71,71,71,0,71,71,0,0,0,
70,70,70,0,0,0,0,70,70,
0,0,0,62,0,0,62,62,62,
0,0,0,0,0,61,61,61,61,
60,0,0,0,60,60,60,60,0,
59,59,0,0,59,59,59,0,0,
0,58,58,0,58,58,0,0,0,
0,0,57,57,57,0,0,0,0,
0,0,0,0,0,0,0,0,0,
0,0,0,0,0,0,0,0,0,
0,0,0,0,0,0,0,0,0.