[layer]
type=Tile Layer 1
data=
0,0,3,4,3,5,21,0,3,
4,21,2,2,1,21,3,0,1,
4,2,10,2,5,1,5,1,0,
1,2,2,1,6,1,3,21,0,
1,2,1,1,1,21,1,5,3,
2,2,2,2,21,7,1,2,2,
2,8,2,1,1,21,3,5,0,
1,21,1,1,3,1,1,1,1,
1,6,4,4,21,1,2,3,1,
1,0,5,0,3,21,2,1,0,
0,4,3,21,4,0,2,1,0,
0,21,4,2,2,2,9,2,0,
0,0,0,0,0,0,0,0,0,
0,0,0,0,0,0,0,0,0,
0,0,0,0,0,0,0,0,0.
[layer]
type=Tile Layer 2
data=
0,0,88,88,88,88,0,0,88,
63,0,63,63,63,0,63,0,63,
61,61,61,48,61,3,61,61,0,
61,61,61,3,61,3,61,0,0,
54,54,2,2,2,0,2,54,54,
42,42,42,42,0,42,2,42,42,
52,52,41,52,52,0,41,52,0,
2,0,2,41,51,41,2,2,41,
45,45,45,45,0,45,45,45,45,
49,0,49,0,49,0,49,49,0,
0,48,48,0,48,0,48,48,0,
0,0,47,47,47,47,47,47,0,
0,0,0,0,0,0,0,0,0,
0,0,0,0,0,0,0,0,0,
0,0,0,0,0,0,0,0,0.