[layer]
type=Tile Layer 1
data=
1,21,0,0,1,0,1,0,0,
1,21,1,1,1,1,1,1,1,
1,21,1,1,1,0,1,1,1,
1,21,1,1,1,0,1,1,1,
0,21,0,0,0,0,1,0,0,
1,1,1,1,1,21,1,1,1,
0,1,1,1,1,1,0,0,21,
0,21,1,1,1,0,0,0,0,
0,0,1,1,0,21,1,1,1,
0,1,0,21,0,1,1,1,1,
21,1,1,1,1,1,1,1,1,
0,1,1,1,21,1,1,1,1,
0,21,1,1,0,1,1,1,1,
1,1,0,21,0,0,0,0,1,
1,1,1,1,0,21,0,0,1,
1,1,0,1,21,1,1,1,0,
1,1,0,1,21,1,1,1,0,
1,1,1,1,21,1,1,1,0,
0,21,0,0,0,0,0,1,0,
1,1,1,1,1,1,21,1,0,
0,0,0,0,0,1,0,1,21,
0,1,1,1,1,1,21,1,1,
0,1,1,1,1,1,21,1,1,
0,1,1,1,1,1,21,1,1,
1,1,1,21,0,0,0,0,1,
1,1,1,1,1,21,1,0,1,
1,1,21,0,0,1,0,0,1,
1,1,1,1,0,21,0,0,0,
0,1,1,0,0,0,1,0,21,
0,21,0,0,1,1,1,1,1,
0,0,0,0,0,0,0,0,0,
0,0,0,0,0,0,0,0,0,
0,0,0,0,0,0,0,0,0.
[layer]
type=Tile Layer 2
data=
166,0,0,0,166,0,166,0,0,
156,0,156,156,156,156,156,156,156,
162,0,162,162,162,0,162,162,162,
112,0,112,112,112,0,112,112,112,
0,0,0,0,0,0,140,0,0,
123,123,123,123,123,0,123,123,123,
0,118,118,118,118,118,0,0,0,
0,0,108,108,108,0,0,0,0,
0,0,134,134,0,0,134,134,134,
0,124,0,0,0,124,124,124,124,
0,108,108,108,108,108,108,108,108,
0,103,103,103,0,103,103,103,103,
0,0,129,129,0,129,129,129,129,
119,119,0,0,0,0,0,0,119,
109,109,109,109,0,0,0,0,109,
99,99,0,99,0,99,99,99,0,
123,123,0,123,0,123,123,123,0,
113,113,113,113,0,113,113,113,0,
0,0,0,0,0,0,0,104,0,
95,95,95,95,95,95,0,95,0,
0,0,0,0,0,94,0,94,0,
0,85,85,85,85,85,0,85,85,
0,84,84,84,84,84,0,84,84,
0,83,83,83,83,83,0,83,83,
74,74,74,0,0,0,0,0,74,
73,73,73,73,73,0,73,0,73,
72,72,0,0,0,72,0,0,72,
71,71,71,71,0,0,0,0,0,
0,70,70,0,0,0,70,0,0,
0,0,0,0,69,69,69,69,69,
0,0,0,0,0,0,0,0,0,
0,0,0,0,0,0,0,0,0,
0,0,0,0,0,0,0,0,0.