[layer]
type=Tile Layer 1
data=
2,21,2,9,2,2,2,24,2,
1,21,2,2,2,2,2,2,1,
1,0,1,0,0,21,8,2,1,
1,21,1,0,1,2,2,0,1,
1,0,1,21,1,1,1,0,1,
1,0,1,21,1,1,1,0,1,
2,2,1,1,1,21,0,0,1,
8,2,2,1,1,21,1,0,2,
2,9,2,2,2,0,2,21,19,
1,2,2,2,24,0,0,21,0,
0,0,19,0,21,1,0,0,1,
0,2,2,2,7,2,2,21,2,
1,21,0,0,1,1,1,2,10,
1,21,1,0,1,1,2,0,2,
2,21,0,2,2,2,2,20,2,
1,0,1,21,1,0,2,24,1,
1,0,1,0,1,2,8,21,0,
1,0,1,21,1,2,2,2,1,
1,21,1,0,1,0,0,0,0,
1,1,1,1,1,21,2,2,1,
0,0,0,21,0,0,0,20,2,
0,0,0,0,0,0,0,0,0,
0,0,0,0,0,0,0,0,0,
0,0,0,0,0,0,0,0,0.
[layer]
type=Tile Layer 2
data=
133,0,133,133,133,133,133,0,133,
119,0,119,119,119,119,119,119,119,
130,0,130,0,0,0,130,130,130,
113,0,113,0,113,113,113,0,113,
104,0,104,0,104,104,104,0,104,
95,0,95,0,95,95,95,0,95,
86,86,86,86,86,0,0,0,86,
107,107,107,107,107,0,107,0,107,
98,98,98,98,98,0,98,0,0,
90,90,90,90,0,0,0,0,0,
0,0,0,0,0,82,0,0,82,
0,81,81,81,81,81,81,0,81,
73,0,0,0,73,73,73,73,73,
72,0,72,0,72,72,72,0,72,
71,0,0,71,71,71,71,0,71,
63,0,63,0,63,0,63,0,63,
62,0,62,0,62,62,62,0,0,
58,0,58,0,58,58,58,58,58,
60,0,60,0,60,0,0,0,0,
54,54,54,54,54,0,54,54,54,
0,0,0,0,0,0,0,0,58,
0,0,0,0,0,0,0,0,0,
0,0,0,0,0,0,0,0,0,
0,0,0,0,0,0,0,0,0.