[layer]
type=Tile Layer 1
data=
0,0,21,0,1,3,1,3,0,
0,1,5,21,5,6,6,1,0,
0,21,0,0,3,5,3,6,0,
0,0,5,21,5,0,4,0,6,
6,0,6,21,6,0,4,0,1,
5,21,4,0,1,0,1,0,2,
5,21,2,2,5,0,4,2,8,
6,21,8,0,6,0,0,2,2,
1,2,2,2,4,21,6,4,1,
4,0,21,0,1,0,6,6,5,
4,21,5,4,6,0,6,5,5,
1,0,1,0,1,21,1,0,0,
0,0,1,21,2,2,0,0,6,
2,21,2,2,9,2,2,2,2,
0,21,6,1,10,2,2,3,5,
4,5,3,2,21,8,2,1,1,
1,4,21,2,2,2,2,1,0,
2,2,2,9,2,2,21,0,2,
0,0,0,0,0,0,0,0,0,
0,0,0,0,0,0,0,0,0,
0,0,0,0,0,0,0,0,0.
[layer]
type=Tile Layer 2
data=
0,0,0,0,127,127,127,127,0,
0,126,126,0,126,126,126,126,0,
0,0,0,0,124,124,124,124,0,
0,0,85,0,85,0,85,0,85,
106,0,106,0,106,0,106,0,106,
97,0,97,0,97,0,97,0,97,
89,0,89,89,89,0,89,89,89,
81,0,81,0,81,0,0,81,81,
72,72,72,72,72,0,72,72,72,
72,0,0,0,72,0,72,72,72,
67,0,67,67,67,0,67,67,67,
70,0,70,0,3,0,70,0,0,
0,0,62,0,49,49,0,0,62,
58,0,46,46,46,46,46,58,58,
0,0,48,3,48,48,48,48,60,
47,47,47,47,0,47,47,2,2,
58,47,0,47,47,47,47,2,0,
57,57,57,57,57,57,0,0,57,
0,0,0,0,0,0,0,0,0,
0,0,0,0,0,0,0,0,0,
0,0,0,0,0,0,0,0,0.