[layer]
type=Tile Layer 1
data=
3,1,1,0,5,21,1,0,1,
1,21,0,0,1,1,6,1,1,
1,21,1,0,5,0,1,0,1,
1,1,1,4,1,21,0,0,0,
1,5,3,1,4,21,1,1,0,
1,0,0,1,21,0,1,0,0,
1,0,4,1,21,1,1,5,0,
6,0,1,0,0,21,1,0,0,
0,21,1,0,1,0,1,0,1,
0,0,0,0,0,0,0,0,0,
0,0,0,0,0,0,0,0,0,
0,0,0,0,0,0,0,0,0.
[layer]
type=Tile Layer 2
data=
79,79,79,0,79,0,79,0,79,
50,0,0,0,50,50,50,50,50,
49,0,49,0,49,0,49,0,49,
48,48,48,48,48,0,0,0,0,
45,45,45,45,45,0,45,45,0,
47,0,0,47,0,0,47,0,0,
46,0,46,46,0,46,46,46,0,
45,0,45,0,0,0,45,0,0,
0,0,44,0,44,0,44,0,44,
0,0,0,0,0,0,0,0,0,
0,0,0,0,0,0,0,0,0,
0,0,0,0,0,0,0,0,0.