[layer]
type=Tile Layer 1
data=
0,21,1,2,19,2,1,1,1,
0,21,0,2,0,0,1,6,1,
2,2,0,5,1,21,0,0,1,
19,0,21,1,0,0,0,0,0,
2,2,21,2,2,1,1,1,3,
1,1,21,19,0,1,4,6,1,
1,4,21,2,2,1,1,1,1,
0,0,21,1,0,0,0,0,0,
0,5,4,1,3,1,1,1,21,
0,4,0,0,0,0,0,0,21,
0,1,21,1,1,1,3,1,1,
0,1,0,1,0,21,0,0,0,
1,1,0,0,0,0,21,0,0,
3,1,21,1,0,0,0,1,0,
1,2,0,2,1,6,1,21,0,
2,2,20,0,0,2,2,21,0,
2,2,2,2,0,2,2,21,20,
1,1,1,1,3,21,0,2,0,
1,5,1,1,5,1,1,1,21,
4,1,1,1,1,0,0,21,0,
1,6,1,1,21,0,1,4,0,
2,2,2,0,18,21,0,2,2,
1,6,1,0,21,0,0,2,2,
3,1,0,21,0,0,1,2,19,
1,1,0,21,0,1,1,2,2,
1,1,21,1,0,1,1,5,6,
1,4,21,1,0,0,1,4,1,
0,0,0,0,21,0,6,1,1,
19,21,1,1,0,1,1,6,1,
2,21,0,1,0,3,1,4,1,
1,21,2,2,2,0,1,1,4,
0,0,2,19,2,0,0,21,0,
1,21,2,2,2,1,6,1,1,
1,0,21,0,4,0,0,0,1,
1,21,1,1,3,0,1,0,1,
1,0,6,21,0,0,2,0,1,
2,21,2,2,2,2,2,20,2,
2,0,21,0,20,0,0,0,2,
6,2,21,2,2,2,1,1,1,
0,21,20,2,2,2,2,2,2,
0,2,21,2,1,4,1,1,1,
0,1,0,0,21,2,1,1,3,
0,0,2,2,20,21,2,2,2,
1,0,0,0,21,2,0,1,1,
5,3,1,1,1,4,21,1,1,
0,0,0,0,0,0,0,0,0,
0,0,0,0,0,0,0,0,0,
0,0,0,0,0,0,0,0,0.
[layer]
type=Tile Layer 2
data=
0,0,208,208,0,208,208,208,208,
0,0,0,206,0,0,206,206,206,
204,204,0,204,204,0,0,0,204,
0,0,0,178,0,0,0,0,0,
157,157,0,157,157,157,157,157,157,
152,152,0,0,0,152,152,152,152,
132,132,0,132,132,132,132,132,132,
0,0,0,173,0,0,0,0,0,
0,160,160,160,160,160,160,160,0,
0,147,0,0,0,0,0,0,0,
0,134,0,134,134,134,134,134,134,
0,167,0,167,0,0,0,0,0,
154,154,0,0,0,0,0,0,0,
142,142,0,142,0,0,0,142,0,
130,130,0,130,130,130,130,0,0,
162,162,0,0,0,162,162,0,0,
149,149,149,149,0,149,149,0,0,
137,137,137,137,137,0,0,137,0,
119,119,119,119,119,119,119,119,0,
156,156,156,156,156,0,0,0,0,
144,144,144,144,0,0,144,144,0,
132,132,132,0,0,0,0,132,132,
121,121,121,0,0,0,0,121,121,
150,150,0,0,0,0,150,150,0,
139,139,0,0,0,139,139,139,139,
128,128,0,128,0,128,128,128,128,
116,116,0,116,0,0,116,116,116,
0,0,0,0,0,0,145,145,145,
0,0,134,134,0,134,134,134,134,
123,0,0,123,0,123,123,123,123,
112,0,112,112,112,0,112,112,112,
0,0,139,0,139,0,0,0,0,
122,0,122,122,122,122,122,122,122,
118,0,0,0,118,0,0,0,118,
108,0,108,108,108,0,108,0,108,
107,0,107,0,0,0,107,0,107,
97,0,97,97,97,97,97,0,97,
96,0,0,0,0,0,0,0,96,
90,90,0,90,90,90,90,90,90,
0,0,0,85,85,85,85,85,85,
0,84,0,84,84,84,84,84,84,
0,83,0,0,0,83,83,83,83,
0,0,82,82,0,0,82,82,82,
81,0,0,0,0,81,0,81,81,
77,77,77,77,77,77,0,77,77,
0,0,0,0,0,0,0,0,0,
0,0,0,0,0,0,0,0,0,
0,0,0,0,0,0,0,0,0.