[layer]
type=Tile Layer 1
data=
1,21,1,0,1,1,1,1,3,
4,1,21,0,0,1,0,1,1,
1,21,0,5,0,1,0,0,1,
1,21,1,1,6,6,1,0,1,
5,21,0,0,0,0,1,1,0,
1,1,0,21,1,1,3,1,0,
1,1,1,4,21,1,1,1,0,
1,1,1,1,0,4,21,0,1,
5,1,0,0,21,0,3,1,1,
0,1,1,1,21,4,0,1,0,
1,6,0,1,0,1,0,0,21,
1,1,21,5,0,3,1,1,0,
1,3,0,1,0,0,21,1,0,
1,1,1,1,6,1,21,4,1,
0,1,21,1,0,0,0,1,0,
0,0,0,0,0,0,0,0,0,
0,0,0,0,0,0,0,0,0,
0,0,0,0,0,0,0,0,0.
[layer]
type=Tile Layer 2
data=
89,0,89,0,89,89,89,89,89,
73,73,0,0,0,73,0,73,73,
72,0,0,72,0,72,0,0,72,
67,0,67,67,67,67,67,0,67,
64,0,0,0,0,0,64,64,0,
63,63,0,0,63,63,63,63,0,
59,59,59,59,0,59,59,59,0,
55,55,55,55,0,55,0,0,55,
54,54,0,0,0,0,54,54,54,
0,53,53,53,0,53,0,53,0,
52,52,0,52,0,52,0,0,0,
51,51,0,51,0,51,51,51,0,
50,50,0,50,0,0,0,50,0,
45,45,45,45,45,45,0,45,45,
0,48,0,48,0,0,0,48,0,
0,0,0,0,0,0,0,0,0,
0,0,0,0,0,0,0,0,0,
0,0,0,0,0,0,0,0,0.