[layer]
type=Tile Layer 1
data=
1,1,3,21,0,0,5,1,1,
1,1,1,21,1,0,0,0,0,
3,1,4,0,0,21,1,1,0,
1,1,4,0,1,21,6,0,1,
1,1,1,1,1,21,6,0,1,
0,0,0,1,3,1,1,21,0,
1,1,1,21,1,1,1,3,1,
1,1,1,1,1,21,5,1,1,
1,21,6,1,1,6,1,1,1,
1,1,1,21,1,1,1,1,4,
1,1,1,21,3,6,1,1,1,
0,0,0,0,3,1,1,0,21,
0,0,1,1,1,3,1,0,21,
0,1,1,21,1,1,5,1,0,
1,0,4,1,21,1,1,0,3,
4,5,21,1,1,1,0,1,1,
0,1,0,0,0,21,0,1,0,
0,0,1,5,1,1,6,0,21,
0,0,0,0,0,0,0,0,0,
0,0,0,0,0,0,0,0,0,
0,0,0,0,0,0,0,0,0.
[layer]
type=Tile Layer 2
data=
128,128,128,0,0,0,128,128,128,
127,127,127,0,127,0,0,0,0,
125,125,125,0,0,0,125,125,0,
86,86,86,0,86,0,86,0,86,
102,102,102,81,81,0,102,0,102,
0,0,0,4,79,4,98,0,0,
81,81,81,0,65,65,81,81,81,
65,4,65,4,4,0,65,4,4,
64,0,64,4,64,64,64,4,64,
3,3,58,0,58,58,58,3,58,
65,65,65,0,65,65,65,65,65,
0,0,0,0,71,71,71,0,0,
0,0,63,63,63,63,63,0,0,
0,62,62,0,62,62,62,62,0,
61,0,61,61,0,61,61,0,61,
57,57,0,57,57,57,0,57,57,
0,59,0,0,0,0,0,59,0,
0,0,58,58,58,58,58,0,0,
0,0,0,0,0,0,0,0,0,
0,0,0,0,0,0,0,0,0,
0,0,0,0,0,0,0,0,0.