[layer]
type=Tile Layer 1
data=
0,0,21,1,1,1,1,0,0,
1,1,0,0,21,0,0,0,1,
1,1,1,1,1,21,0,0,0,
1,21,1,1,1,0,1,1,1,
1,21,1,1,1,0,1,0,0,
1,1,1,1,1,21,1,1,1,
0,0,0,0,0,21,1,1,1,
1,1,1,1,1,21,1,1,1,
0,21,0,0,1,0,1,1,1,
1,1,1,1,1,21,1,1,1,
0,0,0,21,0,0,1,0,0,
1,21,1,1,1,1,1,0,1,
1,21,1,1,1,0,1,0,1,
1,0,0,21,1,0,1,0,1,
1,0,1,0,1,21,1,0,1,
1,21,1,0,1,0,1,0,1,
1,21,1,0,1,0,1,0,1,
1,0,1,0,1,0,1,21,0,
1,1,1,21,1,0,1,1,1,
0,0,1,21,1,0,1,0,0,
1,21,1,0,1,0,1,0,1,
0,1,0,1,1,1,21,1,0,
0,1,0,1,1,1,21,1,1,
0,1,0,0,0,1,0,21,0,
21,1,1,1,1,1,1,1,1,
0,0,0,1,0,0,0,21,0,
1,1,21,1,0,1,1,1,1,
0,0,0,0,0,0,0,0,0,
0,0,0,0,0,0,0,0,0,
0,0,0,0,0,0,0,0,0.
[layer]
type=Tile Layer 2
data=
0,0,0,160,160,160,160,0,0,
158,158,0,0,0,0,0,0,158,
157,157,157,157,157,0,0,0,0,
117,0,117,117,117,0,117,117,117,
107,0,107,107,107,0,107,0,0,
127,127,127,127,127,0,127,127,127,
0,0,0,0,0,0,123,123,123,
107,107,107,107,107,0,107,107,107,
0,0,0,0,102,0,102,102,102,
122,122,122,122,122,0,122,122,122,
0,0,0,0,0,0,118,0,0,
108,0,108,108,108,108,108,0,108,
98,0,98,98,98,0,98,0,98,
122,0,0,0,122,0,122,0,122,
112,0,112,0,112,0,112,0,112,
103,0,103,0,103,0,103,0,103,
94,0,94,0,94,0,94,0,94,
93,0,93,0,93,0,93,0,0,
84,84,84,0,84,0,84,84,84,
0,0,83,0,83,0,83,0,0,
82,0,82,0,82,0,82,0,82,
0,73,0,73,73,73,0,73,0,
0,72,0,72,72,72,0,72,72,
0,71,0,0,0,71,0,0,0,
0,67,67,67,67,67,67,67,67,
0,0,0,69,0,0,0,0,0,
68,68,0,68,0,68,68,68,68,
0,0,0,0,0,0,0,0,0,
0,0,0,0,0,0,0,0,0,
0,0,0,0,0,0,0,0,0.