[layer]
type=Tile Layer 1
data=
1,0,0,1,21,0,1,1,1,
1,21,1,1,1,6,3,1,6,
0,0,0,5,1,0,1,0,21,
1,3,1,0,21,0,0,0,1,
1,3,1,1,1,5,21,4,0,
1,1,1,1,1,1,21,1,0,
5,1,21,0,0,0,0,1,0,
1,1,0,0,6,1,1,21,0,
0,21,1,4,1,1,1,0,0,
0,0,6,1,21,0,0,1,0,
0,4,0,1,0,21,1,1,0,
0,0,21,1,1,1,0,0,0,
1,21,0,0,0,0,0,0,1,
4,1,1,21,1,5,1,0,1,
0,0,1,21,1,0,6,0,1,
1,1,1,4,1,21,1,1,1,
3,21,0,1,0,1,0,1,0,
1,1,5,4,21,1,3,1,1,
5,1,1,1,21,0,1,3,1,
1,1,1,1,4,21,5,1,1,
1,1,1,3,1,21,0,0,0,
0,0,0,21,0,0,1,0,0,
1,1,1,21,1,5,1,0,4,
6,1,1,21,0,0,1,0,1,
1,1,1,3,5,21,1,0,1,
0,0,0,21,1,0,0,0,3,
1,1,1,21,1,1,1,1,6,
1,6,1,21,1,1,5,1,4,
1,4,1,21,1,5,1,1,1,
1,1,1,21,1,6,1,1,1,
1,1,5,1,21,0,6,0,0,
1,4,1,1,1,21,1,0,0,
1,0,0,0,21,0,1,0,6,
0,21,1,1,1,1,0,0,5,
0,0,0,0,0,21,0,4,1,
1,6,1,1,4,1,21,1,1,
1,0,0,21,1,0,1,3,1,
1,0,21,0,1,0,0,0,0,
4,1,1,21,0,0,6,1,0,
1,4,1,21,1,5,1,0,1,
0,0,1,0,21,0,0,0,0,
1,21,1,1,4,1,1,1,6,
1,21,6,1,1,1,1,1,6,
0,0,0,1,1,1,21,0,0,
1,1,21,5,3,1,1,1,3,
0,0,0,0,0,0,0,0,0,
0,0,0,0,0,0,0,0,0,
0,0,0,0,0,0,0,0,0.
[layer]
type=Tile Layer 2
data=
208,0,0,208,0,0,208,208,208,
196,0,196,196,196,196,196,196,196,
0,0,0,204,204,0,204,0,0,
178,178,178,0,0,0,0,0,178,
165,165,165,165,165,165,0,165,0,
152,152,152,152,152,152,0,152,0,
138,138,0,0,0,0,0,138,0,
173,173,0,0,173,173,173,0,0,
0,0,160,160,160,160,160,0,0,
0,0,147,147,0,0,0,147,0,
0,134,0,134,0,0,134,134,0,
0,0,0,167,167,167,0,0,0,
154,0,0,0,0,0,0,0,154,
142,142,142,0,142,142,142,0,142,
0,0,130,0,130,0,130,0,130,
154,154,154,154,154,0,154,154,154,
149,0,0,149,0,149,0,149,0,
131,131,131,131,0,131,131,131,131,
125,125,125,125,0,0,125,125,125,
148,148,148,148,148,0,148,148,148,
144,144,144,144,144,0,0,0,0,
0,0,0,0,0,0,132,0,0,
121,121,121,0,121,121,121,0,121,
150,150,150,0,0,0,150,0,150,
139,139,139,139,139,0,139,0,139,
0,0,0,0,128,0,0,0,128,
111,111,111,0,111,111,111,111,111,
138,138,138,0,138,138,138,138,138,
127,127,127,0,127,127,127,127,127,
117,117,117,0,117,117,117,117,117,
112,112,112,112,0,0,112,0,0,
139,139,139,139,139,0,139,0,0,
128,0,0,0,0,0,128,0,128,
0,0,118,118,118,118,0,0,118,
0,0,0,0,0,0,0,108,108,
102,102,102,102,102,102,0,102,102,
97,0,0,0,97,0,97,97,97,
96,0,0,0,96,0,0,0,0,
95,95,95,0,0,0,95,95,0,
85,85,85,0,85,85,85,0,85,
0,0,84,0,0,0,0,0,0,
79,0,79,79,79,79,79,79,79,
78,0,78,78,78,78,78,78,78,
0,0,0,81,81,81,0,0,0,
77,77,0,77,77,77,77,77,77,
0,0,0,0,0,0,0,0,0,
0,0,0,0,0,0,0,0,0,
0,0,0,0,0,0,0,0,0.