[layer]
type=Tile Layer 1
data=
0,0,0,1,1,1,21,0,4,
0,1,0,6,1,1,1,21,0,
0,0,21,6,1,1,5,1,0,
1,1,21,1,1,1,1,1,0,
1,4,21,4,1,1,1,1,0,
1,1,21,3,1,5,3,1,0,
3,1,4,0,0,21,0,0,3,
1,1,1,1,1,21,1,0,1,
5,1,21,0,0,1,0,0,1,
1,1,1,1,0,0,21,0,0,
0,5,1,0,0,21,1,0,0,
0,21,0,0,1,1,4,1,6,
0,0,0,0,21,1,1,6,1,
0,1,1,1,21,0,6,5,1,
0,1,1,1,1,21,1,4,1,
1,0,1,0,1,21,1,0,1,
1,3,1,21,5,0,5,1,1,
0,0,1,21,4,0,0,0,0,
1,21,1,0,5,6,1,6,1,
0,0,1,0,21,0,1,0,0,
1,1,1,21,1,0,1,4,1,
0,0,1,0,6,0,21,0,0,
1,21,1,0,1,1,4,3,1,
0,0,1,0,1,21,0,0,0,
0,1,1,1,5,5,0,1,21,
21,1,3,6,1,1,1,1,1,
0,21,0,0,0,0,0,1,1,
1,1,1,1,1,1,21,6,1,
1,1,5,1,21,1,0,1,5,
1,6,3,1,3,1,21,1,1,
0,0,0,1,0,21,0,0,0,
0,1,1,1,21,1,1,3,1,
0,6,1,1,0,4,0,0,21,
1,1,3,1,1,1,5,21,1,
1,6,3,0,1,0,0,21,0,
6,1,1,21,1,0,1,1,1,
0,21,0,0,1,0,1,4,1,
1,1,5,1,1,21,1,1,1,
0,0,1,0,21,0,4,6,1,
0,0,0,0,0,0,0,0,0,
0,0,0,0,0,0,0,0,0,
0,0,0,0,0,0,0,0,0.
[layer]
type=Tile Layer 2
data=
0,0,0,197,197,197,0,0,197,
0,195,0,195,195,195,195,0,0,
0,0,0,194,194,194,194,194,0,
146,146,0,146,146,146,146,146,0,
133,133,0,133,133,133,133,133,0,
166,166,0,166,166,166,166,166,0,
153,153,153,0,0,0,0,0,153,
141,141,141,141,141,0,141,0,141,
129,129,0,0,0,129,0,0,129,
161,161,161,161,0,0,0,0,0,
0,148,148,0,0,0,148,0,0,
0,0,0,0,136,136,136,136,136,
0,0,0,0,0,124,124,124,124,
0,155,155,155,0,0,155,155,155,
0,143,143,143,143,0,143,143,143,
131,0,131,0,131,0,131,0,131,
120,120,120,0,120,0,120,120,120,
0,0,149,0,149,0,0,0,0,
138,0,138,0,138,138,138,138,138,
0,0,127,0,0,0,127,0,0,
115,115,115,0,115,0,115,115,115,
0,0,144,0,144,0,0,0,0,
133,0,133,0,133,133,133,133,133,
0,0,122,0,122,0,0,0,0,
0,111,111,111,111,111,0,111,0,
0,132,132,132,132,132,132,132,132,
0,0,0,0,0,0,0,127,127,
111,111,111,111,111,111,0,111,111,
107,107,107,107,0,107,0,107,107,
101,101,101,101,101,101,0,101,101,
0,0,0,96,0,0,0,0,0,
0,95,95,95,0,95,95,95,95,
0,94,94,94,0,94,0,0,0,
80,80,80,80,80,80,80,0,80,
83,83,83,0,83,0,0,0,0,
82,82,82,0,82,0,82,82,82,
0,0,0,0,81,0,81,81,81,
77,77,77,77,77,0,77,77,77,
0,0,79,0,0,0,79,79,79,
0,0,0,0,0,0,0,0,0,
0,0,0,0,0,0,0,0,0,
0,0,0,0,0,0,0,0,0.