[layer]
type=Tile Layer 1
data=
0,0,1,0,0,21,1,1,1,
21,1,1,1,1,1,1,1,1,
0,21,1,1,1,0,1,1,1,
1,1,0,21,0,0,1,1,1,
1,1,0,1,1,21,0,1,1,
1,1,0,0,1,1,21,0,0,
0,0,21,0,1,1,1,1,0,
0,1,1,1,1,0,21,0,0,
0,1,1,1,1,21,1,0,1,
1,21,0,0,0,0,1,0,1,
1,1,1,1,0,1,21,0,1,
1,1,1,1,21,0,0,1,1,
1,1,1,1,21,1,1,1,0,
1,1,1,1,21,1,1,1,0,
1,1,1,1,21,1,1,1,0,
1,1,1,1,21,1,1,1,0,
1,1,1,1,21,1,1,1,0,
0,0,0,0,0,1,1,21,1,
1,1,21,1,1,1,1,1,1,
0,1,0,1,0,0,0,21,0,
0,1,21,1,0,1,1,1,0,
1,1,1,1,1,1,21,1,1,
0,1,1,1,1,1,21,0,0,
21,1,1,1,1,1,1,1,1,
0,1,1,1,1,1,21,1,1,
0,1,1,1,1,1,21,1,1,
0,0,21,1,0,0,0,1,1,
0,1,1,1,21,1,1,1,1,
0,0,0,1,21,1,0,0,0,
1,1,1,1,21,1,1,1,1,
1,1,0,0,21,0,0,1,1,
1,1,0,21,1,1,0,0,0,
1,1,1,21,0,1,1,1,0,
1,21,0,0,0,1,1,0,0,
1,0,21,1,1,0,0,0,1,
1,1,21,1,1,0,1,1,1,
1,1,0,0,0,21,0,0,1,
0,0,1,1,1,0,21,1,1,
0,21,0,0,0,0,1,1,1,
1,1,21,1,1,1,1,1,0,
0,0,0,0,1,1,21,1,0,
0,1,1,1,1,1,1,1,21,
0,1,1,1,0,21,0,1,0,
0,1,1,1,21,1,1,1,1,
0,1,1,1,21,1,1,1,1,
0,0,0,0,0,0,0,0,0,
0,0,0,0,0,0,0,0,0,
0,0,0,0,0,0,0,0,0.
[layer]
type=Tile Layer 2
data=
0,0,208,0,0,0,208,208,208,
0,196,196,196,196,196,196,196,196,
0,0,204,204,204,0,204,204,204,
178,178,0,0,0,0,178,178,178,
165,165,0,165,165,0,0,165,165,
152,152,0,0,152,152,0,0,0,
0,0,0,0,138,138,138,138,0,
0,173,173,173,173,0,0,0,0,
0,160,160,160,160,0,160,0,160,
147,0,0,0,0,0,147,0,147,
134,134,134,134,0,134,0,0,134,
167,167,167,167,0,0,0,167,167,
154,154,154,154,0,154,154,154,0,
142,142,142,142,0,142,142,142,0,
130,130,130,130,0,130,130,130,0,
162,162,162,162,0,162,162,162,0,
149,149,149,149,0,149,149,149,0,
0,0,0,0,0,137,137,0,137,
119,119,0,119,119,119,119,119,119,
0,156,0,156,0,0,0,0,0,
0,144,0,144,0,144,144,144,0,
126,126,126,126,126,126,0,126,126,
0,121,121,121,121,121,0,0,0,
0,143,143,143,143,143,143,143,143,
0,139,139,139,139,139,0,139,139,
0,128,128,128,128,128,0,128,128,
0,0,0,116,0,0,0,116,116,
0,145,145,145,0,145,145,145,145,
0,0,0,134,0,134,0,0,0,
117,117,117,117,0,117,117,117,117,
112,112,0,0,0,0,0,112,112,
139,139,0,0,139,139,0,0,0,
128,128,128,0,0,128,128,128,0,
118,0,0,0,0,118,118,0,0,
108,0,0,108,108,0,0,0,108,
107,107,0,107,107,0,107,107,107,
97,97,0,0,0,0,0,0,97,
0,0,96,96,96,0,0,96,96,
0,0,0,0,0,0,95,95,95,
85,85,0,85,85,85,85,85,0,
0,0,0,0,84,84,0,84,0,
0,83,83,83,83,83,83,83,0,
0,82,82,82,0,0,0,82,0,
0,81,81,81,0,81,81,81,81,
0,80,80,80,0,80,80,80,80,
0,0,0,0,0,0,0,0,0,
0,0,0,0,0,0,0,0,0,
0,0,0,0,0,0,0,0,0.