[layer]
type=Tile Layer 1
data=
1,1,1,1,1,21,1,1,0,
1,1,1,1,5,21,0,0,0,
3,1,4,3,1,1,21,0,0,
1,1,6,1,1,0,21,4,0,
1,1,1,1,3,0,21,1,0,
1,1,1,1,3,1,0,21,0,
0,3,21,1,1,3,1,1,1,
0,1,21,5,1,1,0,1,0,
1,6,21,1,1,1,1,1,1,
1,1,1,1,1,1,1,1,21,
1,1,1,6,1,1,21,1,1,
0,1,1,5,1,4,0,4,21,
21,6,1,1,1,1,1,1,1,
0,6,0,0,0,0,0,0,21,
0,1,4,1,1,1,1,3,21,
1,5,1,1,4,1,1,21,0,
1,1,1,1,21,0,0,0,0,
0,0,0,21,0,1,6,6,1,
21,1,1,1,1,4,1,1,1,
0,0,0,0,21,0,5,4,1,
1,3,1,1,1,21,0,0,0,
4,1,1,3,1,1,0,21,0,
4,1,1,5,5,1,21,3,1,
1,1,1,1,1,1,21,1,1,
1,1,1,1,1,1,21,0,4,
6,1,0,0,0,0,21,0,1,
0,21,0,4,5,1,1,1,1,
0,21,1,1,5,1,4,1,1,
1,0,21,0,3,1,1,1,4,
1,3,1,21,0,0,1,1,1,
1,4,6,1,1,0,21,0,0,
5,1,1,1,0,0,0,21,0,
1,6,1,1,21,1,1,1,1,
1,5,1,1,1,21,1,1,5,
0,0,21,0,0,0,1,0,0,
1,1,1,1,1,21,4,1,3,
0,0,0,0,1,0,21,0,0,
1,3,1,6,1,21,1,1,1,
5,0,21,0,0,0,1,1,1,
1,21,1,1,1,6,1,1,1,
0,0,21,3,0,1,0,0,0,
1,1,1,21,1,5,1,5,1,
1,0,21,0,0,5,1,1,1,
1,1,21,0,0,0,0,0,0,
1,3,21,3,4,1,1,1,0,
1,1,1,1,1,1,21,1,1,
1,1,6,21,5,1,1,5,1,
1,21,1,1,4,1,1,1,1,
1,1,1,1,1,1,1,1,1,
0,0,0,0,0,0,0,0,0,
0,0,0,0,0,0,0,0,0.
[layer]
type=Tile Layer 2
data=
228,228,228,228,228,0,228,228,0,
227,227,227,227,227,0,0,0,0,
225,225,225,225,225,225,0,0,0,
183,183,183,183,183,0,0,183,0,
168,168,168,168,168,0,0,168,0,
154,154,154,123,123,123,0,0,0,
0,192,0,154,9,154,192,192,192,
0,178,0,142,8,8,0,178,0,
131,131,0,131,131,131,131,131,8,
7,7,7,7,7,7,7,119,0,
149,149,149,149,149,149,0,149,9,
0,173,173,173,173,173,0,173,0,
0,151,151,151,151,151,151,151,151,
0,145,0,0,0,0,0,0,0,
0,181,181,181,181,181,181,181,0,
167,167,167,167,167,167,167,0,0,
154,154,154,154,0,0,0,0,0,
0,0,0,0,0,141,141,141,141,
0,167,167,167,167,167,167,167,167,
0,0,0,0,0,0,162,162,162,
149,149,149,149,149,0,0,0,0,
136,136,136,136,136,136,0,0,0,
162,162,162,162,162,162,0,162,162,
150,150,150,150,150,150,0,150,150,
144,144,144,144,144,144,0,0,144,
132,132,0,0,0,0,0,0,132,
0,0,0,164,164,164,164,164,164,
0,0,152,152,152,152,152,152,152,
140,0,0,0,140,140,140,140,140,
127,127,127,0,0,0,127,127,127,
159,159,159,159,159,0,0,0,0,
147,147,147,147,0,0,0,0,0,
128,128,128,128,0,128,128,128,128,
117,117,117,117,117,0,117,117,117,
0,0,0,0,0,0,153,0,0,
135,135,135,135,135,0,135,135,135,
0,0,0,0,130,0,0,0,0,
113,113,113,113,113,0,113,113,113,
118,0,0,0,0,0,118,118,118,
102,0,102,102,102,102,102,102,102,
0,0,0,106,0,106,0,0,0,
100,100,100,0,100,100,100,100,100,
94,0,0,0,0,94,94,94,94,
93,93,0,0,0,0,0,0,0,
92,92,0,92,92,92,92,92,0,
73,73,73,4,4,4,0,4,4,
72,72,72,0,72,4,72,72,72,
71,0,4,71,71,71,71,71,71,
4,4,4,4,4,4,4,4,4,
0,0,0,0,0,0,0,0,0,
0,0,0,0,0,0,0,0,0.