[layer]
type=Tile Layer 1
data=
1,1,1,1,3,21,1,1,1,
1,1,4,21,0,0,1,1,1,
1,1,3,21,1,0,4,1,5,
1,0,21,0,1,0,1,0,6,
3,4,1,21,1,1,1,0,1,
1,4,1,0,0,0,1,21,0,
6,1,1,21,1,1,1,1,5,
1,1,1,21,1,1,1,1,4,
1,1,1,21,1,5,1,6,4,
0,1,1,1,0,0,1,0,21,
0,1,4,1,21,1,1,0,0,
0,1,5,6,21,1,4,0,0,
0,21,4,1,0,0,1,0,0,
6,1,3,1,1,0,21,0,1,
1,1,1,3,21,0,1,0,1,
0,0,0,21,0,1,0,0,4,
0,0,1,6,1,1,21,1,1,
1,0,0,0,0,21,0,0,0,
1,1,1,21,0,0,0,0,0,
6,1,1,21,4,1,3,1,1,
0,0,1,21,1,1,1,1,4,
1,4,1,21,1,1,1,1,1,
0,0,5,0,1,0,0,21,0,
1,4,1,1,21,1,6,1,1,
1,1,6,6,21,1,1,1,1,
0,0,0,0,21,1,4,1,1,
3,1,1,1,21,3,1,1,1,
5,21,1,0,1,1,3,0,1,
3,21,5,1,1,1,1,0,1,
6,21,1,0,1,1,1,0,1,
1,21,6,0,1,1,4,0,1,
0,0,0,0,0,21,1,0,0,
1,1,1,1,1,6,1,21,3,
1,21,1,1,6,1,1,0,0,
3,21,1,1,1,1,3,1,1,
1,21,1,5,1,1,1,0,6,
0,1,0,21,4,1,0,0,0,
0,1,0,21,1,1,3,5,0,
0,1,21,0,1,1,0,0,0,
0,0,1,0,1,3,0,21,1,
4,0,1,1,21,0,1,0,0,
1,21,6,1,1,1,1,3,0,
0,1,0,1,0,1,6,1,21,
0,1,0,4,21,5,1,1,0,
0,0,0,0,21,0,0,0,1,
1,21,5,1,3,1,1,1,1,
0,0,21,1,0,4,1,1,3,
0,1,0,1,21,1,4,1,1,
0,1,0,0,21,1,1,1,1,
1,1,1,6,21,5,1,6,1,
1,3,1,1,21,0,0,0,0,
0,0,0,0,0,0,0,0,0,
0,0,0,0,0,0,0,0,0,
0,0,0,0,0,0,0,0,0.
[layer]
type=Tile Layer 2
data=
223,223,223,223,223,0,223,223,223,
233,233,233,0,0,0,233,233,233,
231,231,231,0,231,0,231,231,231,
174,0,0,0,174,0,174,0,174,
159,159,159,0,159,159,159,0,159,
199,199,199,0,0,0,199,0,0,
175,175,175,0,175,175,175,175,175,
161,161,161,0,161,161,161,161,161,
147,147,147,0,147,147,147,147,147,
0,193,193,193,0,0,193,0,0,
0,179,179,179,0,179,179,0,0,
0,165,165,165,0,165,165,0,0,
0,0,150,150,0,0,150,0,0,
188,188,188,188,188,0,0,0,188,
174,174,174,174,0,0,174,0,174,
0,0,0,0,0,160,0,0,160,
0,0,146,146,146,146,0,146,146,
182,0,0,0,0,0,0,0,0,
168,168,168,0,0,0,0,0,0,
148,148,148,0,148,148,148,148,148,
0,0,142,0,142,142,142,142,142,
168,168,168,0,168,168,168,168,168,
0,0,163,0,163,0,0,0,0,
143,143,143,143,0,143,143,143,143,
131,131,131,131,0,131,131,131,131,
0,0,0,0,0,171,171,171,171,
151,151,151,151,0,151,151,151,151,
145,0,145,0,145,145,145,0,145,
133,0,133,133,133,133,133,0,133,
165,0,165,0,165,165,165,0,165,
153,0,153,0,153,153,153,0,153,
0,0,0,0,0,0,141,0,0,
122,122,122,122,122,122,122,0,122,
160,0,160,160,160,160,160,0,0,
141,0,141,141,141,141,141,141,141,
136,0,136,136,136,136,136,0,136,
0,124,0,0,124,124,0,0,0,
0,154,0,0,154,154,154,154,0,
0,142,0,0,142,142,0,0,0,
0,0,131,0,131,131,0,0,131,
120,0,120,120,0,0,120,0,0,
119,0,119,119,119,119,119,119,0,
0,108,0,108,0,108,108,108,0,
0,107,0,107,0,107,107,107,0,
0,0,0,0,0,0,0,0,106,
91,0,91,91,91,91,91,91,91,
0,0,0,94,0,94,94,94,94,
0,93,0,93,0,93,93,93,93,
0,92,0,0,0,92,92,92,92,
87,87,87,87,0,87,87,87,87,
90,90,90,90,0,0,0,0,0,
0,0,0,0,0,0,0,0,0,
0,0,0,0,0,0,0,0,0,
0,0,0,0,0,0,0,0,0.