[layer]
type=Tile Layer 1
data=
0,3,1,1,21,1,1,1,0,
0,1,0,0,21,1,1,1,0,
0,6,3,1,0,1,5,1,21,
0,0,0,1,21,0,0,4,0,
1,1,0,6,21,1,0,1,1,
1,5,0,1,21,1,0,0,0,
0,0,1,1,1,3,1,21,1,
0,1,21,0,0,0,6,1,1,
0,1,1,1,6,21,0,4,1,
0,1,1,1,0,1,0,21,0,
4,21,0,0,0,3,0,1,0,
6,1,1,1,0,21,1,1,0,
4,5,1,1,1,21,1,1,0,
1,1,1,1,1,21,1,4,0,
3,1,1,0,0,0,0,21,0,
1,0,21,0,1,0,0,0,1,
1,21,3,1,1,1,1,0,1,
0,0,1,6,3,1,4,0,21,
1,21,6,5,1,1,1,0,5,
0,0,0,0,0,0,21,0,1,
1,21,1,1,1,3,1,1,1,
0,0,0,0,0,0,0,0,0,
0,0,0,0,0,0,0,0,0,
0,0,0,0,0,0,0,0,0.
[layer]
type=Tile Layer 2
data=
0,133,133,133,0,133,133,133,0,
0,132,0,0,0,132,132,132,0,
0,130,130,130,0,130,130,130,0,
0,0,0,113,0,0,0,113,0,
104,104,0,104,0,104,0,104,104,
95,95,0,95,0,95,0,0,0,
0,0,86,86,86,86,86,0,86,
0,107,0,0,0,0,107,107,107,
0,98,98,98,98,0,0,98,98,
0,90,90,90,0,90,0,0,0,
82,0,0,0,0,82,0,82,0,
81,81,81,81,0,0,81,81,0,
69,69,69,69,69,0,69,69,0,
68,68,68,68,68,0,68,68,0,
71,71,71,0,0,0,0,0,0,
63,0,0,0,63,0,0,0,63,
59,0,59,59,59,59,59,0,59,
0,0,61,61,61,61,61,0,0,
57,0,57,57,57,57,57,0,57,
0,0,0,0,0,0,0,0,59,
53,0,53,53,53,53,53,53,53,
0,0,0,0,0,0,0,0,0,
0,0,0,0,0,0,0,0,0,
0,0,0,0,0,0,0,0,0.