[layer]
type=Tile Layer 1
data=
1,1,1,1,21,1,0,1,1,
1,1,1,1,0,0,0,21,0,
1,1,1,1,1,1,21,1,1,
1,1,1,1,21,0,0,0,0,
0,0,1,1,1,0,21,1,0,
0,1,1,1,1,1,1,0,21,
0,1,1,1,1,1,1,21,1,
0,0,0,1,1,1,0,21,1,
1,1,21,1,1,1,0,1,1,
1,1,1,1,1,1,0,21,0,
1,1,1,1,21,0,1,1,0,
1,1,0,0,21,0,0,0,0,
1,1,0,1,1,1,21,1,0,
1,1,1,1,1,1,21,1,0,
0,0,0,1,1,1,21,0,0,
1,1,21,1,1,1,0,1,1,
0,21,0,1,0,0,0,1,1,
1,1,21,1,1,1,1,1,1,
1,1,0,21,0,0,0,1,1,
1,1,21,1,1,1,1,1,1,
0,21,0,0,0,0,0,1,0,
1,1,1,0,21,0,0,1,1,
1,1,0,21,1,1,0,1,1,
1,0,0,1,1,1,0,21,0,
0,21,1,1,1,1,1,1,0,
0,21,1,1,1,1,1,1,0,
1,1,1,1,1,21,1,1,0,
0,0,0,0,0,0,0,0,0,
0,0,0,0,0,0,0,0,0,
0,0,0,0,0,0,0,0,0.
[layer]
type=Tile Layer 2
data=
160,160,160,160,0,160,0,160,160,
158,158,158,158,0,0,0,0,0,
149,149,149,149,149,149,0,149,149,
117,117,117,117,0,0,0,0,0,
0,0,107,107,107,0,0,107,0,
0,133,133,133,133,133,133,0,0,
0,123,123,123,123,123,123,0,123,
0,0,0,113,113,113,0,0,113,
102,102,0,102,102,102,0,102,102,
128,128,128,128,128,128,0,0,0,
118,118,118,118,0,0,118,118,0,
108,108,0,0,0,0,0,0,0,
98,98,0,98,98,98,0,98,0,
122,122,122,122,122,122,0,122,0,
0,0,0,112,112,112,0,0,0,
103,103,0,103,103,103,0,103,103,
0,0,0,94,0,0,0,94,94,
88,88,0,88,88,88,88,88,88,
84,84,0,0,0,0,0,84,84,
79,79,0,79,79,79,79,79,79,
0,0,0,0,0,0,0,82,0,
73,73,73,0,0,0,0,73,73,
72,72,0,0,72,72,0,72,72,
71,0,0,71,71,71,0,0,0,
0,0,70,70,70,70,70,70,0,
0,0,69,69,69,69,69,69,0,
68,68,68,68,68,0,68,68,0,
0,0,0,0,0,0,0,0,0,
0,0,0,0,0,0,0,0,0,
0,0,0,0,0,0,0,0,0.