[layer]
type=Tile Layer 1
data=
1,1,1,0,21,0,1,1,1,
1,1,0,0,21,0,0,0,1,
1,21,0,1,1,1,1,0,0,
1,1,1,1,1,21,1,1,1,
1,21,1,1,1,0,1,0,1,
1,0,1,1,1,21,1,0,1,
1,0,0,0,21,0,0,0,0,
1,1,1,21,1,1,1,1,1,
1,0,1,0,1,0,0,21,0,
1,21,1,1,1,0,1,1,1,
0,0,21,0,1,0,1,1,1,
1,1,1,21,1,1,1,1,1,
0,0,0,1,21,1,1,0,0,
0,21,1,1,1,1,0,1,0,
0,1,1,21,1,1,1,1,1,
0,0,1,1,1,0,1,1,21,
0,0,0,0,1,1,0,0,21,
0,21,1,1,1,1,1,1,0,
0,0,0,0,0,0,0,0,0,
0,0,0,0,0,0,0,0,0,
0,0,0,0,0,0,0,0,0.
[layer]
type=Tile Layer 2
data=
128,128,128,0,0,0,128,128,128,
127,127,0,0,0,0,0,0,127,
125,0,0,125,125,125,125,0,0,
78,78,78,78,78,0,78,78,78,
107,0,107,107,107,0,107,0,107,
98,0,98,98,98,0,98,0,98,
90,0,0,0,0,0,0,0,0,
74,74,74,0,74,74,74,74,74,
81,0,81,0,81,0,0,0,0,
69,0,69,69,69,0,69,69,69,
0,0,0,0,72,0,72,72,72,
64,64,64,0,64,64,64,64,64,
0,0,0,63,0,63,63,0,0,
0,0,62,62,62,62,0,62,0,
0,58,58,0,58,58,58,58,58,
0,0,60,60,60,0,60,60,0,
0,0,0,0,59,59,0,0,0,
0,0,58,58,58,58,58,58,0,
0,0,0,0,0,0,0,0,0,
0,0,0,0,0,0,0,0,0,
0,0,0,0,0,0,0,0,0.