[layer]
type=Tile Layer 1
data=
1,3,1,21,0,1,1,1,6,
1,1,5,1,21,0,1,3,1,
1,1,1,1,5,21,0,0,1,
0,0,21,1,4,1,1,0,5,
1,1,0,0,1,0,0,21,1,
1,1,6,21,1,0,2,2,1,
2,2,21,1,2,2,9,2,2,
2,21,1,5,1,2,2,2,1,
9,2,2,2,2,2,21,2,2,
1,21,2,2,2,2,7,2,2,
0,0,1,1,1,21,2,2,0,
1,0,5,21,1,1,2,2,1,
0,2,2,2,21,2,2,9,2,
0,0,1,0,1,21,2,0,0,
0,0,0,6,1,1,1,3,21,
0,0,0,0,0,0,0,0,0,
0,0,0,0,0,0,0,0,0,
0,0,0,0,0,0,0,0,0.
[layer]
type=Tile Layer 2
data=
89,89,89,0,0,89,89,89,89,
69,69,69,69,0,0,69,69,69,
72,72,72,72,72,0,0,0,72,
0,0,0,71,71,71,71,0,71,
64,64,0,0,64,0,0,0,64,
60,60,60,0,60,0,60,60,60,
62,62,0,3,62,49,49,62,62,
49,0,39,49,49,49,39,39,49,
41,41,41,41,51,41,0,41,41,
2,0,42,53,53,53,42,53,42,
0,0,42,2,42,0,42,52,0,
2,0,41,0,51,51,41,51,2,
0,50,50,50,0,50,50,50,50,
0,0,49,0,49,0,49,0,0,
0,0,0,48,48,48,48,48,0,
0,0,0,0,0,0,0,0,0,
0,0,0,0,0,0,0,0,0,
0,0,0,0,0,0,0,0,0.