[layer]
type=Tile Layer 1
data=
1,1,1,21,1,1,1,1,1,
1,0,1,0,0,21,0,0,1,
1,21,1,1,1,0,1,0,1,
1,21,1,1,1,0,1,0,1,
1,21,1,1,1,1,1,0,1,
0,21,1,1,1,0,1,0,1,
1,0,1,1,1,21,1,0,1,
1,0,0,21,0,0,0,0,0,
1,1,1,1,1,21,1,1,1,
1,1,1,1,1,1,1,21,0,
1,1,1,1,1,1,21,0,0,
1,1,1,1,1,0,21,1,0,
1,1,1,1,1,21,1,1,0,
1,1,1,1,0,21,0,1,0,
0,0,0,21,0,1,1,0,0,
0,0,1,1,1,1,1,0,21,
1,0,0,0,0,1,1,21,0,
1,1,1,1,21,1,1,0,1,
0,1,21,0,0,0,0,1,0,
0,1,0,1,21,1,0,1,0,
0,1,0,1,0,1,0,21,0,
0,1,21,1,0,1,1,1,0,
0,1,0,1,0,0,0,1,21,
0,1,21,1,1,1,0,1,1,
0,0,0,0,0,0,0,0,0,
0,0,0,0,0,0,0,0,0,
0,0,0,0,0,0,0,0,0.
[layer]
type=Tile Layer 2
data=
125,125,125,0,125,125,125,125,125,
137,0,137,0,0,0,0,0,137,
136,0,136,136,136,0,136,0,136,
110,0,110,110,110,0,110,0,110,
96,0,96,96,96,96,96,0,96,
0,0,91,91,91,0,91,0,91,
114,0,114,114,114,0,114,0,114,
105,0,0,0,0,0,0,0,0,
87,87,87,87,87,0,87,87,87,
83,83,83,83,83,83,83,0,0,
108,108,108,108,108,108,0,0,0,
99,99,99,99,99,0,0,99,0,
87,87,87,87,87,0,87,87,0,
83,83,83,83,0,0,0,83,0,
0,0,0,0,0,82,82,0,0,
0,0,74,74,74,74,74,0,0,
73,0,0,0,0,73,73,0,0,
68,68,68,68,0,68,68,0,68,
0,64,0,0,0,0,0,64,0,
0,63,0,63,0,63,0,63,0,
0,62,0,62,0,62,0,0,0,
0,61,0,61,0,61,61,61,0,
0,60,0,60,0,0,0,60,0,
0,59,0,59,59,59,0,59,59,
0,0,0,0,0,0,0,0,0,
0,0,0,0,0,0,0,0,0,
0,0,0,0,0,0,0,0,0.