[layer]
type=Tile Layer 1
data=
3,4,1,1,21,1,1,1,1,
0,1,21,0,1,1,1,0,5,
5,1,1,1,21,1,1,1,4,
0,1,1,1,1,0,21,0,6,
1,21,0,5,1,1,1,0,0,
1,1,21,1,1,3,3,0,1,
1,1,0,0,0,21,0,0,1,
3,0,0,21,0,6,1,0,0,
1,0,1,1,0,21,0,4,1,
1,21,0,4,3,1,0,1,1,
0,21,0,0,0,0,0,5,1,
0,1,21,4,1,1,1,1,1,
1,1,1,21,1,0,0,0,0,
1,1,6,21,1,1,1,1,6,
0,0,3,0,1,21,1,1,4,
1,1,6,21,4,0,1,1,1,
1,1,1,0,0,0,1,21,0,
5,4,1,21,1,1,1,0,1,
1,1,1,21,1,1,1,0,1,
1,5,1,1,1,1,6,21,1,
0,0,21,0,5,1,3,0,3,
1,1,1,1,1,21,1,1,1,
1,0,3,21,0,0,6,3,1,
1,21,1,1,1,0,5,5,1,
1,21,4,1,1,0,1,0,0,
1,21,1,1,1,0,3,1,1,
1,21,3,1,4,0,1,6,1,
5,21,1,1,1,0,1,1,1,
1,0,21,0,1,0,1,6,1,
1,5,1,21,6,0,1,3,1,
5,1,1,1,0,21,0,0,0,
0,0,0,0,1,4,21,1,0,
0,1,6,1,1,1,0,21,1,
0,0,0,21,1,3,1,0,0,
1,1,1,0,0,21,0,0,0,
1,1,1,21,5,5,1,1,6,
5,4,1,0,21,1,0,0,0,
1,6,1,1,1,1,21,1,0,
4,1,0,0,0,21,0,1,0,
1,21,1,0,1,1,1,1,1,
1,0,3,0,21,0,6,0,1,
1,21,1,3,5,1,1,0,1,
4,21,0,0,0,0,0,0,1,
1,21,1,3,1,6,1,0,1,
1,0,4,1,1,1,1,21,0,
0,0,0,0,0,0,0,0,0,
0,0,0,0,0,0,0,0,0,
0,0,0,0,0,0,0,0,0.
[layer]
type=Tile Layer 2
data=
198,198,198,198,0,198,198,198,198,
0,206,0,0,206,206,206,0,206,
194,194,194,194,0,194,194,194,194,
0,178,178,178,178,0,0,0,178,
165,0,0,165,165,165,165,0,0,
152,152,0,152,152,152,152,0,152,
138,138,0,0,0,0,0,0,138,
173,0,0,0,0,173,173,0,0,
160,0,160,160,0,0,0,160,160,
147,0,0,147,147,147,0,147,147,
0,0,0,0,0,0,0,134,134,
0,167,0,167,167,167,167,167,167,
154,154,154,0,154,0,0,0,0,
135,135,135,0,135,135,135,135,135,
0,0,130,0,130,0,130,130,130,
162,162,162,0,162,0,162,162,162,
149,149,149,0,0,0,149,0,0,
137,137,137,0,137,137,137,0,137,
125,125,125,0,125,125,125,0,125,
148,148,148,148,148,148,148,0,148,
0,0,0,0,144,144,144,0,144,
126,126,126,126,126,0,126,126,126,
121,0,121,0,0,0,121,121,121,
150,0,150,150,150,0,150,150,150,
139,0,139,139,139,0,139,0,0,
128,0,128,128,128,0,128,128,128,
116,0,116,116,116,0,116,116,116,
145,0,145,145,145,0,145,145,145,
134,0,0,0,134,0,134,134,134,
123,123,123,0,123,0,123,123,123,
112,112,112,112,0,0,0,0,0,
0,0,0,0,139,139,0,139,0,
0,128,128,128,128,128,0,0,128,
0,0,0,0,118,118,118,0,0,
108,108,108,0,0,0,0,0,0,
102,102,102,0,102,102,102,102,102,
97,97,97,0,0,97,0,0,0,
96,96,96,96,96,96,0,96,0,
95,95,0,0,0,0,0,95,0,
85,0,85,0,85,85,85,85,85,
84,0,84,0,0,0,84,0,84,
83,0,83,83,83,83,83,0,83,
82,0,0,0,0,0,0,0,82,
81,0,81,81,81,81,81,0,81,
80,0,80,80,80,80,80,0,0,
0,0,0,0,0,0,0,0,0,
0,0,0,0,0,0,0,0,0,
0,0,0,0,0,0,0,0,0.