[layer]
type=Tile Layer 1
data=
0,0,0,21,1,0,1,1,6,
1,5,1,21,1,1,1,1,1,
1,4,5,21,1,0,4,1,1,
1,1,1,21,1,0,4,1,1,
3,1,1,0,0,0,0,21,0,
1,1,1,21,4,6,1,0,1,
1,6,1,21,3,5,0,0,1,
1,1,0,0,0,21,0,0,1,
6,1,21,0,1,1,1,1,0,
1,1,1,21,0,0,0,0,0,
1,4,6,1,1,3,1,1,21,
1,1,0,0,1,1,6,21,0,
0,0,0,21,0,0,0,1,1,
0,1,6,4,1,1,21,0,0,
0,0,0,0,1,1,0,0,21,
0,0,1,1,1,21,6,1,1,
1,21,5,3,1,0,1,1,6,
1,21,0,0,0,0,1,1,1,
1,1,3,21,1,4,1,1,1,
1,1,1,0,0,0,3,21,0,
1,1,5,21,1,1,1,4,1,
0,0,1,21,1,1,5,1,1,
1,1,6,21,4,1,1,1,1,
4,1,1,0,0,0,0,21,0,
4,1,1,1,21,5,0,1,1,
0,1,0,0,21,1,0,1,1,
0,1,1,1,0,4,21,1,3,
0,1,1,6,0,0,0,0,21,
1,1,1,5,21,1,1,1,4,
0,1,1,1,21,1,5,1,1,
0,1,1,6,21,1,5,1,1,
0,0,0,0,21,5,1,1,1,
21,1,1,1,1,4,4,1,1,
5,1,1,4,0,0,21,0,1,
1,1,1,0,0,21,0,0,3,
1,1,1,21,1,5,1,1,1,
0,0,0,0,1,0,0,21,4,
1,1,6,21,1,1,0,1,3,
1,4,1,21,0,0,0,1,1,
4,1,0,0,1,1,0,21,0,
0,21,1,0,1,3,0,1,1,
0,21,0,0,0,0,0,6,1,
0,0,0,1,1,1,1,1,21,
1,1,21,1,6,5,1,4,0,
0,1,0,6,21,0,0,0,0,
0,1,1,1,1,3,21,4,1,
0,3,1,1,4,1,21,1,0,
0,1,1,1,1,1,21,5,0,
0,0,0,0,0,0,0,0,0,
0,0,0,0,0,0,0,0,0,
0,0,0,0,0,0,0,0,0.
[layer]
type=Tile Layer 2
data=
0,0,0,0,228,0,228,228,228,
216,216,216,0,216,216,216,216,216,
225,225,225,0,225,0,225,225,225,
183,183,183,0,183,0,183,183,183,
168,168,168,0,0,0,0,0,0,
154,154,154,0,154,154,154,0,154,
192,192,192,0,192,192,0,0,192,
178,178,0,0,0,0,0,0,178,
164,164,0,0,164,164,164,164,0,
149,149,149,0,0,0,0,0,0,
178,178,178,178,178,178,178,178,0,
173,173,0,0,173,173,173,0,0,
0,0,0,0,0,0,0,159,159,
0,145,145,145,145,145,0,0,0,
0,0,0,0,181,181,0,0,0,
0,0,167,167,167,0,167,167,167,
154,0,154,154,154,0,154,154,154,
141,0,0,0,0,0,141,141,141,
167,167,167,0,167,167,167,167,167,
162,162,162,0,0,0,162,0,0,
142,142,142,0,142,142,142,142,142,
0,0,136,0,136,136,136,136,136,
162,162,162,0,162,162,162,162,162,
157,157,157,0,0,0,0,0,0,
144,144,144,144,0,144,0,144,144,
0,132,0,0,0,132,0,132,132,
0,164,164,164,0,164,0,164,164,
0,152,152,152,0,0,0,0,0,
133,133,133,133,0,133,133,133,133,
0,127,127,127,0,127,127,127,127,
0,159,159,159,0,159,159,159,159,
0,0,0,0,0,147,147,147,147,
0,128,128,128,128,128,128,128,128,
123,123,123,123,0,0,0,0,123,
153,153,153,0,0,0,0,0,153,
135,135,135,0,135,135,135,135,135,
0,0,0,0,130,0,0,0,130,
119,119,119,0,119,119,0,119,119,
118,118,118,0,0,0,0,118,118,
107,107,0,0,107,107,0,0,0,
0,0,106,0,106,106,0,106,106,
0,0,0,0,0,0,0,105,105,
0,0,0,94,94,94,94,94,0,
93,93,0,93,93,93,93,93,0,
0,92,0,92,0,0,0,0,0,
0,91,91,91,91,91,0,91,91,
0,90,90,90,90,90,0,90,0,
0,89,89,89,89,89,0,89,0,
0,0,0,0,0,0,0,0,0,
0,0,0,0,0,0,0,0,0,
0,0,0,0,0,0,0,0,0.