[layer]
type=Tile Layer 1
data=
4,0,1,21,1,5,1,0,1,
0,21,1,0,6,1,1,0,5,
1,21,1,0,1,1,1,0,1,
1,5,1,1,6,1,0,21,0,
3,1,1,1,21,0,0,1,0,
1,3,1,1,21,1,1,0,0,
3,1,1,4,0,0,21,0,1,
1,6,0,0,0,0,0,21,0,
1,1,0,1,1,1,1,21,0,
1,1,0,21,4,1,1,0,0,
3,1,21,0,1,1,1,0,0,
1,5,21,1,1,1,1,0,5,
4,1,1,21,1,1,1,1,1,
0,21,1,0,1,5,4,1,1,
6,21,1,0,1,1,1,6,1,
1,0,1,21,0,0,0,0,0,
1,21,1,4,1,1,1,6,5,
1,0,0,0,21,0,0,0,0,
1,1,1,1,1,6,1,21,1,
0,21,1,4,4,1,1,0,1,
1,21,1,5,5,1,1,1,6,
1,4,1,5,0,0,21,0,1,
1,1,1,1,1,1,21,1,0,
1,1,6,1,1,5,21,6,0,
1,21,0,0,0,0,0,0,1,
1,0,4,1,1,3,21,0,1,
1,1,21,1,1,6,0,0,0,
0,0,0,0,0,0,0,0,0,
0,0,0,0,0,0,0,0,0,
0,0,0,0,0,0,0,0,0.
[layer]
type=Tile Layer 2
data=
160,0,160,0,160,160,160,0,160,
0,0,158,0,158,158,158,0,158,
157,0,157,0,157,157,157,0,157,
117,117,117,117,117,117,0,0,0,
107,107,107,107,0,0,0,107,0,
133,133,133,133,0,133,133,0,0,
123,123,123,123,0,0,0,0,123,
113,113,0,0,0,0,0,0,0,
102,102,0,102,102,102,102,0,0,
128,128,0,0,128,128,128,0,0,
118,118,0,0,118,118,118,0,0,
108,108,0,108,108,108,108,0,108,
93,93,93,0,93,93,93,93,93,
0,0,122,0,122,122,122,122,122,
112,0,112,0,112,112,112,112,112,
103,0,103,0,0,0,0,0,0,
89,0,89,89,89,89,89,89,89,
93,0,0,0,0,0,0,0,0,
80,80,80,80,80,80,80,0,80,
0,0,83,83,83,83,83,0,83,
78,0,78,78,78,78,78,78,78,
73,73,73,73,0,0,0,0,73,
72,72,72,72,72,72,0,72,0,
71,71,71,71,71,71,0,71,0,
70,0,0,0,0,0,0,0,70,
69,0,69,69,69,69,0,0,69,
68,68,0,68,68,68,0,0,0,
0,0,0,0,0,0,0,0,0,
0,0,0,0,0,0,0,0,0,
0,0,0,0,0,0,0,0,0.