[layer]
type=Tile Layer 1
data=
1,21,1,3,1,1,1,1,1,
0,0,21,0,5,0,0,0,0,
1,4,1,1,3,1,1,21,1,
4,21,0,0,0,0,1,0,1,
3,1,1,1,1,1,1,21,1,
5,1,1,21,5,1,1,0,1,
1,1,1,1,21,0,0,0,1,
0,1,3,6,21,1,1,5,1,
0,1,6,1,21,1,1,3,1,
0,21,1,6,0,1,1,1,1,
1,21,1,6,0,3,1,1,4,
0,0,1,1,0,21,0,0,1,
0,0,0,0,0,1,5,21,1,
1,3,6,1,1,1,1,21,1,
1,21,0,0,0,0,0,0,0,
1,0,1,1,3,21,5,0,0,
1,0,1,6,1,21,1,0,1,
0,0,1,0,0,21,1,0,6,
5,5,1,21,1,1,1,0,1,
0,0,0,0,1,0,21,0,0,
1,1,1,3,1,21,1,6,1,
0,0,0,0,0,0,0,0,0,
0,0,0,0,0,0,0,0,0,
0,0,0,0,0,0,0,0,0.
[layer]
type=Tile Layer 2
data=
120,0,120,120,120,120,120,120,120,
0,0,0,0,132,0,0,0,0,
117,117,117,117,117,117,117,0,117,
113,0,0,0,0,0,113,0,113,
94,94,94,94,94,94,94,0,94,
90,90,90,0,90,90,90,0,90,
86,86,86,86,0,0,0,0,86,
0,102,102,102,0,102,102,102,102,
0,94,94,94,0,94,94,94,94,
0,0,90,90,0,90,90,90,90,
78,0,78,78,0,78,78,78,78,
0,0,81,81,0,0,0,0,81,
0,0,0,0,0,73,73,0,73,
65,65,65,65,65,65,65,0,65,
71,0,0,0,0,0,0,0,0,
63,0,63,63,63,0,63,0,0,
62,0,62,62,62,0,62,0,62,
0,0,61,0,0,0,61,0,61,
57,57,57,0,57,57,57,0,57,
0,0,0,0,59,0,0,0,0,
53,53,53,53,53,0,53,53,53,
0,0,0,0,0,0,0,0,0,
0,0,0,0,0,0,0,0,0,
0,0,0,0,0,0,0,0,0.