[layer]
type=Tile Layer 1
data=
0,3,5,5,21,1,1,1,6,
0,1,1,1,21,1,1,1,1,
0,0,0,1,1,0,21,0,0,
0,5,0,0,21,0,0,1,1,
21,1,1,3,1,1,1,3,4,
0,21,0,0,0,1,1,1,1,
1,21,1,1,1,4,1,0,1,
1,0,0,0,0,0,0,21,0,
1,21,1,4,1,6,1,0,3,
1,21,6,1,1,3,1,0,1,
1,21,1,1,5,1,1,0,6,
0,0,1,0,1,0,1,21,0,
3,21,1,1,1,0,1,1,5,
1,0,0,21,1,0,1,0,1,
1,0,1,6,5,21,1,0,1,
6,0,0,0,1,0,21,0,1,
1,1,21,1,5,4,0,1,1,
6,21,1,1,1,0,1,1,1,
0,0,1,1,21,1,4,1,0,
0,5,0,1,0,1,21,1,0,
1,21,0,0,1,0,0,0,6,
0,0,0,0,0,0,0,0,0,
0,0,0,0,0,0,0,0,0,
0,0,0,0,0,0,0,0,0.
[layer]
type=Tile Layer 2
data=
0,127,127,127,0,127,127,127,127,
0,125,125,125,0,125,125,125,125,
0,0,0,130,130,0,0,0,0,
0,113,0,0,0,0,0,113,113,
0,94,94,94,94,94,94,94,94,
0,0,0,0,0,95,95,95,95,
82,0,82,82,82,82,82,0,82,
107,0,0,0,0,0,0,0,0,
94,0,94,94,94,94,94,0,94,
86,0,86,86,86,86,86,0,86,
78,0,78,78,78,78,78,0,78,
0,0,81,0,81,0,81,0,0,
69,0,69,69,69,0,69,69,69,
72,0,0,0,72,0,72,0,72,
71,0,71,71,71,0,71,0,71,
63,0,0,0,63,0,0,0,63,
59,59,0,59,59,59,0,59,59,
58,0,58,58,58,0,58,58,58,
0,0,60,60,0,60,60,60,0,
0,59,0,59,0,59,0,59,0,
58,0,0,0,58,0,0,0,58,
0,0,0,0,0,0,0,0,0,
0,0,0,0,0,0,0,0,0,
0,0,0,0,0,0,0,0,0.