[layer]
type=Tile Layer 1
data=
0,1,0,10,21,0,0,1,0,
0,2,20,2,2,2,21,2,0,
0,2,2,7,2,21,2,2,2,
2,2,20,2,21,2,2,2,0,
0,0,2,10,0,1,21,0,0,
0,2,2,2,2,1,21,5,1,
9,2,21,2,2,2,0,2,2,
2,2,0,5,21,2,20,0,2,
0,1,3,0,1,1,2,21,4,
2,0,0,21,0,0,0,0,2,
2,2,2,21,20,2,2,2,2,
0,4,1,21,0,2,5,1,0,
0,0,0,0,0,0,0,0,0,
0,0,0,0,0,0,0,0,0,
0,0,0,0,0,0,0,0,0.
[layer]
type=Tile Layer 2
data=
0,88,0,88,0,0,0,88,0,
0,63,0,63,63,63,0,63,0,
0,62,62,62,62,0,62,62,62,
61,61,0,61,0,61,61,61,0,
0,0,54,54,0,54,0,0,0,
0,50,50,50,50,50,0,50,50,
52,52,0,52,52,52,0,52,52,
51,51,0,51,0,51,0,0,51,
0,50,50,0,50,50,50,0,50,
49,0,0,0,0,0,0,0,49,
46,46,46,0,0,46,46,46,46,
0,47,47,0,0,47,47,47,0,
0,0,0,0,0,0,0,0,0,
0,0,0,0,0,0,0,0,0,
0,0,0,0,0,0,0,0,0.