[layer]
type=Tile Layer 1
data=
0,3,6,1,21,1,0,0,1,
1,6,6,1,0,0,21,5,3,
0,5,5,5,1,3,21,0,0,
0,0,1,0,0,21,1,5,4,
0,0,1,0,1,21,0,3,1,
0,4,5,3,4,21,0,0,0,
6,5,3,21,1,1,5,1,5,
0,4,3,1,21,5,5,6,0,
6,1,21,3,1,3,1,1,6,
1,1,5,5,1,1,4,1,21,
0,4,1,1,1,1,21,5,0,
0,4,0,1,6,1,0,0,21,
0,0,0,0,0,0,0,0,0,
0,0,0,0,0,0,0,0,0,
0,0,0,0,0,0,0,0,0.
[layer]
type=Tile Layer 2
data=
0,83,83,83,0,83,0,0,83,
58,58,58,58,0,0,0,58,58,
0,58,58,58,58,58,0,0,0,
0,0,57,0,0,0,57,57,57,
0,0,50,0,50,0,0,50,50,
0,49,49,49,39,0,0,0,0,
48,48,48,0,2,2,48,48,48,
0,48,38,38,0,38,38,48,0,
47,2,0,37,2,37,2,2,47,
2,2,37,37,2,37,37,2,0,
0,36,2,36,2,2,0,36,0,
0,44,0,44,44,44,0,0,0,
0,0,0,0,0,0,0,0,0,
0,0,0,0,0,0,0,0,0,
0,0,0,0,0,0,0,0,0.