[layer]
type=Tile Layer 1
data=
1,21,1,1,1,1,1,1,1,
1,0,1,1,1,21,0,0,0,
1,21,1,1,1,0,1,0,1,
1,0,1,1,1,21,1,0,1,
1,21,1,1,1,0,1,1,1,
1,21,0,0,0,0,1,0,1,
1,1,1,21,0,1,1,1,1,
2,2,2,21,18,2,2,2,2,
0,21,1,0,1,1,1,1,1,
0,1,1,21,0,1,1,1,1,
0,1,1,1,0,0,0,21,1,
18,21,0,2,2,2,2,0,2,
1,1,21,0,1,1,1,0,0,
1,0,1,1,0,21,0,0,1,
1,21,0,0,0,1,2,2,1,
2,21,2,2,2,2,2,20,2,
2,21,2,0,0,0,2,20,2,
1,21,1,0,1,2,2,0,1,
0,0,2,18,2,21,19,0,2,
1,0,1,21,1,0,2,0,1,
0,18,2,0,2,21,2,0,2,
0,0,0,0,0,0,0,0,0,
0,0,0,0,0,0,0,0,0,
0,0,0,0,0,0,0,0,0.
[layer]
type=Tile Layer 2
data=
120,0,120,120,120,120,120,120,120,
132,0,132,132,132,0,0,0,0,
130,0,130,130,130,0,130,0,130,
113,0,113,113,113,0,113,0,113,
99,0,99,99,99,0,99,99,99,
95,0,0,0,0,0,95,0,95,
82,82,82,0,0,82,82,82,82,
102,102,102,0,0,102,102,102,102,
0,0,98,0,98,98,98,98,98,
0,90,90,0,0,90,90,90,90,
0,82,82,82,0,0,0,0,82,
0,0,0,81,81,81,81,0,81,
73,73,0,0,73,73,73,0,0,
72,0,72,72,0,0,0,0,72,
71,0,0,0,0,71,71,71,71,
60,0,60,60,60,60,60,0,60,
62,0,62,0,0,0,62,0,62,
61,0,61,0,61,61,61,0,61,
0,0,60,0,60,0,0,0,60,
59,0,59,0,59,0,59,0,59,
0,0,58,0,58,0,58,0,58,
0,0,0,0,0,0,0,0,0,
0,0,0,0,0,0,0,0,0,
0,0,0,0,0,0,0,0,0.