[layer]
type=Tile Layer 1
data=
1,21,1,5,1,1,1,1,0,
5,21,0,0,1,1,1,4,0,
1,4,1,1,1,3,1,1,21,
0,0,0,0,1,1,1,21,3,
0,1,1,1,0,0,0,21,1,
0,0,0,21,1,1,1,4,6,
0,0,21,1,0,1,0,6,1,
6,4,0,1,21,1,0,1,1,
1,1,0,3,0,21,0,1,1,
4,1,1,1,1,1,21,3,5,
0,0,0,21,0,1,0,1,0,
1,1,1,1,1,1,21,4,1,
0,5,0,21,0,0,0,1,0,
0,1,21,1,1,1,4,6,0,
0,0,0,1,1,1,1,1,21,
1,1,21,0,1,1,0,0,0,
1,1,6,1,5,21,0,1,4,
1,1,21,1,5,1,1,1,0,
0,1,0,0,5,1,0,0,21,
0,1,3,1,1,1,1,1,21,
1,0,0,21,5,6,1,0,0,
0,0,0,0,0,0,0,0,0,
0,0,0,0,0,0,0,0,0,
0,0,0,0,0,0,0,0,0.
[layer]
type=Tile Layer 2
data=
127,0,127,127,127,127,127,127,0,
132,0,0,0,132,132,132,132,0,
117,117,117,117,117,117,117,117,0,
0,0,0,0,113,113,113,0,113,
0,104,104,104,0,0,0,0,104,
0,0,0,0,95,95,95,95,95,
0,0,0,86,0,86,0,86,86,
107,107,0,107,0,107,0,107,107,
98,98,0,98,0,0,0,98,98,
81,81,81,81,81,81,0,81,81,
0,0,0,0,0,82,0,82,0,
73,73,73,73,73,73,0,73,73,
0,73,0,0,0,0,0,73,0,
0,72,0,72,72,72,72,72,0,
0,0,0,71,71,71,71,71,0,
63,63,0,0,63,63,0,0,0,
59,59,59,59,59,0,0,59,59,
58,58,0,58,58,58,58,58,0,
0,60,0,0,60,60,0,0,0,
0,57,57,57,57,57,57,57,0,
58,0,0,0,58,58,58,0,0,
0,0,0,0,0,0,0,0,0,
0,0,0,0,0,0,0,0,0,
0,0,0,0,0,0,0,0,0.