[layer]
type=Tile Layer 1
data=
0,0,0,1,3,1,21,1,1,
1,5,21,1,3,1,0,1,1,
0,1,21,1,0,1,0,6,0,
1,1,1,1,21,1,0,1,1,
6,1,1,5,21,1,0,0,0,
1,4,4,1,21,1,0,5,1,
0,1,1,4,0,1,21,0,0,
0,1,1,3,21,1,1,1,1,
0,21,0,5,0,0,0,0,0,
1,1,1,1,21,1,4,1,1,
5,1,1,1,21,1,1,3,0,
3,5,1,1,21,1,1,4,0,
0,21,0,1,0,1,1,1,0,
0,6,1,5,21,1,1,1,3,
0,1,6,1,0,0,0,0,21,
4,1,1,21,1,3,5,0,1,
1,0,0,0,3,0,21,0,1,
1,21,1,1,1,0,1,1,1,
1,0,0,0,0,21,6,0,0,
1,1,5,1,1,1,4,21,1,
0,0,0,0,0,0,21,0,1,
1,1,1,1,1,4,21,1,1,
0,0,1,21,0,0,0,0,0,
3,1,6,21,1,6,1,1,1,
0,1,1,1,0,21,1,1,1,
0,1,1,1,0,21,4,1,1,
0,0,21,6,6,0,1,1,3,
1,5,21,0,1,0,0,0,0,
1,1,3,21,1,1,1,4,0,
1,1,21,1,5,1,1,0,1,
1,1,0,0,0,21,1,1,0,
5,1,1,6,1,1,21,3,0,
1,1,1,1,1,3,1,21,0,
1,1,1,21,0,1,5,1,1,
6,1,5,21,0,1,4,1,1,
0,0,4,21,1,1,1,1,1,
0,1,1,21,0,1,1,1,3,
0,1,5,1,21,0,0,0,1,
0,0,0,1,6,5,1,21,1,
0,0,0,0,0,0,0,0,0,
0,0,0,0,0,0,0,0,0,
0,0,0,0,0,0,0,0,0.
[layer]
type=Tile Layer 2
data=
0,0,0,198,198,198,0,198,198,
196,196,0,196,196,196,0,196,196,
0,195,0,195,0,195,0,195,0,
147,147,147,147,0,147,0,147,147,
134,134,134,134,0,134,0,0,0,
167,167,167,167,0,167,0,167,167,
0,154,154,154,0,154,0,0,0,
0,142,142,142,0,142,142,142,142,
0,0,0,130,0,0,0,0,0,
154,154,154,154,0,154,154,154,154,
149,149,149,149,0,149,149,149,0,
137,137,137,137,0,137,137,137,0,
0,0,0,125,0,125,125,125,0,
0,156,156,156,0,156,156,156,156,
0,144,144,144,0,0,0,0,0,
132,132,132,0,132,132,132,0,132,
121,0,0,0,121,0,0,0,121,
150,0,150,150,150,0,150,150,150,
139,0,0,0,0,0,139,0,0,
122,122,122,122,122,122,122,0,122,
0,0,0,0,0,0,0,0,116,
138,138,138,138,138,138,0,138,138,
0,0,134,0,0,0,0,0,0,
117,117,117,0,117,117,117,117,117,
0,112,112,112,0,0,112,112,112,
0,139,139,139,0,0,139,139,139,
0,0,0,128,128,0,128,128,128,
118,118,0,0,118,0,0,0,0,
108,108,108,0,108,108,108,108,0,
107,107,0,107,107,107,107,0,107,
97,97,0,0,0,0,97,97,0,
96,96,96,96,96,96,0,96,0,
95,95,95,95,95,95,95,0,0,
85,85,85,0,0,85,85,85,85,
84,84,84,0,0,84,84,84,84,
0,0,83,0,83,83,83,83,83,
0,82,82,0,0,82,82,82,82,
0,81,81,81,0,0,0,0,81,
0,0,0,80,80,80,80,0,80,
0,0,0,0,0,0,0,0,0,
0,0,0,0,0,0,0,0,0,
0,0,0,0,0,0,0,0,0.