[layer]
type=Tile Layer 1
data=
1,1,0,1,0,21,0,0,0,
1,1,21,1,1,1,1,1,0,
1,1,0,21,0,1,0,0,0,
1,1,1,1,21,1,1,1,0,
0,0,0,0,0,0,21,1,0,
1,1,1,1,1,1,21,1,1,
0,21,0,1,1,1,1,1,1,
0,1,21,1,1,1,1,1,1,
0,1,21,0,0,1,1,1,1,
0,0,1,1,0,21,1,1,1,
1,21,0,0,0,1,0,1,1,
1,1,1,1,1,1,21,1,1,
0,0,0,21,1,1,0,1,1,
0,0,1,1,0,0,21,1,1,
1,1,21,0,1,1,1,1,1,
1,0,0,21,0,0,1,0,0,
1,1,1,1,1,1,1,21,1,
0,0,21,0,0,0,1,0,1,
1,1,1,1,1,21,1,0,1,
0,0,0,21,1,0,1,0,1,
1,0,1,0,1,21,1,0,1,
0,0,0,0,0,0,0,0,0,
0,0,0,0,0,0,0,0,0,
0,0,0,0,0,0,0,0,0.
[layer]
type=Tile Layer 2
data=
133,133,0,133,0,0,0,0,0,
125,125,0,125,125,125,125,125,0,
130,130,0,0,0,130,0,0,0,
107,107,107,107,0,107,107,107,0,
0,0,0,0,0,0,0,104,0,
86,86,86,86,86,86,0,86,86,
0,0,0,86,86,86,86,86,86,
0,102,0,102,102,102,102,102,102,
0,98,0,0,0,98,98,98,98,
0,0,90,90,0,0,90,90,90,
82,0,0,0,0,82,0,82,82,
73,73,73,73,73,73,0,73,73,
0,0,0,0,73,73,0,73,73,
0,0,72,72,0,0,0,72,72,
67,67,0,0,67,67,67,67,67,
63,0,0,0,0,0,63,0,0,
56,56,56,56,56,56,56,0,56,
0,0,0,0,0,0,61,0,61,
57,57,57,57,57,0,57,0,57,
0,0,0,0,59,0,59,0,59,
58,0,58,0,58,0,58,0,58,
0,0,0,0,0,0,0,0,0,
0,0,0,0,0,0,0,0,0,
0,0,0,0,0,0,0,0,0.