[layer]
type=Tile Layer 1
data=
0,1,1,1,0,1,0,3,21,
0,2,2,1,21,1,1,5,6,
0,19,21,0,0,1,3,1,1,
1,2,2,1,21,6,3,6,1,
1,1,5,1,21,3,1,1,1,
1,1,1,1,21,1,1,1,5,
2,2,2,2,21,0,0,2,18,
1,1,1,1,21,3,5,2,24,
0,0,0,1,0,1,21,0,0,
1,1,1,1,3,21,0,2,24,
1,0,0,0,0,21,0,1,0,
0,24,0,1,1,5,21,0,0,
0,2,18,0,0,0,21,2,2,
0,3,0,0,0,1,0,0,21,
1,1,1,21,1,6,1,1,1,
0,1,21,0,1,1,4,1,5,
0,0,0,0,1,21,0,4,1,
0,0,1,21,1,1,0,6,1,
1,21,1,1,1,1,1,0,1,
4,0,1,6,4,0,1,21,0,
5,21,1,1,1,0,1,0,1,
1,0,0,0,21,0,5,0,1,
2,21,2,2,2,2,2,18,2,
1,0,1,4,1,1,1,21,0,
6,21,1,1,1,1,1,5,1,
4,21,1,1,1,1,1,0,1,
1,21,1,1,1,5,4,0,6,
1,4,21,5,4,1,0,1,1,
1,1,21,1,1,1,0,1,1,
0,2,0,21,0,6,0,1,1,
19,2,21,3,1,1,5,1,1,
0,2,0,0,0,0,0,0,21,
1,5,1,6,21,1,1,1,1,
6,1,1,4,21,3,1,1,1,
1,1,1,2,21,2,1,1,1,
0,1,21,0,24,2,1,4,1,
4,1,1,0,21,1,0,6,1,
2,2,2,2,21,2,0,0,18,
1,1,1,5,21,0,1,1,0,
0,21,0,1,1,0,1,0,1,
0,1,21,1,1,4,0,0,5,
0,0,0,0,1,1,0,6,21,
1,1,0,21,1,1,0,5,0,
1,1,21,0,0,0,0,0,1,
5,3,4,1,1,21,1,0,1,
2,21,2,2,2,2,2,18,2,
0,21,2,2,2,2,2,18,2,
1,1,1,3,6,1,1,21,1,
0,0,0,0,0,0,0,21,1,
1,1,5,21,1,1,1,6,1,
0,18,2,0,0,0,21,0,0,
0,0,0,0,0,0,0,0,0,
0,0,0,0,0,0,0,0,0,
0,0,0,0,0,0,0,0,0.
[layer]
type=Tile Layer 2
data=
0,234,234,234,0,234,0,234,0,
0,233,233,233,0,233,233,233,233,
0,0,0,0,0,231,231,231,231,
166,166,166,166,0,166,166,166,166,
152,152,152,152,0,152,152,152,152,
189,189,189,189,0,189,189,189,189,
184,184,184,184,0,0,0,184,0,
169,169,169,169,0,169,169,169,0,
0,0,0,155,0,155,0,0,0,
193,193,193,193,193,0,0,193,0,
179,0,0,0,0,0,0,179,0,
0,0,0,165,165,165,0,0,0,
0,150,0,0,0,0,0,150,150,
0,188,0,0,0,188,0,0,0,
165,165,165,0,165,165,165,165,165,
0,160,0,0,160,160,160,160,160,
0,0,0,0,146,0,0,146,146,
0,0,182,0,182,182,0,182,182,
168,0,168,168,168,168,168,0,168,
155,0,155,155,155,0,155,0,0,
142,0,142,142,142,0,142,0,142,
177,0,0,0,0,0,177,0,177,
163,0,163,163,163,163,163,0,163,
150,0,150,150,150,150,150,0,0,
131,0,131,131,131,131,131,131,131,
171,0,171,171,171,171,171,0,171,
158,0,158,158,158,158,158,0,158,
145,145,0,145,145,145,0,145,145,
133,133,0,133,133,133,0,133,133,
0,165,0,0,0,165,0,165,165,
0,153,0,153,153,153,153,153,153,
0,141,0,0,0,0,0,0,0,
122,122,122,122,0,122,122,122,122,
152,152,152,152,0,152,152,152,152,
141,141,141,141,0,141,141,141,141,
0,136,0,0,0,136,136,136,136,
124,124,124,0,0,124,0,124,124,
154,154,154,154,0,154,0,0,0,
142,142,142,142,0,0,142,142,0,
0,0,0,131,131,0,131,0,131,
0,120,0,120,120,120,0,0,120,
0,0,0,0,119,119,0,119,0,
108,108,0,0,108,108,0,108,0,
107,107,0,0,0,0,0,0,107,
106,106,106,106,106,0,106,0,106,
95,0,95,95,95,95,95,0,95,
0,0,94,94,94,94,94,0,94,
89,89,89,89,89,89,89,0,89,
0,0,0,0,0,0,0,0,92,
87,87,87,0,87,87,87,87,87,
0,0,90,0,0,0,0,0,0,
0,0,0,0,0,0,0,0,0,
0,0,0,0,0,0,0,0,0,
0,0,0,0,0,0,0,0,0.