[layer]
type=Tile Layer 1
data=
1,1,21,1,1,0,1,1,1,
1,1,0,21,0,0,0,1,1,
1,1,1,0,0,0,21,0,1,
1,1,1,1,1,21,1,0,1,
1,1,1,1,1,21,1,0,1,
1,1,1,0,0,21,0,0,0,
1,1,1,0,21,1,1,1,0,
1,0,0,0,1,21,0,0,0,
1,0,0,21,0,0,1,1,1,
1,1,1,0,0,21,1,0,1,
1,1,1,21,1,1,1,1,1,
1,0,1,21,1,1,1,0,0,
1,0,1,21,1,1,1,0,1,
1,0,1,21,1,1,1,0,1,
1,21,1,1,1,1,1,0,1,
1,21,1,0,0,0,0,0,0,
1,21,1,0,1,1,1,0,1,
1,0,0,21,1,0,1,0,1,
0,0,1,1,1,1,0,21,1,
0,1,1,1,1,1,1,0,21,
0,1,0,21,1,1,1,1,0,
0,1,0,21,1,1,1,1,0,
0,21,0,1,1,1,1,1,0,
0,0,1,1,1,0,1,1,21,
0,0,0,0,0,0,0,0,0,
0,0,0,0,0,0,0,0,0,
0,0,0,0,0,0,0,0,0.
[layer]
type=Tile Layer 2
data=
131,131,0,131,131,0,131,131,131,
136,136,0,0,0,0,0,136,136,
135,135,135,0,0,0,0,0,135,
104,104,104,104,104,0,104,0,104,
95,95,95,95,95,0,95,0,95,
90,90,90,0,0,0,0,0,0,
113,113,113,0,0,113,113,113,0,
104,0,0,0,104,0,0,0,0,
95,0,0,0,0,0,95,95,95,
86,86,86,0,0,0,86,0,86,
97,97,97,0,97,97,97,97,97,
98,0,98,0,98,98,98,0,0,
90,0,90,0,90,90,90,0,90,
82,0,82,0,82,82,82,0,82,
77,0,77,77,77,77,77,0,77,
73,0,73,0,0,0,0,0,0,
72,0,72,0,72,72,72,0,72,
71,0,0,0,71,0,71,0,71,
0,0,63,63,63,63,0,0,63,
0,62,62,62,62,62,62,0,0,
0,61,0,0,61,61,61,61,0,
0,60,0,0,60,60,60,60,0,
0,0,0,59,59,59,59,59,0,
0,0,58,58,58,0,58,58,0,
0,0,0,0,0,0,0,0,0,
0,0,0,0,0,0,0,0,0,
0,0,0,0,0,0,0,0,0.