[layer]
type=Tile Layer 1
data=
1,3,1,4,21,0,1,1,1,
2,2,2,24,21,0,7,2,2,
1,21,0,6,1,2,10,2,1,
1,1,21,1,1,2,2,2,6,
1,1,0,0,0,0,21,0,1,
1,2,2,4,0,21,0,0,3,
1,10,2,1,0,21,0,0,1,
1,2,2,1,1,1,4,21,5,
2,7,2,2,2,2,2,21,2,
0,0,0,0,21,2,0,0,20,
1,1,2,2,2,4,21,2,0,
2,2,0,20,0,21,0,2,0,
2,2,21,2,2,2,2,2,18,
4,1,0,6,0,0,21,1,0,
1,1,1,1,21,1,2,2,0,
0,0,0,0,21,1,2,10,0,
0,2,2,2,21,2,2,2,18,
0,2,21,2,2,2,2,7,2,
3,5,1,1,6,21,0,0,0,
1,1,1,1,3,1,21,0,0,
1,1,1,0,0,0,21,0,0,
1,1,5,1,1,1,0,21,0,
3,4,1,0,21,1,0,0,2,
1,1,1,0,21,1,3,0,24,
1,1,6,21,1,1,1,1,0,
1,1,3,0,21,4,3,1,0,
1,1,1,1,21,6,1,1,0,
2,2,2,2,2,7,2,21,2,
1,4,1,1,21,0,0,0,1,
0,0,21,0,0,1,1,1,6,
21,3,1,3,1,6,1,1,1,
0,0,21,0,1,1,1,1,1,
1,1,1,0,0,21,0,4,1,
2,2,0,0,21,20,0,2,2,
3,1,21,4,2,2,2,1,1,
1,1,21,1,5,1,2,2,1,
2,2,2,7,21,2,2,19,0,
6,1,1,1,4,1,21,2,0,
0,21,0,0,0,1,0,1,0,
4,1,3,1,1,1,21,1,0,
0,2,0,0,0,0,0,1,21,
10,2,2,2,21,2,2,2,18,
2,2,21,1,0,10,19,0,0,
2,2,21,2,2,2,2,9,0,
0,1,0,2,8,2,2,2,21,
0,0,0,2,21,2,1,1,1,
24,2,2,9,21,2,2,2,2,
3,21,2,2,2,2,8,2,1,
1,0,21,1,0,2,2,2,1,
3,8,21,2,0,2,1,5,1,
2,10,2,2,20,21,0,2,2,
0,0,0,0,0,0,0,0,0,
0,0,0,0,0,0,0,0,0,
0,0,0,0,0,0,0,0,0.
[layer]
type=Tile Layer 2
data=
234,234,234,234,0,0,234,234,234,
233,233,233,0,0,0,233,233,233,
231,0,0,231,231,231,231,231,231,
166,166,0,166,166,166,166,166,166,
159,159,0,0,0,0,0,0,159,
199,199,199,199,0,0,0,0,199,
184,184,184,184,0,0,0,0,184,
161,161,161,161,161,161,161,0,161,
155,155,155,155,155,155,155,0,155,
0,0,0,0,0,193,0,0,0,
179,179,179,179,179,179,0,179,0,
165,165,0,0,0,0,0,165,0,
150,150,0,150,150,150,150,150,0,
188,188,0,188,0,0,0,188,0,
174,174,174,174,0,174,174,174,0,
0,0,0,0,0,160,160,160,0,
0,146,146,146,0,146,146,146,0,
0,182,0,182,182,182,182,182,182,
168,168,168,168,168,0,0,0,0,
155,155,155,155,155,155,0,0,0,
142,142,142,0,0,0,0,0,0,
177,177,177,177,177,177,0,0,0,
163,163,163,0,0,163,0,0,163,
150,150,150,0,0,150,150,0,0,
137,137,137,0,137,137,137,137,0,
171,171,171,0,0,171,171,171,0,
158,158,158,158,0,158,158,158,0,
145,145,145,145,145,145,145,0,145,
133,133,133,133,0,0,0,0,133,
0,0,0,0,0,165,165,165,165,
0,146,146,146,146,146,146,146,146,
0,0,0,0,141,141,141,141,141,
128,128,128,0,0,0,0,128,128,
160,160,0,0,0,0,0,160,160,
141,141,0,141,141,141,141,141,141,
129,129,0,129,129,129,129,129,129,
124,124,124,124,0,124,124,0,0,
154,154,154,154,154,154,0,154,0,
0,0,0,0,0,142,0,142,0,
131,131,131,131,131,131,0,131,0,
0,120,0,0,0,0,0,120,0,
119,119,119,119,0,119,119,119,0,
108,108,0,108,0,108,0,0,0,
107,107,0,107,107,107,107,107,0,
0,106,0,106,106,106,106,106,0,
0,0,0,95,0,95,95,95,95,
0,94,94,94,0,94,94,94,94,
93,0,93,93,93,93,93,93,93,
92,0,0,92,0,92,92,92,92,
91,91,0,91,0,91,91,91,91,
90,90,90,90,0,0,0,90,90,
0,0,0,0,0,0,0,0,0,
0,0,0,0,0,0,0,0,0,
0,0,0,0,0,0,0,0,0.