[layer]
type=Tile Layer 1
data=
1,0,0,1,1,0,21,1,1,
0,1,1,21,0,0,2,2,1,
0,21,2,2,2,2,9,2,2,
0,1,1,1,1,2,21,2,0,
1,1,1,0,0,1,21,0,1,
1,1,1,1,21,0,2,2,1,
0,0,2,2,2,2,8,2,21,
1,0,2,10,0,5,2,2,21,
0,1,2,2,2,21,1,1,1,
0,0,2,2,2,21,7,2,1,
1,21,1,0,0,2,2,0,1,
0,0,21,1,1,1,1,0,1,
0,0,0,0,0,0,0,0,0,
0,0,0,0,0,0,0,0,0,
0,0,0,0,0,0,0,0,0.
[layer]
type=Tile Layer 2
data=
89,0,0,89,89,0,0,89,89,
0,64,64,0,0,0,64,64,64,
0,0,63,63,63,63,63,63,63,
0,62,62,62,62,62,0,62,0,
55,55,55,0,0,55,0,0,55,
51,51,51,51,0,0,51,51,51,
0,0,53,53,53,53,53,53,0,
52,0,52,52,0,52,52,52,0,
0,49,49,49,49,0,49,49,49,
0,0,50,50,50,0,50,50,50,
49,0,49,0,0,49,49,0,49,
0,0,0,48,48,48,48,0,48,
0,0,0,0,0,0,0,0,0,
0,0,0,0,0,0,0,0,0,
0,0,0,0,0,0,0,0,0.