[layer]
type=Tile Layer 1
data=
1,1,1,1,1,21,0,1,1,
1,1,1,1,1,1,21,1,1,
1,1,1,1,1,1,21,1,1,
0,1,0,1,0,1,0,0,21,
0,1,1,1,21,1,1,1,0,
0,0,0,21,0,1,1,1,0,
1,1,1,1,21,1,1,1,0,
0,0,0,1,0,0,0,0,21,
1,1,1,1,1,1,21,1,1,
1,1,21,1,0,1,0,1,0,
1,1,21,1,0,1,0,1,0,
0,0,21,1,0,1,0,0,0,
1,0,21,1,1,0,1,1,1,
1,1,0,0,21,0,1,1,1,
1,1,1,21,0,0,1,1,1,
1,1,1,0,21,0,1,1,1,
1,1,1,0,1,21,0,1,1,
1,1,21,0,1,1,0,1,1,
1,0,0,1,1,21,0,1,1,
0,0,1,1,1,21,0,1,1,
0,1,1,1,1,1,21,1,1,
1,1,1,0,21,0,0,0,0,
1,1,1,1,1,1,1,21,0,
1,1,21,0,0,0,0,0,1,
1,1,21,0,1,1,1,1,1,
1,1,1,0,21,0,0,1,1,
1,1,1,1,1,1,0,21,0,
1,1,1,1,0,0,0,21,0,
1,1,1,1,21,1,1,1,1,
1,1,1,1,21,1,1,1,1,
0,1,0,1,0,1,1,1,21,
0,1,0,1,21,1,1,1,1,
0,1,21,1,0,1,1,1,0,
0,1,0,1,0,1,1,1,21,
0,1,0,1,21,1,0,0,0,
1,1,0,1,21,1,0,1,1,
0,21,0,1,0,1,0,0,0,
1,1,1,1,21,1,1,1,1,
1,1,1,1,21,0,0,1,1,
1,1,1,1,1,1,1,21,0,
1,1,1,1,1,1,21,0,0,
1,1,1,1,1,21,0,1,0,
1,1,1,1,1,21,1,1,0,
1,1,1,1,21,0,0,1,0,
0,0,21,0,0,1,1,0,0,
0,0,0,0,0,0,0,0,0,
0,0,0,0,0,0,0,0,0,
0,0,0,0,0,0,0,0,0.
[layer]
type=Tile Layer 2
data=
208,208,208,208,208,0,0,208,208,
196,196,196,196,196,196,0,196,196,
194,194,194,194,194,194,0,194,194,
0,178,0,178,0,178,0,0,0,
0,165,165,165,0,165,165,165,0,
0,0,0,0,0,152,152,152,0,
138,138,138,138,0,138,138,138,0,
0,0,0,173,0,0,0,0,0,
152,152,152,152,152,152,0,152,152,
147,147,0,147,0,147,0,147,0,
134,134,0,134,0,134,0,134,0,
0,0,0,167,0,167,0,0,0,
154,0,0,154,154,0,154,154,154,
142,142,0,0,0,0,142,142,142,
130,130,130,0,0,0,130,130,130,
162,162,162,0,0,0,162,162,162,
149,149,149,0,149,0,0,149,149,
137,137,0,0,137,137,0,137,137,
125,0,0,125,125,0,0,125,125,
0,0,156,156,156,0,0,156,156,
0,144,144,144,144,144,0,144,144,
132,132,132,0,0,0,0,0,0,
121,121,121,121,121,121,121,0,0,
150,150,0,0,0,0,0,0,150,
139,139,0,0,139,139,139,139,139,
128,128,128,0,0,0,0,128,128,
116,116,116,116,116,116,0,0,0,
145,145,145,145,0,0,0,0,0,
127,127,127,127,0,127,127,127,127,
117,117,117,117,0,117,117,117,117,
0,112,0,112,0,112,112,112,0,
0,139,0,139,0,139,139,139,139,
0,128,0,128,0,128,128,128,0,
0,118,0,118,0,118,118,118,0,
0,108,0,108,0,108,0,0,0,
107,107,0,107,0,107,0,107,107,
0,0,0,97,0,97,0,0,0,
91,91,91,91,0,91,91,91,91,
95,95,95,95,0,0,0,95,95,
85,85,85,85,85,85,85,0,0,
84,84,84,84,84,84,0,0,0,
83,83,83,83,83,0,0,83,0,
82,82,82,82,82,0,82,82,0,
81,81,81,81,0,0,0,81,0,
0,0,0,0,0,80,80,0,0,
0,0,0,0,0,0,0,0,0,
0,0,0,0,0,0,0,0,0,
0,0,0,0,0,0,0,0,0.