[layer]
type=Tile Layer 1
data=
1,0,1,1,1,1,1,21,0,
1,21,1,1,1,1,1,1,1,
1,21,1,1,1,1,1,0,1,
1,1,1,1,1,1,1,21,1,
0,0,0,0,1,21,0,0,0,
1,1,1,1,1,21,1,1,1,
1,1,1,1,1,21,1,1,1,
1,1,1,1,1,21,1,1,1,
1,0,0,21,0,0,1,1,1,
0,0,19,21,0,0,1,1,1,
0,0,21,0,0,1,1,1,1,
0,1,1,21,1,1,1,1,1,
0,1,1,0,0,0,21,0,0,
0,21,0,1,0,0,1,0,1,
18,21,2,2,2,2,0,0,2,
0,0,1,1,1,21,0,1,1,
1,1,0,0,1,0,21,0,1,
1,1,0,0,21,0,2,2,1,
1,0,1,21,1,1,2,19,1,
0,21,1,0,1,1,2,0,1,
1,21,1,0,1,1,1,0,1,
1,0,1,0,1,21,0,0,0,
1,1,1,21,1,1,1,1,1,
1,0,21,0,0,0,1,1,1,
1,1,1,2,2,21,1,1,1,
1,1,1,2,19,21,1,1,1,
1,1,1,2,2,21,1,1,1,
1,0,21,0,1,1,1,0,1,
1,21,1,1,1,1,1,1,1,
1,21,0,0,0,0,0,0,1,
1,1,1,21,1,1,2,24,1,
1,1,1,21,1,1,1,0,1,
1,1,1,1,1,1,2,21,1,
1,1,1,21,1,1,2,24,0,
1,1,1,21,1,2,2,2,0,
0,0,2,2,2,2,20,0,21,
1,1,1,0,0,21,0,0,0,
2,21,2,0,2,2,2,2,18,
1,1,0,0,1,0,1,21,0,
1,0,1,21,1,0,1,2,0,
1,0,1,1,0,21,1,2,24,
0,2,0,2,0,1,21,1,0,
0,2,19,2,21,1,0,1,0,
0,2,2,2,0,1,21,0,1,
1,0,0,0,21,1,1,0,1,
1,1,21,1,1,1,1,1,1,
0,0,21,0,0,1,0,0,0,
1,1,21,1,1,1,1,1,1,
1,1,21,1,1,1,1,1,0,
2,2,21,2,2,2,2,2,18,
24,2,21,1,1,1,1,1,0,
0,0,0,0,0,0,0,0,0,
0,0,0,0,0,0,0,0,0,
0,0,0,0,0,0,0,0,0.
[layer]
type=Tile Layer 2
data=
234,0,234,234,234,234,234,0,0,
221,0,221,221,221,221,221,221,221,
231,0,231,231,231,231,231,0,231,
166,166,166,166,166,166,166,0,166,
0,0,0,0,159,0,0,0,0,
189,189,189,189,189,0,189,189,189,
175,175,175,175,175,0,175,175,175,
161,161,161,161,161,0,161,161,161,
155,0,0,0,0,0,155,155,155,
0,0,0,0,0,0,193,193,193,
0,0,0,0,0,179,179,179,179,
0,165,165,0,165,165,165,165,165,
0,150,150,0,0,0,0,0,0,
0,0,0,188,0,0,188,0,188,
0,0,174,174,174,174,0,0,174,
0,0,160,160,160,0,0,160,160,
146,146,0,0,146,0,0,0,146,
182,182,0,0,0,0,182,182,182,
168,0,168,0,168,168,168,0,168,
0,0,155,0,155,155,155,0,155,
142,0,142,0,142,142,142,0,142,
177,0,177,0,177,0,0,0,0,
155,155,155,0,155,155,155,155,155,
150,0,0,0,0,0,150,150,150,
131,131,131,131,131,0,131,131,131,
171,171,171,171,0,0,171,171,171,
151,151,151,151,151,0,151,151,151,
145,0,0,0,145,145,145,0,145,
127,0,127,127,127,127,127,127,127,
165,0,0,0,0,0,0,0,165,
153,153,153,0,153,153,153,0,153,
141,141,141,0,141,141,141,0,141,
122,122,122,122,122,122,122,0,122,
160,160,160,0,160,160,160,0,0,
148,148,148,0,148,148,148,148,0,
0,0,136,136,136,136,0,0,0,
124,124,124,0,0,0,0,0,0,
154,0,154,0,154,154,154,154,0,
142,142,0,0,142,0,142,0,0,
131,0,131,0,131,0,131,131,0,
120,0,120,120,0,0,120,120,0,
0,119,0,119,0,119,0,119,0,
0,108,0,108,0,108,0,108,0,
0,107,107,107,0,107,0,0,107,
106,0,0,0,0,106,106,0,106,
91,91,0,91,91,91,91,91,91,
0,0,0,0,0,94,0,0,0,
89,89,0,89,89,89,89,89,89,
92,92,0,92,92,92,92,92,0,
91,91,0,91,91,91,91,91,0,
0,90,0,90,90,90,90,90,0,
0,0,0,0,0,0,0,0,0,
0,0,0,0,0,0,0,0,0,
0,0,0,0,0,0,0,0,0.