[layer]
type=Tile Layer 1
data=
18,2,21,2,2,2,2,2,0,
0,2,0,20,0,21,0,2,0,
0,2,2,2,2,2,21,2,2,
1,0,21,1,0,1,0,1,0,
0,1,21,1,0,1,1,1,1,
2,2,2,2,21,2,18,2,2,
1,1,0,0,1,1,0,0,21,
0,1,1,0,1,1,1,1,21,
1,1,6,0,1,21,1,1,0,
1,2,0,2,1,1,0,21,0,
0,0,24,21,1,1,1,0,1,
1,0,2,1,1,1,21,0,1,
0,0,0,0,0,0,0,0,0,
0,0,0,0,0,0,0,0,0,
0,0,0,0,0,0,0,0,0.
[layer]
type=Tile Layer 2
data=
0,88,0,88,88,88,88,88,0,
0,63,0,0,0,0,0,63,0,
0,59,59,59,59,59,0,59,59,
61,0,0,61,0,61,0,61,0,
0,54,0,54,0,54,54,54,54,
50,50,50,50,0,50,0,50,50,
52,52,0,0,52,52,0,0,0,
0,51,51,0,51,51,51,51,0,
50,50,50,0,50,0,50,50,0,
49,49,0,49,49,49,0,0,0,
0,0,0,0,48,48,48,0,48,
47,0,47,47,47,47,0,0,47,
0,0,0,0,0,0,0,0,0,
0,0,0,0,0,0,0,0,0,
0,0,0,0,0,0,0,0,0.