[layer]
type=Tile Layer 1
data=
1,1,1,21,1,1,1,1,1,
1,1,1,21,1,1,1,1,1,
1,1,1,21,1,1,1,1,1,
0,0,1,1,1,1,1,21,0,
0,0,1,1,0,0,0,21,0,
1,21,1,1,1,1,0,0,1,
1,21,0,0,1,1,1,0,0,
1,1,1,21,1,1,1,1,0,
0,0,0,0,1,0,0,1,21,
0,1,1,21,0,0,1,1,1,
0,1,1,1,1,21,0,1,1,
0,0,0,0,1,1,21,1,1,
1,1,1,1,1,21,1,0,1,
1,1,1,0,21,0,1,0,1,
1,1,1,21,1,1,1,1,1,
0,0,1,0,0,0,0,21,1,
1,21,1,1,1,1,1,1,1,
1,0,0,21,1,0,1,1,1,
1,1,1,21,1,0,1,1,1,
1,1,1,21,1,0,1,1,1,
1,1,1,21,1,0,1,1,1,
1,1,1,1,21,1,1,1,1,
0,0,0,1,21,1,1,1,1,
1,1,1,1,21,1,1,1,1,
1,1,0,1,0,1,0,21,0,
1,1,21,1,0,1,1,1,1,
0,21,0,1,1,1,0,0,1,
1,1,21,1,1,1,1,1,0,
0,1,21,1,1,1,1,1,0,
1,1,21,1,1,1,1,1,1,
0,0,21,1,1,1,1,1,1,
0,0,1,21,0,1,1,1,1,
0,21,1,1,0,0,0,0,0,
0,1,1,1,1,1,1,0,21,
0,1,1,1,1,1,1,21,0,
0,21,0,0,0,1,1,1,0,
0,0,0,21,0,1,1,1,1,
0,1,1,1,21,0,0,0,0,
0,0,0,0,21,0,1,1,0,
1,1,1,21,1,0,1,1,1,
0,0,0,0,0,0,0,21,1,
1,1,1,1,1,1,1,21,1,
1,1,1,21,1,1,1,0,1,
1,1,1,21,1,1,1,1,1,
1,0,0,21,1,1,1,0,1,
0,0,0,0,0,0,0,0,0,
0,0,0,0,0,0,0,0,0,
0,0,0,0,0,0,0,0,0.
[layer]
type=Tile Layer 2
data=
198,198,198,0,198,198,198,198,198,
196,196,196,0,196,196,196,196,196,
194,194,194,0,194,194,194,194,194,
0,0,178,178,178,178,178,0,0,
0,0,165,165,0,0,0,0,0,
152,0,152,152,152,152,0,0,152,
138,0,0,0,138,138,138,0,0,
173,173,173,0,173,173,173,173,0,
0,0,0,0,160,0,0,160,0,
0,147,147,0,0,0,147,147,147,
0,134,134,134,134,0,0,134,134,
0,0,0,0,167,167,0,167,167,
154,154,154,154,154,0,154,0,154,
142,142,142,0,0,0,142,0,142,
123,123,123,0,123,123,123,123,123,
0,0,162,0,0,0,0,0,162,
142,0,142,142,142,142,142,142,142,
137,0,0,0,137,0,137,137,137,
125,125,125,0,125,0,125,125,125,
156,156,156,0,156,0,156,156,156,
144,144,144,0,144,0,144,144,144,
126,126,126,126,0,126,126,126,126,
0,0,0,121,0,121,121,121,121,
143,143,143,143,0,143,143,143,143,
139,139,0,139,0,139,0,0,0,
128,128,0,128,0,128,128,128,128,
0,0,0,116,116,116,0,0,116,
145,145,0,145,145,145,145,145,0,
0,134,0,134,134,134,134,134,0,
117,117,0,117,117,117,117,117,117,
0,0,0,112,112,112,112,112,112,
0,0,139,0,0,139,139,139,139,
0,0,128,128,0,0,0,0,0,
0,118,118,118,118,118,118,0,0,
0,108,108,108,108,108,108,0,0,
0,0,0,0,0,107,107,107,0,
0,0,0,0,0,97,97,97,97,
0,96,96,96,0,0,0,0,0,
0,0,0,0,0,0,95,95,0,
85,85,85,0,85,0,85,85,85,
0,0,0,0,0,0,0,0,84,
79,79,79,79,79,79,79,0,79,
82,82,82,0,82,82,82,0,82,
78,78,78,0,78,78,78,78,78,
80,0,0,0,80,80,80,0,80,
0,0,0,0,0,0,0,0,0,
0,0,0,0,0,0,0,0,0,
0,0,0,0,0,0,0,0,0.