[layer]
type=Tile Layer 1
data=
0,0,1,1,21,1,6,1,1,
10,2,21,0,0,0,0,0,5,
2,2,7,2,2,21,2,0,2,
0,0,21,0,0,1,1,1,1,
0,21,1,3,0,1,4,1,1,
1,1,1,6,4,0,21,0,0,
1,21,1,1,1,6,6,4,0,
1,21,2,0,1,1,1,5,0,
1,10,2,1,1,1,1,1,21,
0,0,21,0,1,1,1,0,1,
0,6,1,1,0,0,0,21,4,
0,21,0,0,1,3,1,1,1,
1,0,0,0,0,21,1,0,0,
2,21,2,2,2,0,2,2,7,
0,0,1,0,1,0,0,21,3,
5,1,4,21,1,1,1,0,1,
1,0,1,0,2,21,0,0,1,
2,21,2,2,9,2,2,2,2,
9,2,2,2,2,21,2,2,0,
2,0,4,21,1,0,1,1,1,
0,2,7,2,2,21,2,2,2,
1,1,4,0,1,0,1,21,0,
1,5,1,21,1,0,2,2,1,
1,6,6,21,1,0,2,8,1,
1,1,3,21,6,0,2,2,2,
0,0,21,0,1,0,1,2,8,
1,1,1,1,1,21,4,2,2,
4,0,0,21,0,0,0,0,1,
1,21,4,5,1,1,1,0,1,
1,0,1,1,3,0,1,21,0,
1,1,1,21,6,1,1,1,1,
0,0,0,0,1,0,0,0,21,
1,1,1,21,3,3,5,0,1,
7,2,2,21,2,2,2,0,2,
1,6,1,21,2,10,2,1,1,
0,21,4,0,2,0,2,0,0,
0,0,0,0,0,0,0,0,0,
0,0,0,0,0,0,0,0,0,
0,0,0,0,0,0,0,0,0.
[layer]
type=Tile Layer 2
data=
0,0,176,176,0,176,176,176,176,
175,175,0,0,0,0,0,0,175,
173,173,173,173,173,0,173,0,173,
0,0,0,0,0,140,140,140,140,
0,0,129,129,0,129,129,129,129,
118,118,118,118,118,0,0,0,0,
147,0,147,147,147,147,147,147,0,
135,0,135,0,135,135,135,135,0,
124,124,124,124,124,124,124,124,0,
0,0,0,0,113,113,113,0,113,
0,141,141,141,0,0,0,0,141,
0,0,0,0,130,130,130,130,130,
119,0,0,0,0,0,119,0,0,
109,0,109,109,109,0,109,109,109,
0,0,135,0,135,0,0,0,135,
125,125,125,0,125,125,125,0,125,
115,0,115,0,115,0,0,0,115,
104,0,104,104,104,104,104,104,104,
130,130,130,130,130,0,130,130,0,
120,0,120,0,120,0,120,120,120,
0,110,110,110,110,0,110,110,110,
100,100,100,0,100,0,100,0,0,
124,124,124,0,124,0,124,124,124,
114,114,114,0,114,0,114,114,114,
105,105,105,0,105,0,105,105,105,
0,0,0,0,96,0,96,96,96,
90,90,90,90,90,0,90,90,90,
86,0,0,0,0,0,0,0,86,
85,0,85,85,85,85,85,0,85,
84,0,84,84,84,0,84,0,0,
71,71,71,0,71,71,71,71,71,
0,0,0,0,74,0,0,0,0,
73,73,73,0,73,73,73,0,73,
72,72,72,0,72,72,72,0,72,
71,71,71,0,71,71,71,71,71,
0,0,70,0,70,0,70,0,0,
0,0,0,0,0,0,0,0,0,
0,0,0,0,0,0,0,0,0,
0,0,0,0,0,0,0,0,0.