[layer]
type=Tile Layer 1
data=
1,21,0,0,0,0,0,0,1,
1,1,3,1,4,21,1,1,1,
4,1,1,21,1,0,1,1,5,
1,1,1,0,0,0,21,0,0,
1,1,1,1,21,4,1,0,0,
3,1,1,1,0,6,21,3,0,
0,21,3,0,0,0,1,1,0,
0,1,1,21,0,0,6,0,0,
0,1,1,0,1,5,1,1,21,
1,0,1,0,1,0,3,21,0,
1,1,1,1,0,21,0,0,1,
4,0,0,0,0,21,0,0,6,
1,1,1,0,21,0,0,0,0,
1,4,1,21,1,1,5,6,1,
0,0,6,21,1,1,1,1,1,
6,1,1,21,1,1,1,4,1,
0,0,1,0,1,21,0,0,0,
1,1,1,3,21,1,6,1,1,
1,1,1,1,21,1,1,3,4,
0,0,0,0,21,1,4,1,1,
1,1,1,1,21,1,1,5,5,
1,21,1,0,1,5,1,0,1,
1,21,1,4,5,6,1,0,1,
6,0,1,21,1,1,1,0,1,
1,0,3,21,1,1,1,0,1,
0,0,21,0,0,0,5,0,0,
1,1,1,1,1,6,1,21,5,
1,0,1,3,6,1,4,21,0,
1,21,3,1,1,1,1,1,1,
1,21,1,4,1,1,1,0,1,
1,0,0,21,0,0,1,1,1,
1,0,21,0,5,0,6,1,1,
3,1,1,21,1,0,1,1,6,
1,0,5,3,1,1,21,0,0,
0,0,0,0,0,21,0,1,1,
0,0,21,6,1,1,1,1,1,
1,1,0,21,1,5,0,0,0,
0,0,0,21,1,1,1,0,0,
0,0,6,4,1,1,1,0,21,
5,1,1,0,21,0,0,0,0,
1,1,1,1,1,21,6,1,1,
0,0,0,0,1,0,3,0,21,
1,1,1,21,1,1,4,1,1,
0,6,1,0,0,1,1,21,1,
1,1,1,21,6,1,5,1,4,
0,0,0,0,0,0,0,0,0,
0,0,0,0,0,0,0,0,0,
0,0,0,0,0,0,0,0,0.
[layer]
type=Tile Layer 2
data=
208,0,0,0,0,0,0,0,208,
196,196,196,196,196,0,196,196,196,
204,204,204,0,204,0,204,204,204,
178,178,178,0,0,0,0,0,0,
165,165,165,165,0,165,165,0,0,
152,152,152,152,0,152,0,152,0,
0,0,138,0,0,0,138,138,0,
0,173,173,0,0,0,173,0,0,
0,160,160,0,160,160,160,160,0,
147,0,147,0,147,0,147,0,0,
134,134,134,134,0,0,0,0,134,
167,0,0,0,0,0,0,0,167,
154,154,154,0,0,0,0,0,0,
135,135,135,0,135,135,135,135,135,
0,0,130,0,130,130,130,130,130,
154,154,154,0,154,154,154,154,154,
0,0,149,0,149,0,0,0,0,
131,131,131,131,0,131,131,131,131,
119,119,119,119,0,119,119,119,119,
0,0,0,0,0,156,156,156,156,
137,137,137,137,0,137,137,137,137,
132,0,132,0,132,132,132,0,132,
121,0,121,121,121,121,121,0,121,
150,0,150,0,150,150,150,0,150,
139,0,139,0,139,139,139,0,139,
0,0,0,0,0,0,128,0,0,
111,111,111,111,111,111,111,0,111,
145,0,145,145,145,145,145,0,0,
127,0,127,127,127,127,127,127,127,
123,0,123,123,123,123,123,0,123,
112,0,0,0,0,0,112,112,112,
139,0,0,0,139,0,139,139,139,
128,128,128,0,128,0,128,128,128,
118,0,118,118,118,118,0,0,0,
0,0,0,0,0,0,0,108,108,
0,0,0,107,107,107,107,107,107,
97,97,0,0,97,97,0,0,0,
0,0,0,0,96,96,96,0,0,
0,0,95,95,95,95,95,0,0,
85,85,85,0,0,0,0,0,0,
80,80,80,80,80,0,80,80,80,
0,0,0,0,83,0,83,0,0,
78,78,78,0,78,78,78,78,78,
0,81,81,0,0,81,81,0,81,
77,77,77,0,77,77,77,77,77,
0,0,0,0,0,0,0,0,0,
0,0,0,0,0,0,0,0,0,
0,0,0,0,0,0,0,0,0.