[layer]
type=Tile Layer 1
data=
1,1,1,1,21,1,1,1,1,
1,1,1,1,21,1,0,1,0,
1,1,1,1,0,1,21,1,0,
0,1,0,0,21,0,0,0,1,
0,1,1,21,1,1,1,1,1,
0,1,1,21,1,1,1,1,1,
0,1,21,0,0,0,0,0,0,
1,1,0,21,1,1,0,1,0,
1,1,1,0,0,0,21,1,0,
1,1,0,1,1,1,1,21,0,
1,1,0,21,1,0,1,0,1,
1,1,1,0,1,21,1,0,0,
1,21,1,1,1,1,1,0,1,
1,21,1,1,1,1,1,0,1,
1,1,1,1,1,1,1,21,1,
0,0,1,1,1,1,1,21,1,
1,1,1,1,1,1,1,21,1,
0,0,0,0,0,21,0,0,1,
1,1,1,21,1,1,1,0,1,
1,1,1,0,1,0,21,0,0,
1,1,1,21,1,1,1,1,1,
1,21,1,1,1,0,1,1,1,
0,0,1,0,1,0,1,1,21,
1,1,1,21,1,0,1,1,1,
1,1,1,0,1,0,1,21,0,
1,1,1,21,1,0,1,1,1,
1,1,1,0,1,21,0,0,1,
1,1,1,21,1,1,1,1,1,
1,0,21,0,1,1,1,1,1,
1,1,1,21,1,1,1,1,1,
0,0,1,1,1,1,21,0,1,
0,1,1,1,1,1,21,0,1,
0,0,0,1,1,1,21,1,0,
1,1,21,0,0,1,0,0,0,
1,1,1,1,21,1,0,1,1,
1,1,1,1,21,1,0,0,1,
1,0,0,0,0,1,21,1,0,
1,21,1,1,1,1,0,0,0,
1,0,0,0,21,0,0,1,1,
0,1,1,1,1,1,0,1,21,
0,1,1,1,1,1,21,1,0,
0,1,1,1,1,1,21,1,0,
0,1,1,1,1,1,21,1,1,
0,1,0,21,0,0,0,0,0,
0,1,0,1,21,1,1,1,1,
0,0,0,0,0,0,0,0,0,
0,0,0,0,0,0,0,0,0,
0,0,0,0,0,0,0,0,0.
[layer]
type=Tile Layer 2
data=
198,198,198,198,0,198,198,198,198,
206,206,206,206,0,206,0,206,0,
204,204,204,204,0,204,0,204,0,
0,178,0,0,0,0,0,0,178,
0,165,165,0,165,165,165,165,165,
0,152,152,0,152,152,152,152,152,
0,138,0,0,0,0,0,0,0,
173,173,0,0,173,173,0,173,0,
160,160,160,0,0,0,0,160,0,
147,147,0,147,147,147,147,0,0,
134,134,0,0,134,0,134,0,134,
167,167,167,0,167,0,167,0,0,
154,0,154,154,154,154,154,0,154,
142,0,142,142,142,142,142,0,142,
123,123,123,123,123,123,123,0,123,
0,0,162,162,162,162,162,0,162,
142,142,142,142,142,142,142,0,142,
0,0,0,0,0,0,0,0,137,
125,125,125,0,125,125,125,0,125,
156,156,156,0,156,0,0,0,0,
137,137,137,0,137,137,137,137,137,
132,0,132,132,132,0,132,132,132,
0,0,121,0,121,0,121,121,0,
150,150,150,0,150,0,150,150,150,
139,139,139,0,139,0,139,0,0,
128,128,128,0,128,0,128,128,128,
116,116,116,0,116,0,0,0,116,
138,138,138,0,138,138,138,138,138,
134,0,0,0,134,134,134,134,134,
117,117,117,0,117,117,117,117,117,
0,0,112,112,112,112,0,0,112,
0,139,139,139,139,139,0,0,139,
0,0,0,128,128,128,0,128,0,
118,118,0,0,0,118,0,0,0,
108,108,108,108,0,108,0,108,108,
107,107,107,107,0,107,0,0,107,
97,0,0,0,0,97,0,97,0,
96,0,96,96,96,96,0,0,0,
95,0,0,0,0,0,0,95,95,
0,85,85,85,85,85,0,85,0,
0,84,84,84,84,84,0,84,0,
0,83,83,83,83,83,0,83,0,
0,82,82,82,82,82,0,82,82,
0,81,0,0,0,0,0,0,0,
0,80,0,80,0,80,80,80,80,
0,0,0,0,0,0,0,0,0,
0,0,0,0,0,0,0,0,0,
0,0,0,0,0,0,0,0,0.