[layer]
type=Tile Layer 1
data=
1,1,1,1,1,21,1,1,1,
0,0,1,0,8,2,1,21,0,
1,1,1,2,2,21,1,0,1,
1,1,1,0,1,21,1,0,1,
1,1,1,21,1,1,1,0,1,
2,2,1,21,1,1,1,0,1,
8,2,1,0,0,21,2,2,1,
2,2,2,2,21,2,9,2,2,
1,1,1,0,21,2,2,0,1,
0,2,2,21,2,9,2,2,2,
0,0,2,2,2,2,21,1,1,
2,2,2,9,2,21,0,2,2,
1,1,21,2,0,1,1,2,10,
1,0,0,0,21,0,1,2,2,
1,21,1,1,1,0,1,1,1,
0,1,0,1,21,1,1,1,1,
0,1,21,1,0,0,0,1,0,
1,1,21,1,1,1,1,1,0,
1,1,0,1,21,0,0,1,0,
1,2,21,1,0,1,1,1,0,
0,8,0,1,0,21,0,0,0,
0,0,0,0,0,0,0,0,0,
0,0,0,0,0,0,0,0,0,
0,0,0,0,0,0,0,0,0.
[layer]
type=Tile Layer 2
data=
120,120,120,120,120,0,120,120,120,
0,0,132,0,132,132,132,0,0,
124,124,124,124,124,0,124,0,124,
113,113,113,0,113,0,113,0,113,
99,99,99,0,99,99,99,0,99,
90,90,90,0,90,90,90,0,90,
86,86,86,0,0,0,86,86,86,
102,102,102,102,0,102,102,102,102,
98,98,98,0,0,98,98,0,98,
0,90,90,0,90,90,90,90,90,
0,0,82,82,82,82,0,82,82,
81,81,81,81,81,0,0,81,81,
73,73,0,73,0,73,73,73,73,
72,0,0,0,0,0,72,72,72,
67,0,67,67,67,0,67,67,67,
0,63,0,63,0,63,63,63,63,
0,62,0,62,0,0,0,62,0,
58,58,0,58,58,58,58,58,0,
60,60,0,60,0,0,0,60,0,
59,59,0,59,0,59,59,59,0,
0,58,0,58,0,0,0,0,0,
0,0,0,0,0,0,0,0,0,
0,0,0,0,0,0,0,0,0,
0,0,0,0,0,0,0,0,0.