[layer]
type=Tile Layer 1
data=
1,1,0,21,0,1,5,3,1,
0,21,0,1,1,1,4,1,1,
0,21,5,1,1,1,1,4,1,
1,21,1,4,1,1,1,4,1,
5,0,21,0,1,1,1,5,1,
1,1,1,21,1,1,6,1,6,
0,21,0,1,1,1,0,1,0,
1,1,21,6,1,1,0,3,4,
0,1,0,21,0,0,0,1,0,
0,1,1,1,1,1,21,1,1,
0,1,21,0,0,1,0,5,6,
0,1,0,1,1,1,21,4,6,
0,1,0,1,1,5,21,0,0,
0,6,0,1,1,1,21,1,1,
0,4,0,0,0,21,0,1,1,
0,0,1,1,4,3,1,0,21,
0,4,1,5,1,1,1,1,21,
0,3,1,1,1,1,1,1,21,
0,1,5,1,1,1,5,1,21,
0,0,1,1,21,0,0,4,1,
1,0,21,0,0,1,1,6,1,
1,1,0,0,21,0,0,1,6,
1,1,0,21,0,0,0,1,1,
5,4,21,0,1,1,1,4,1,
1,1,1,1,1,0,21,0,0,
1,1,21,0,0,0,0,3,4,
1,1,0,1,1,21,0,4,5,
0,1,1,1,4,21,1,1,1,
0,0,0,4,1,21,6,1,1,
1,1,21,0,0,0,1,5,1,
5,1,21,6,6,1,1,1,1,
5,21,1,1,0,1,4,1,1,
1,0,0,21,0,1,1,1,1,
0,1,4,1,1,1,21,6,0,
0,0,0,1,0,21,0,1,0,
5,1,1,5,1,1,1,1,21,
0,1,0,0,0,0,21,0,0,
0,1,21,1,1,1,1,6,1,
0,1,0,4,1,1,0,5,21,
0,1,21,1,3,1,0,1,1,
0,1,0,6,21,0,0,1,1,
1,1,21,1,4,6,0,1,1,
1,1,1,1,21,0,0,1,1,
5,6,3,1,1,21,1,0,0,
6,1,1,1,1,0,0,21,0,
0,0,0,0,0,21,3,1,6,
0,0,1,0,0,21,0,0,0,
1,21,0,0,1,1,1,1,1,
0,0,0,0,0,0,0,0,0,
0,0,0,0,0,0,0,0,0,
0,0,0,0,0,0,0,0,0.
[layer]
type=Tile Layer 2
data=
229,229,0,0,0,229,229,229,229,
0,0,0,228,228,228,228,228,228,
0,0,226,226,226,226,226,226,226,
175,0,175,175,175,175,175,175,175,
169,0,0,0,169,169,169,169,169,
147,147,147,0,147,147,147,147,147,
0,0,0,193,193,193,0,193,0,
179,179,0,179,179,179,0,179,179,
0,165,0,0,0,0,0,165,0,
0,150,150,150,150,150,0,150,150,
0,188,0,0,0,188,0,188,188,
0,174,0,174,174,174,0,174,174,
0,160,0,160,160,160,0,0,0,
0,146,0,146,146,146,0,146,146,
0,182,0,0,0,0,0,182,182,
0,0,168,168,168,168,168,0,0,
0,155,155,155,155,155,155,155,0,
0,142,142,142,142,142,142,142,0,
0,177,177,177,177,177,177,177,0,
0,0,163,163,0,0,0,163,163,
150,0,0,0,0,150,150,150,150,
137,137,0,0,0,0,0,137,137,
171,171,0,0,0,0,0,171,171,
158,158,0,0,158,158,158,158,158,
145,145,145,145,145,0,0,0,0,
133,133,0,0,0,0,0,133,133,
165,165,0,165,165,0,0,165,165,
0,153,153,153,153,0,153,153,153,
0,0,0,141,141,0,141,141,141,
128,128,0,0,0,0,128,128,128,
152,152,0,152,152,152,152,152,152,
148,0,148,148,0,148,148,148,148,
136,0,0,0,0,136,136,136,136,
0,124,124,124,124,124,0,124,0,
0,0,0,154,0,0,0,154,0,
136,136,136,136,136,136,136,136,0,
0,131,0,0,0,0,0,0,0,
0,120,0,120,120,120,120,120,120,
0,119,0,119,119,119,0,119,0,
0,108,0,108,108,108,0,108,108,
0,107,0,107,0,0,0,107,107,
106,106,0,106,106,106,0,106,106,
95,95,95,95,0,0,0,95,95,
94,94,94,94,94,0,94,0,0,
93,93,93,93,93,0,0,0,0,
0,0,0,0,0,0,92,92,92,
0,0,91,0,0,0,0,0,0,
90,0,0,0,90,90,90,90,90,
0,0,0,0,0,0,0,0,0,
0,0,0,0,0,0,0,0,0,
0,0,0,0,0,0,0,0,0.