[layer]
type=Tile Layer 1
data=
1,1,1,1,0,21,0,0,1,
1,1,1,1,21,1,1,1,1,
1,21,0,0,0,1,1,1,1,
0,21,1,1,1,1,1,1,1,
21,1,1,1,1,1,1,1,1,
0,0,21,1,1,1,1,1,1,
2,2,18,0,21,0,0,0,0,
1,1,1,1,1,1,1,21,19,
1,1,1,1,1,1,1,21,2,
0,2,0,2,21,2,2,2,20,
1,1,21,1,0,1,1,2,0,
0,21,0,1,0,0,0,0,0,
1,1,21,1,1,1,1,1,1,
1,1,21,1,0,0,0,0,0,
1,1,21,1,2,2,2,1,0,
1,1,0,0,21,19,0,0,0,
1,1,21,1,2,2,2,1,1,
0,0,18,2,21,2,2,2,2,
0,1,0,0,0,0,21,0,0,
0,0,21,0,0,0,0,1,0,
1,1,1,1,1,0,21,0,1,
1,1,1,1,1,21,0,0,0,
1,1,2,2,2,1,21,0,0,
1,1,2,19,2,1,1,21,0,
1,1,2,2,2,1,0,21,0,
2,2,2,2,2,2,18,21,0,
1,1,1,1,1,0,21,1,1,
1,1,1,0,0,21,0,0,1,
1,0,0,0,21,0,0,0,1,
0,21,1,1,1,1,1,1,1,
21,2,2,2,1,1,1,1,1,
0,21,19,0,0,0,0,1,1,
1,2,2,2,1,1,0,21,0,
1,1,1,1,1,1,1,21,0,
2,2,2,2,2,2,2,21,20,
1,1,1,1,1,1,1,2,21,
1,0,1,1,1,0,1,21,0,
2,21,2,2,2,18,2,2,2,
0,0,0,0,2,0,1,21,1,
2,2,2,20,2,21,2,0,2,
1,0,2,0,2,21,0,0,1,
1,0,1,21,1,0,1,1,1,
1,0,1,21,1,0,1,1,1,
1,21,1,0,1,0,1,1,1,
2,0,21,0,1,0,0,0,0,
20,2,2,2,21,0,2,2,2,
18,2,2,2,0,21,2,2,2,
0,0,21,1,1,0,1,1,1,
1,1,21,0,1,0,0,0,0,
1,1,1,21,1,1,2,2,0,
2,2,21,2,2,2,2,20,2,
0,0,0,0,0,0,0,0,0,
0,0,0,0,0,0,0,0,0,
0,0,0,0,0,0,0,0,0.
[layer]
type=Tile Layer 2
data=
234,234,234,234,0,0,0,0,234,
221,221,221,221,0,221,221,221,221,
231,0,0,0,0,231,231,231,231,
0,0,174,174,174,174,174,174,174,
0,152,152,152,152,152,152,152,152,
0,0,0,199,199,199,199,199,199,
184,184,0,0,0,0,0,0,0,
169,169,169,169,169,169,169,0,0,
147,147,147,147,147,147,147,0,147,
0,193,0,193,0,193,193,193,0,
179,179,0,179,0,179,179,179,0,
0,0,0,165,0,0,0,0,0,
143,143,0,143,143,143,143,143,143,
188,188,0,188,0,0,0,0,0,
174,174,0,174,174,174,174,174,0,
160,160,0,0,0,0,0,0,0,
139,139,0,139,139,139,139,139,139,
0,0,0,182,0,182,182,182,182,
0,168,0,0,0,0,0,0,0,
0,0,0,0,0,0,0,155,0,
142,142,142,142,142,0,0,0,142,
177,177,177,177,177,0,0,0,0,
163,163,163,163,163,163,0,0,0,
150,150,150,0,150,150,150,0,0,
137,137,137,137,137,137,0,0,0,
171,171,171,171,171,171,0,0,0,
158,158,158,158,158,0,0,158,158,
145,145,145,0,0,0,0,0,145,
133,0,0,0,0,0,0,0,133,
0,0,165,165,165,165,165,165,165,
0,146,146,146,146,146,146,146,146,
0,0,0,0,0,0,0,141,141,
128,128,128,128,128,128,0,0,0,
160,160,160,160,160,160,160,0,0,
148,148,148,148,148,148,148,0,0,
129,129,129,129,129,129,129,129,0,
124,0,124,124,124,0,124,0,0,
154,0,154,154,154,0,154,154,154,
0,0,0,0,142,0,142,0,142,
131,131,131,0,131,0,131,0,131,
120,0,120,0,120,0,0,0,120,
119,0,119,0,119,0,119,119,119,
108,0,108,0,108,0,108,108,108,
107,0,107,0,107,0,107,107,107,
106,0,0,0,106,0,0,0,0,
0,95,95,95,0,0,95,95,95,
0,94,94,94,0,0,94,94,94,
0,0,0,93,93,0,93,93,93,
92,92,0,0,92,0,0,0,0,
91,91,91,0,91,91,91,91,0,
90,90,0,90,90,90,90,0,90,
0,0,0,0,0,0,0,0,0,
0,0,0,0,0,0,0,0,0,
0,0,0,0,0,0,0,0,0.