[layer]
type=Tile Layer 1
data=
1,21,1,1,1,0,1,1,1,
1,0,1,1,1,0,21,0,0,
1,21,1,1,1,1,1,1,1,
1,0,0,21,1,0,1,1,1,
1,21,1,1,1,0,1,1,1,
1,21,1,1,1,0,1,1,1,
1,1,1,1,1,21,1,0,1,
1,1,1,1,1,21,1,0,1,
0,0,0,0,1,21,1,0,1,
1,1,1,21,1,1,1,0,1,
1,0,21,0,0,0,1,0,0,
1,1,21,1,1,1,1,1,1,
1,1,21,1,1,1,1,1,1,
1,1,0,0,0,0,21,0,0,
1,1,21,1,1,1,1,1,1,
1,21,0,0,1,0,0,0,1,
1,1,1,21,1,0,1,1,1,
0,0,1,0,1,21,0,0,1,
1,1,1,21,1,1,1,0,1,
1,21,0,0,1,0,1,0,1,
1,21,1,1,1,0,1,0,1,
1,0,1,21,0,0,1,0,0,
1,21,1,0,1,0,1,1,1,
0,0,1,0,1,0,0,0,21,
1,1,0,0,21,0,1,1,1,
1,1,1,0,1,21,0,1,1,
1,1,1,21,1,1,0,1,1,
1,1,1,21,1,1,0,0,0,
1,1,1,1,0,0,0,21,0,
1,1,0,21,1,0,1,1,1,
1,1,21,1,1,0,1,1,1,
1,1,1,21,1,0,0,0,1,
1,1,1,0,0,21,1,0,1,
1,21,0,1,1,0,0,1,1,
1,21,1,0,0,1,1,1,1,
1,0,1,1,0,0,21,0,1,
1,0,21,0,0,0,0,0,1,
1,1,21,1,0,1,1,1,1,
1,1,21,1,0,1,1,1,1,
0,0,0,0,0,0,0,0,0,
0,0,0,0,0,0,0,0,0,
0,0,0,0,0,0,0,0,0.
[layer]
type=Tile Layer 2
data=
197,0,197,197,197,0,197,197,197,
195,0,195,195,195,0,0,0,0,
184,0,184,184,184,184,184,184,184,
146,0,0,0,146,0,146,146,146,
133,0,133,133,133,0,133,133,133,
166,0,166,166,166,0,166,166,166,
153,153,153,153,153,0,153,0,153,
141,141,141,141,141,0,141,0,141,
0,0,0,0,129,0,129,0,129,
161,161,161,0,161,161,161,0,161,
148,0,0,0,0,0,148,0,0,
130,130,0,130,130,130,130,130,130,
118,118,0,118,118,118,118,118,118,
155,155,0,0,0,0,0,0,0,
136,136,0,136,136,136,136,136,136,
131,0,0,0,131,0,0,0,131,
120,120,120,0,120,0,120,120,120,
0,0,149,0,149,0,0,0,149,
138,138,138,0,138,138,138,0,138,
127,0,0,0,127,0,127,0,127,
115,0,115,115,115,0,115,0,115,
144,0,144,0,0,0,144,0,0,
133,0,133,0,133,0,133,133,133,
0,0,122,0,122,0,0,0,0,
111,111,0,0,0,0,111,111,111,
138,138,138,0,138,0,0,138,138,
127,127,127,0,127,127,0,127,127,
117,117,117,0,117,117,0,0,0,
107,107,107,107,0,0,0,0,0,
106,106,0,0,106,0,106,106,106,
96,96,0,96,96,0,96,96,96,
95,95,95,0,95,0,0,0,95,
94,94,94,0,0,0,94,0,94,
84,0,0,84,84,0,0,84,84,
83,0,83,0,0,83,83,83,83,
82,0,82,82,0,0,0,0,82,
81,0,0,0,0,0,0,0,81,
80,80,0,80,0,80,80,80,80,
79,79,0,79,0,79,79,79,79,
0,0,0,0,0,0,0,0,0,
0,0,0,0,0,0,0,0,0,
0,0,0,0,0,0,0,0,0.