[layer]
type=Tile Layer 1
data=
0,1,1,1,1,1,1,1,21,
0,0,0,21,0,2,24,2,0,
1,1,1,1,1,1,21,1,0,
2,2,0,0,0,0,0,21,18,
1,1,21,1,1,1,1,1,1,
1,1,21,1,1,1,1,1,0,
1,1,1,1,1,1,1,2,21,
0,21,0,0,0,0,0,2,24,
21,1,1,1,1,1,1,1,1,
1,1,1,21,2,2,1,1,1,
0,0,1,0,19,0,21,0,1,
2,2,2,21,2,2,2,18,2,
0,21,0,0,1,1,1,0,1,
1,1,2,21,2,1,1,1,1,
1,1,2,24,0,21,0,0,1,
1,1,1,21,1,1,1,1,1,
1,1,1,0,1,0,0,21,0,
1,1,1,21,1,1,1,0,1,
1,21,1,1,1,0,1,1,1,
1,0,21,0,1,0,0,0,1,
1,24,2,21,1,1,1,0,1,
1,21,1,0,0,0,1,0,0,
1,1,1,1,1,21,1,1,1,
0,0,0,0,1,0,0,21,1,
1,21,1,0,1,2,2,0,1,
1,0,1,0,1,21,19,0,1,
1,0,1,21,1,0,2,2,1,
0,0,2,2,2,21,18,2,2,
0,2,2,2,2,2,21,0,18,
0,21,0,1,1,1,1,1,0,
0,2,0,21,1,1,1,1,1,
24,2,0,21,0,1,1,1,1,
0,0,1,1,0,21,1,1,1,
0,1,21,0,1,1,1,1,1,
0,0,21,0,0,0,1,1,1,
18,2,2,0,0,21,2,2,2,
1,1,1,21,1,1,0,1,1,
1,1,1,0,1,1,21,0,1,
1,1,21,0,1,1,1,0,0,
1,1,21,0,0,0,0,0,0,
1,1,1,21,1,1,1,1,1,
1,1,1,0,0,21,0,0,0,
0,0,0,0,0,0,0,0,0,
0,0,0,0,0,0,0,0,0,
0,0,0,0,0,0,0,0,0.
[layer]
type=Tile Layer 2
data=
0,203,203,203,203,203,203,203,0,
0,0,0,0,0,201,0,201,0,
200,200,200,200,200,200,0,200,0,
138,138,0,0,0,0,0,0,0,
164,164,0,164,164,164,164,164,164,
160,160,0,160,160,160,160,160,0,
140,140,140,140,140,140,140,140,0,
0,0,0,0,0,0,0,134,0,
0,159,159,159,159,159,159,159,159,
147,147,147,0,147,147,147,147,147,
0,0,142,0,0,0,0,0,142,
130,130,130,0,130,130,130,0,130,
0,0,0,0,162,162,162,0,162,
142,142,142,0,142,142,142,142,142,
137,137,137,0,0,0,0,0,137,
119,119,119,0,119,119,119,119,119,
156,156,156,0,156,0,0,0,0,
144,144,144,0,144,144,144,0,144,
132,0,132,132,132,0,132,132,132,
121,0,0,0,121,0,0,0,121,
150,0,150,0,150,150,150,0,150,
139,0,139,0,0,0,139,0,0,
122,122,122,122,122,0,122,122,122,
0,0,0,0,116,0,0,0,116,
145,0,145,0,145,145,145,0,145,
134,0,134,0,134,0,0,0,134,
123,0,123,0,123,0,123,123,123,
0,0,112,112,112,0,0,112,112,
0,139,139,139,139,139,0,0,0,
0,0,0,128,128,128,128,128,0,
0,118,0,0,118,118,118,118,118,
0,108,0,0,0,108,108,108,108,
0,0,107,107,0,0,107,107,107,
0,97,0,0,97,97,97,97,97,
0,0,0,0,0,0,96,96,96,
0,95,95,0,0,0,95,95,95,
85,85,85,0,85,85,0,85,85,
84,84,84,0,84,84,0,0,84,
83,83,0,0,83,83,83,0,0,
82,82,0,0,0,0,0,0,0,
78,78,78,0,78,78,78,78,78,
80,80,80,0,0,0,0,0,0,
0,0,0,0,0,0,0,0,0,
0,0,0,0,0,0,0,0,0,
0,0,0,0,0,0,0,0,0.