[layer]
type=Tile Layer 1
data=
3,1,1,1,1,1,0,21,0,
5,1,5,0,21,0,0,1,6,
1,1,1,21,1,1,3,1,1,
1,1,1,0,0,0,21,0,1,
1,4,0,21,1,1,1,0,0,
5,3,0,0,0,0,21,0,0,
1,4,1,1,0,0,21,0,0,
1,1,1,6,1,5,21,0,0,
0,0,0,0,0,21,0,1,1,
0,21,6,1,5,1,1,5,1,
1,0,0,0,21,0,0,0,0,
1,1,1,4,1,1,0,21,0,
1,1,4,6,6,1,21,1,1,
1,1,1,3,0,21,0,1,3,
1,1,4,1,21,1,1,1,1,
5,21,1,0,1,1,1,1,3,
0,0,4,0,1,21,0,0,0,
3,1,1,21,1,0,1,1,1,
1,0,0,21,1,0,1,0,1,
1,0,4,1,1,21,3,0,1,
5,21,1,0,0,0,1,0,0,
4,21,1,0,1,1,6,0,1,
5,21,1,0,1,0,1,0,0,
1,0,1,21,1,0,1,1,4,
0,1,21,4,1,6,0,1,4,
0,0,0,1,0,0,21,0,0,
1,1,1,1,21,3,1,1,1,
0,21,0,1,0,0,0,0,0,
1,6,1,1,21,1,1,3,1,
1,4,1,1,21,1,6,1,1,
1,1,3,1,21,1,1,1,1,
0,1,0,0,21,1,1,4,1,
5,1,21,4,3,1,1,1,1,
0,1,21,0,0,1,1,3,1,
21,1,1,4,1,6,1,4,1,
0,0,0,1,0,0,21,0,0,
6,1,21,1,0,1,1,1,6,
1,1,21,1,0,1,4,1,0,
4,1,21,5,0,1,1,1,0,
0,0,0,0,0,0,0,0,0,
0,0,0,0,0,0,0,0,0,
0,0,0,0,0,0,0,0,0.
[layer]
type=Tile Layer 2
data=
197,197,197,197,197,197,0,0,0,
195,195,195,0,0,0,0,195,195,
184,184,184,0,184,184,184,184,184,
146,146,146,0,0,0,0,0,146,
133,133,0,0,133,133,133,0,0,
166,166,0,0,0,0,0,0,0,
153,153,153,153,0,0,0,0,0,
141,141,141,141,141,141,0,0,0,
0,0,0,0,0,0,0,129,129,
0,0,161,161,161,161,161,161,161,
148,0,0,0,0,0,0,0,0,
136,136,136,136,136,136,0,0,0,
118,118,118,118,118,118,0,118,118,
155,155,155,155,0,0,0,155,155,
136,136,136,136,0,136,136,136,136,
131,0,131,0,131,131,131,131,131,
0,0,120,0,120,0,0,0,0,
149,149,149,0,149,0,149,149,149,
138,0,0,0,138,0,138,0,138,
127,0,127,127,127,0,127,0,127,
115,0,115,0,0,0,115,0,0,
144,0,144,0,144,144,144,0,144,
133,0,133,0,133,0,133,0,0,
122,0,122,0,122,0,122,122,122,
0,111,0,111,111,111,0,111,111,
0,0,0,138,0,0,0,0,0,
121,121,121,121,0,121,121,121,121,
0,0,0,117,0,0,0,0,0,
102,102,102,102,0,102,102,102,102,
101,101,101,101,0,101,101,101,101,
91,91,91,91,0,91,91,91,91,
0,95,0,0,0,95,95,95,95,
89,89,0,89,89,89,89,89,89,
0,84,0,0,0,84,84,84,84,
0,79,79,79,79,79,79,79,79,
0,0,0,82,0,0,0,0,0,
81,81,0,81,0,81,81,81,81,
80,80,0,80,0,80,80,80,0,
79,79,0,79,0,79,79,79,0,
0,0,0,0,0,0,0,0,0,
0,0,0,0,0,0,0,0,0,
0,0,0,0,0,0,0,0,0.