[layer]
type=Tile Layer 1
data=
1,21,1,1,1,4,1,1,6,
6,0,0,0,0,21,0,1,1,
1,1,1,3,1,1,21,1,3,
1,1,1,1,1,1,21,3,1,
1,5,1,1,1,5,21,0,0,
1,1,6,1,21,0,0,0,0,
1,1,6,21,0,1,1,1,1,
1,1,3,0,0,0,21,0,0,
1,3,4,1,1,1,1,1,21,
1,1,0,1,21,5,0,3,0,
0,1,0,4,0,5,21,1,0,
1,1,21,1,1,1,0,1,1,
0,0,0,1,0,0,21,0,0,
1,1,21,1,1,1,6,5,0,
3,1,0,0,21,0,0,1,0,
1,1,21,1,1,1,1,1,0,
3,1,0,0,0,6,21,0,0,
1,1,1,3,1,1,21,5,1,
1,0,0,0,21,0,0,1,4,
3,1,1,1,6,1,21,1,1,
4,1,0,0,21,0,0,1,1,
5,1,21,4,6,1,5,1,1,
1,1,0,0,0,21,0,1,1,
1,4,1,1,1,1,21,0,1,
1,6,4,5,0,21,0,0,1,
1,6,1,21,0,1,1,1,1,
1,1,1,21,1,1,1,1,5,
0,21,1,5,1,6,1,1,1,
0,21,1,1,1,1,1,1,1,
0,0,0,0,21,5,3,1,1,
0,0,3,1,0,21,0,5,1,
0,0,1,4,1,0,21,1,1,
0,1,1,1,1,0,21,3,1,
0,1,1,1,4,1,0,21,1,
6,1,1,1,0,21,1,0,0,
1,6,1,5,1,0,0,21,0,
1,1,0,1,21,1,1,1,0,
0,0,21,1,0,0,0,4,0,
4,1,5,3,21,1,1,1,0,
0,0,0,1,21,5,1,1,0,
1,1,21,1,0,6,1,4,1,
1,4,0,1,0,0,0,21,0,
5,1,21,1,1,1,5,6,0,
1,1,0,3,0,21,0,0,0,
1,1,21,1,0,1,1,1,1,
0,1,0,21,1,1,1,4,1,
0,6,21,1,1,1,6,1,5,
0,1,1,0,21,5,1,1,1,
0,1,0,21,1,1,1,1,1,
21,5,3,1,1,1,1,1,4,
0,0,21,0,0,0,4,1,1,
0,0,0,0,0,0,0,0,0,
0,0,0,0,0,0,0,0,0,
0,0,0,0,0,0,0,0,0.
[layer]
type=Tile Layer 2
data=
223,0,223,223,223,223,223,223,223,
233,0,0,0,0,0,0,233,233,
220,220,220,220,220,220,0,220,220,
166,166,166,166,166,166,0,166,166,
159,159,159,159,159,159,0,0,0,
199,199,199,199,0,0,0,0,0,
184,184,184,0,0,184,184,184,184,
169,169,169,0,0,0,0,0,0,
147,147,147,147,147,147,147,147,0,
193,193,0,193,0,193,0,193,0,
0,179,0,179,0,179,0,179,0,
165,165,0,165,165,165,0,165,165,
0,0,0,150,0,0,0,0,0,
188,188,0,188,188,188,188,188,0,
174,174,0,0,0,0,0,174,0,
160,160,0,160,160,160,160,160,0,
146,146,0,0,0,146,0,0,0,
173,173,173,173,173,173,0,173,173,
168,0,0,0,0,0,0,168,168,
148,148,148,148,148,148,0,148,148,
142,142,0,0,0,0,0,142,142,
168,168,0,168,168,168,168,168,168,
163,163,0,0,0,0,0,163,163,
150,150,150,150,150,150,0,0,150,
137,137,137,137,0,0,0,0,137,
171,171,171,0,0,171,171,171,171,
151,151,151,0,151,151,151,151,151,
0,0,145,145,145,145,145,145,145,
0,0,133,133,133,133,133,133,133,
0,0,0,0,0,165,165,165,165,
0,0,153,153,0,0,0,153,153,
0,0,141,141,141,0,0,141,141,
0,128,128,128,128,0,0,128,128,
0,160,160,160,160,160,0,0,160,
148,148,148,148,0,0,148,0,0,
136,136,136,136,136,0,0,0,0,
124,124,0,124,0,124,124,124,0,
0,0,0,154,0,0,0,154,0,
142,142,142,142,0,142,142,142,0,
0,0,0,131,0,131,131,131,0,
120,120,0,120,0,120,120,120,120,
119,119,0,119,0,0,0,0,0,
108,108,0,108,108,108,108,108,0,
107,107,0,107,0,0,0,0,0,
106,106,0,106,0,106,106,106,106,
0,95,0,0,95,95,95,95,95,
0,94,0,94,94,94,94,94,94,
0,93,93,0,0,93,93,93,93,
0,92,0,0,92,92,92,92,92,
0,87,87,87,87,87,87,87,87,
0,0,0,0,0,0,90,90,90,
0,0,0,0,0,0,0,0,0,
0,0,0,0,0,0,0,0,0,
0,0,0,0,0,0,0,0,0.