[layer]
type=Tile Layer 1
data=
1,1,21,1,1,1,0,1,1,
0,0,0,1,1,1,21,0,0,
0,1,1,1,21,1,1,1,0,
0,1,21,1,0,1,1,0,0,
1,1,21,1,1,1,0,1,1,
1,0,0,1,21,1,0,1,0,
1,1,0,0,21,0,0,1,1,
1,1,21,1,1,1,1,1,1,
1,0,21,0,0,0,0,0,1,
1,21,1,1,1,1,1,0,1,
0,0,1,0,0,0,1,21,1,
0,0,1,1,1,1,1,21,0,
0,0,0,0,0,0,0,0,0,
0,0,0,0,0,0,0,0,0,
0,0,0,0,0,0,0,0,0.
[layer]
type=Tile Layer 2
data=
84,84,0,84,84,84,0,84,84,
0,0,0,63,63,63,0,0,0,
0,62,62,62,0,62,62,62,0,
0,61,0,61,0,61,61,0,0,
51,51,0,51,51,51,0,51,51,
53,0,0,53,0,53,0,53,0,
52,52,0,0,0,0,0,52,52,
46,46,0,46,46,46,46,46,46,
50,0,0,0,0,0,0,0,50,
47,0,47,47,47,47,47,0,47,
0,0,48,0,0,0,48,0,48,
0,0,47,47,47,47,47,0,0,
0,0,0,0,0,0,0,0,0,
0,0,0,0,0,0,0,0,0,
0,0,0,0,0,0,0,0,0.