[layer]
type=Tile Layer 1
data=
0,3,1,1,21,6,1,1,0,
1,1,0,0,0,5,0,1,21,
1,1,0,2,2,6,21,1,1,
1,1,21,19,0,4,0,2,0,
1,1,0,2,1,1,2,19,21,
0,1,21,1,1,1,0,2,0,
0,1,1,3,0,1,21,4,1,
0,0,0,1,0,2,0,2,21,
2,2,0,1,21,2,24,2,0,
20,2,2,2,2,2,2,2,21,
0,0,21,1,1,1,1,1,0,
5,1,21,0,0,2,0,0,0,
6,1,1,1,21,0,24,2,1,
1,1,1,0,21,0,2,5,1,
1,1,0,21,5,0,0,0,0,
0,0,0,0,0,0,0,0,0,
0,0,0,0,0,0,0,0,0,
0,0,0,0,0,0,0,0,0.
[layer]
type=Tile Layer 2
data=
0,94,94,94,0,94,94,94,0,
73,73,0,0,0,73,0,73,0,
68,68,0,68,68,68,0,68,68,
71,71,0,0,0,71,0,71,0,
64,64,0,64,64,64,64,0,0,
0,63,0,63,63,63,0,63,0,
0,62,62,62,0,62,0,62,62,
0,0,0,55,0,55,0,55,0,
54,54,0,54,0,54,0,54,0,
0,50,50,50,50,50,50,50,0,
0,0,0,52,52,52,52,52,0,
51,51,0,0,0,51,0,0,0,
50,50,50,50,0,0,0,50,50,
49,49,49,0,0,0,49,49,49,
48,48,0,0,48,0,0,0,0,
0,0,0,0,0,0,0,0,0,
0,0,0,0,0,0,0,0,0,
0,0,0,0,0,0,0,0,0.