[layer]
type=Tile Layer 1
data=
4,1,0,1,21,0,1,1,1,
0,0,0,0,21,0,2,2,3,
0,21,2,2,2,2,2,9,2,
1,21,0,6,0,0,2,2,1,
1,1,0,21,0,0,2,8,4,
3,1,21,1,1,2,2,2,1,
0,0,0,21,0,2,19,2,1,
24,2,2,1,2,10,2,21,3,
2,10,2,1,2,2,21,0,1,
19,0,2,0,1,21,1,0,1,
2,2,3,21,5,1,1,0,1,
7,2,2,2,21,18,2,0,2,
3,1,1,3,1,5,4,21,1,
1,0,1,5,1,1,1,21,0,
1,21,1,1,1,2,2,0,1,
2,0,0,21,0,2,20,0,2,
1,21,6,1,2,8,2,2,1,
2,0,2,0,2,18,21,0,2,
1,1,21,1,1,5,0,1,1,
1,21,2,2,2,4,1,0,1,
3,0,2,8,2,21,2,0,1,
2,21,2,2,2,2,2,20,2,
0,1,1,5,0,1,2,2,21,
0,0,0,1,1,6,21,0,0,
0,0,0,0,0,0,0,0,0,
0,0,0,0,0,0,0,0,0,
0,0,0,0,0,0,0,0,0.
[layer]
type=Tile Layer 2
data=
139,139,0,139,0,0,139,139,139,
0,0,0,0,0,0,137,137,137,
0,0,136,136,136,136,136,136,136,
110,0,0,110,0,0,110,110,110,
101,101,0,0,0,0,101,101,101,
83,83,0,83,83,83,83,83,83,
0,0,0,0,0,114,0,114,114,
0,105,105,105,105,105,105,0,105,
96,96,96,96,96,96,0,0,96,
0,0,87,0,87,0,87,0,87,
103,103,103,0,103,103,103,0,103,
99,99,99,99,0,0,99,0,99,
82,82,82,82,82,82,82,0,82,
83,0,83,83,83,83,83,0,0,
78,0,78,78,78,78,78,0,78,
74,0,0,0,0,74,0,0,74,
69,0,69,69,69,69,69,69,69,
72,0,72,0,72,0,0,0,72,
61,61,0,61,61,61,0,61,61,
60,0,60,60,60,60,60,0,60,
62,0,62,62,62,0,62,0,62,
58,0,58,58,58,58,58,0,58,
0,60,60,60,0,60,60,60,0,
0,0,0,59,59,59,0,0,0,
0,0,0,0,0,0,0,0,0,
0,0,0,0,0,0,0,0,0,
0,0,0,0,0,0,0,0,0.