[layer]
type=Tile Layer 1
data=
1,1,1,1,1,1,1,21,0,
1,1,6,1,1,0,21,0,1,
1,1,5,6,1,21,1,3,5,
1,1,1,1,1,4,1,3,21,
1,4,1,0,0,21,0,0,0,
1,1,1,21,1,3,1,6,1,
0,21,0,0,3,4,1,1,1,
1,1,1,21,1,1,1,1,1,
5,21,5,0,0,0,0,0,1,
1,21,1,1,6,0,1,1,1,
0,21,0,0,1,0,1,0,1,
1,1,1,4,6,21,5,0,1,
1,21,1,1,1,0,1,6,3,
1,0,0,0,21,0,1,4,1,
1,21,3,1,6,1,1,1,1,
1,0,1,0,0,21,0,0,1,
1,1,1,21,1,4,1,6,1,
1,1,1,21,4,3,1,1,6,
3,1,1,21,1,6,1,1,1,
0,0,0,21,6,1,5,1,1,
1,21,1,1,1,1,1,5,1,
0,0,0,0,21,0,1,0,4,
1,4,1,3,1,1,1,21,1,
1,1,1,1,5,0,21,0,0,
1,1,1,1,1,21,1,3,1,
4,1,4,1,1,21,1,1,1,
1,1,1,1,3,21,6,1,6,
0,0,21,0,1,0,1,1,5,
1,1,1,1,1,21,3,4,5,
1,1,1,0,0,0,0,21,0,
0,21,1,0,6,1,1,0,0,
0,1,3,1,1,1,21,1,1,
0,1,1,4,1,6,21,1,0,
0,3,1,4,5,4,21,1,0,
0,21,0,1,0,0,0,0,0,
1,1,1,1,1,1,1,1,21,
0,21,0,0,0,1,1,1,0,
3,1,21,6,1,1,1,1,0,
0,3,0,1,21,1,1,5,0,
0,0,21,0,1,5,1,5,1,
0,1,21,0,1,1,1,1,1,
0,1,21,1,3,4,1,1,1,
4,5,0,0,21,0,0,0,0,
3,1,1,1,1,21,0,1,0,
1,3,1,1,1,1,0,21,0,
4,1,1,5,1,1,1,21,0,
1,1,1,1,1,21,0,0,0,
1,1,1,1,3,0,5,21,0,
1,1,0,21,0,4,1,1,1,
1,1,0,0,21,0,1,1,1,
3,4,6,21,0,0,0,0,0,
1,1,1,1,0,21,0,1,0,
3,1,3,1,1,1,21,0,0,
1,6,4,1,1,0,21,0,0,
0,0,0,0,0,0,0,0,0,
0,0,0,0,0,0,0,0,0,
0,0,0,0,0,0,0,0,0.
[layer]
type=Tile Layer 2
data=
239,239,239,239,239,239,239,0,0,
237,237,237,237,237,0,0,0,237,
224,224,224,224,224,0,224,224,224,
156,156,156,156,156,156,156,156,0,
205,205,205,0,0,0,0,0,0,
180,180,180,0,180,180,180,180,180,
0,0,0,0,174,174,174,174,174,
152,152,152,0,152,152,152,152,152,
199,0,199,0,0,0,0,0,199,
184,0,184,184,184,0,184,184,184,
0,0,0,0,169,0,169,0,169,
155,155,155,155,155,0,155,0,155,
193,0,193,193,193,0,193,193,193,
179,0,0,0,0,0,179,179,179,
157,0,157,157,157,157,157,157,157,
150,0,150,0,0,0,0,0,150,
179,179,179,0,179,179,179,179,179,
165,165,165,0,165,165,165,165,165,
152,152,152,0,152,152,152,152,152,
0,0,0,0,146,146,146,146,146,
173,0,173,173,173,173,173,173,173,
0,0,0,0,0,0,168,0,168,
148,148,148,148,148,148,148,0,148,
142,142,142,142,142,0,0,0,0,
168,168,168,168,168,0,168,168,168,
155,155,155,155,155,0,155,155,155,
143,143,143,143,143,0,143,143,143,
0,0,0,0,137,0,137,137,137,
163,163,163,163,163,0,163,163,163,
158,158,158,0,0,0,0,0,0,
0,0,145,0,145,145,145,0,0,
0,133,133,133,133,133,0,133,133,
0,165,165,165,165,165,0,165,0,
0,153,153,153,153,153,0,153,0,
0,0,0,141,0,0,0,0,0,
122,122,122,122,122,122,122,122,0,
0,0,0,0,0,160,160,160,0,
148,148,0,148,148,148,148,148,0,
0,136,0,136,0,136,136,136,0,
0,0,0,0,124,124,124,124,124,
0,154,0,0,154,154,154,154,154,
0,142,0,142,142,142,142,142,142,
131,131,0,0,0,0,0,0,0,
120,120,120,120,120,0,0,120,0,
119,119,119,119,119,119,0,0,0,
108,108,108,108,108,108,108,0,0,
107,107,107,107,107,0,0,0,0,
106,106,106,106,106,0,106,0,0,
95,95,0,0,0,95,95,95,95,
94,94,0,0,0,0,94,94,94,
93,93,93,0,0,0,0,0,0,
92,92,92,92,0,0,0,92,0,
91,91,91,91,91,91,0,0,0,
90,90,90,90,90,0,0,0,0,
0,0,0,0,0,0,0,0,0,
0,0,0,0,0,0,0,0,0,
0,0,0,0,0,0,0,0,0.