[layer]
type=Tile Layer 1
data=
1,21,0,1,0,1,1,1,1,
5,4,21,5,0,1,1,1,1,
6,1,1,1,0,21,0,1,4,
0,0,1,1,0,0,0,0,21,
0,0,21,5,1,1,1,1,0,
6,1,21,0,1,1,4,1,0,
0,0,6,1,1,1,3,1,21,
0,21,1,1,1,1,1,1,0,
0,21,1,1,4,1,3,1,0,
0,21,4,6,1,1,1,1,1,
1,0,0,21,0,0,0,0,0,
1,5,1,21,1,1,4,1,0,
6,0,0,0,1,21,0,0,0,
0,1,1,21,0,0,1,4,0,
0,0,21,1,1,1,3,1,1,
1,0,1,21,0,0,6,0,4,
1,21,1,1,1,1,1,0,1,
4,0,0,0,1,21,5,0,0,
1,1,1,21,1,0,6,1,1,
0,0,0,21,0,0,5,0,3,
1,1,1,1,1,21,6,0,1,
1,0,21,0,1,0,1,0,1,
1,21,1,0,5,0,1,0,1,
4,0,1,0,6,0,21,0,1,
0,4,1,1,1,5,1,1,21,
0,0,0,21,0,0,0,1,0,
1,1,1,1,4,1,21,1,3,
1,1,1,1,21,0,0,1,1,
1,1,5,1,4,1,21,3,1,
1,5,1,4,0,1,21,0,0,
1,1,1,1,21,1,0,1,1,
0,0,0,21,0,1,0,1,1,
21,1,1,6,4,1,1,3,3,
1,0,3,0,0,21,4,0,0,
1,1,1,1,1,21,4,1,1,
0,0,21,0,1,0,6,1,1,
1,21,1,0,4,0,1,1,4,
1,21,1,0,1,0,1,1,3,
3,21,1,5,1,1,1,1,1,
0,0,0,0,0,0,0,0,0,
0,0,0,0,0,0,0,0,0,
0,0,0,0,0,0,0,0,0.
[layer]
type=Tile Layer 2
data=
198,0,0,198,0,198,198,198,198,
196,196,0,196,0,196,196,196,196,
195,195,195,195,0,0,0,195,195,
0,0,147,147,0,0,0,0,0,
0,0,0,134,134,134,134,134,0,
167,167,0,0,167,167,167,167,0,
0,0,154,154,154,154,154,154,0,
0,0,142,142,142,142,142,142,0,
0,0,130,130,130,130,130,130,0,
0,0,162,162,162,162,162,162,162,
149,0,0,0,0,0,0,0,0,
137,137,137,0,137,137,137,137,0,
125,0,0,0,125,0,0,0,0,
0,156,156,0,0,0,156,156,0,
0,0,0,144,144,144,144,144,144,
132,0,132,0,0,0,132,0,132,
121,0,121,121,121,121,121,0,121,
150,0,0,0,150,0,150,0,0,
139,139,139,0,139,0,139,139,139,
0,0,0,0,0,0,128,0,128,
116,116,116,116,116,0,116,0,116,
145,0,0,0,145,0,145,0,145,
134,0,134,0,134,0,134,0,134,
123,0,123,0,123,0,0,0,123,
0,112,112,112,112,112,112,112,0,
0,0,0,0,0,0,0,139,0,
122,122,122,122,122,122,0,122,122,
118,118,118,118,0,0,0,118,118,
103,103,103,103,103,103,0,103,103,
107,107,107,107,0,107,0,0,0,
97,97,97,97,0,97,0,97,97,
0,0,0,0,0,96,0,96,96,
0,90,90,90,90,90,90,90,90,
85,0,85,0,0,0,85,0,0,
80,80,80,80,80,0,80,80,80,
0,0,0,0,83,0,83,83,83,
82,0,82,0,82,0,82,82,82,
81,0,81,0,81,0,81,81,81,
77,0,77,77,77,77,77,77,77,
0,0,0,0,0,0,0,0,0,
0,0,0,0,0,0,0,0,0,
0,0,0,0,0,0,0,0,0.