[layer]
type=Tile Layer 1
data=
1,4,21,1,1,1,1,1,1,
0,1,0,4,5,1,0,0,21,
0,6,0,1,1,1,0,1,21,
0,1,0,1,1,1,0,1,21,
0,1,21,3,1,3,0,4,1,
0,1,21,1,0,0,0,6,0,
0,1,5,4,4,1,1,1,21,
0,21,0,1,1,1,1,1,0,
0,1,5,1,1,1,1,6,21,
1,1,1,5,1,1,0,21,0,
1,1,1,6,1,21,0,0,0,
4,1,1,0,0,21,1,5,0,
1,1,21,0,1,1,1,1,0,
5,1,0,21,1,5,0,0,0,
1,1,0,0,1,3,21,0,6,
1,1,21,6,1,1,1,0,1,
1,21,0,0,0,5,1,1,1,
0,21,5,1,0,3,1,1,1,
1,1,21,1,1,1,1,6,0,
1,1,5,1,4,1,6,4,21,
0,0,21,1,1,1,1,1,0,
1,6,1,6,1,3,1,1,21,
0,0,0,0,0,21,0,1,0,
0,1,4,1,1,1,1,1,21,
0,1,0,21,0,0,0,0,0,
0,1,21,1,1,1,6,1,1,
0,5,21,1,5,1,3,1,0,
1,4,1,0,21,0,0,0,1,
3,1,1,1,5,21,1,4,0,
1,1,1,1,1,21,0,0,0,
1,21,0,0,0,0,1,1,0,
1,0,1,21,1,1,5,1,0,
1,21,4,0,6,1,6,1,0,
0,0,0,0,0,0,0,0,0,
0,0,0,0,0,0,0,0,0,
0,0,0,0,0,0,0,0,0.
[layer]
type=Tile Layer 2
data=
162,162,0,162,162,162,162,162,162,
0,169,0,169,169,169,0,0,0,
0,167,0,167,167,167,0,167,0,
0,146,0,146,146,146,0,146,0,
0,134,0,134,134,134,0,134,134,
0,123,0,123,0,0,0,123,0,
0,112,112,112,112,112,112,112,0,
0,0,0,140,140,140,140,140,0,
0,129,129,129,129,129,129,129,0,
118,118,118,118,118,118,0,0,0,
108,108,108,108,108,0,0,0,0,
134,134,134,0,0,0,134,134,0,
124,124,0,0,124,124,124,124,0,
114,114,0,0,114,114,0,0,0,
103,103,0,0,103,103,0,0,103,
129,129,0,129,129,129,129,0,129,
119,0,0,0,0,119,119,119,119,
0,0,109,109,0,109,109,109,109,
99,99,0,99,99,99,99,99,0,
117,117,117,117,117,117,117,117,0,
0,0,0,113,113,113,113,113,0,
99,99,99,99,99,99,99,99,0,
0,0,0,0,0,0,0,95,0,
0,94,94,94,94,94,94,94,0,
0,85,0,0,0,0,0,0,0,
0,84,0,84,84,84,84,84,84,
0,83,0,83,83,83,83,83,0,
74,74,74,0,0,0,0,0,74,
73,73,73,73,73,0,73,73,0,
72,72,72,72,72,0,0,0,0,
71,0,0,0,0,0,71,71,0,
70,0,70,0,70,70,70,70,0,
69,0,69,0,69,69,69,69,0,
0,0,0,0,0,0,0,0,0,
0,0,0,0,0,0,0,0,0,
0,0,0,0,0,0,0,0,0.