[layer]
type=Tile Layer 1
data=
0,21,0,0,1,1,1,0,0,
0,1,1,1,1,1,1,0,21,
0,1,1,1,1,1,1,21,2,
0,0,1,0,21,0,1,2,9,
1,0,2,2,1,21,0,2,2,
1,21,8,2,2,2,0,0,1,
0,2,2,2,8,2,21,1,1,
0,1,1,2,2,2,1,21,1,
0,2,2,2,21,0,1,0,0,
1,1,0,1,0,1,21,1,0,
7,2,2,2,1,2,2,2,21,
0,1,1,1,0,1,1,0,21,
0,0,0,0,0,0,0,0,0,
0,0,0,0,0,0,0,0,0,
0,0,0,0,0,0,0,0,0.
[layer]
type=Tile Layer 2
data=
0,0,0,0,88,88,88,0,0,
0,63,63,63,63,63,63,0,0,
0,59,59,59,59,59,59,0,59,
0,0,61,0,0,0,61,61,61,
54,0,54,54,54,0,0,54,54,
53,0,53,53,53,53,0,0,53,
0,52,52,52,52,52,0,52,52,
0,49,49,49,49,49,49,0,49,
0,50,50,50,0,0,50,0,0,
49,49,0,49,0,49,0,49,0,
46,46,46,46,46,46,46,46,0,
0,47,47,47,0,47,47,0,0,
0,0,0,0,0,0,0,0,0,
0,0,0,0,0,0,0,0,0,
0,0,0,0,0,0,0,0,0.