[layer]
type=Tile Layer 1
data=
1,1,21,1,1,1,1,1,0,
1,1,21,1,1,1,1,1,0,
0,1,0,0,0,0,21,0,0,
0,1,1,1,0,21,0,1,1,
0,0,21,1,1,1,0,0,1,
1,1,0,0,0,21,1,0,1,
1,1,1,1,1,1,1,21,1,
1,1,0,0,0,21,1,0,0,
1,1,1,1,1,21,1,1,0,
1,0,0,0,0,0,0,21,0,
1,21,0,0,0,1,1,0,1,
1,1,1,1,0,21,0,0,1,
1,21,1,0,1,1,1,0,1,
1,0,1,21,1,1,1,0,1,
1,21,1,1,1,1,1,0,1,
1,0,0,21,0,0,1,0,1,
1,1,1,1,1,21,1,1,1,
1,1,1,1,1,21,0,0,0,
1,1,1,1,1,21,1,1,1,
1,1,1,1,1,0,1,21,0,
1,1,1,1,1,21,1,0,1,
0,1,0,0,0,0,21,0,0,
1,1,21,1,0,1,1,1,1,
1,1,21,1,0,1,1,1,1,
1,1,21,1,1,1,1,1,1,
0,0,0,1,21,0,0,1,0,
1,1,21,1,1,1,1,1,1,
0,1,0,1,1,1,1,1,21,
1,1,21,1,1,1,1,1,0,
1,1,21,1,1,1,1,1,0,
1,1,1,1,21,0,1,1,0,
1,1,1,1,0,21,0,0,0,
1,1,1,1,1,1,21,1,1,
1,1,0,21,0,0,0,1,1,
0,21,0,1,1,0,0,1,1,
0,0,21,0,1,0,1,1,1,
1,1,0,21,0,0,0,0,0,
0,0,0,1,0,21,0,0,0,
1,1,21,1,1,1,1,1,0,
1,1,1,0,21,1,1,1,0,
1,1,1,1,1,1,1,1,21,
0,0,0,0,0,1,21,0,0,
1,1,1,1,21,1,1,1,0,
1,1,21,1,0,1,1,1,0,
1,1,21,1,1,1,1,1,0,
0,0,0,0,0,0,0,0,0,
0,0,0,0,0,0,0,0,0,
0,0,0,0,0,0,0,0,0.
[layer]
type=Tile Layer 2
data=
208,208,0,208,208,208,208,208,0,
206,206,0,206,206,206,206,206,0,
0,204,0,0,0,0,0,0,0,
0,178,178,178,0,0,0,178,178,
0,0,0,165,165,165,0,0,165,
152,152,0,0,0,0,152,0,152,
132,132,132,132,132,132,132,0,132,
173,173,0,0,0,0,173,0,0,
160,160,160,160,160,0,160,160,0,
147,0,0,0,0,0,0,0,0,
134,0,0,0,0,134,134,0,134,
167,167,167,167,0,0,0,0,167,
154,0,154,0,154,154,154,0,154,
142,0,142,0,142,142,142,0,142,
130,0,130,130,130,130,130,0,130,
162,0,0,0,0,0,162,0,162,
142,142,142,142,142,0,142,142,142,
137,137,137,137,137,0,0,0,0,
119,119,119,119,119,0,119,119,119,
156,156,156,156,156,0,156,0,0,
144,144,144,144,144,0,144,0,144,
0,132,0,0,0,0,0,0,0,
121,121,0,121,0,121,121,121,121,
150,150,0,150,0,150,150,150,150,
132,132,0,132,132,132,132,132,132,
0,0,0,128,0,0,0,128,0,
111,111,0,111,111,111,111,111,111,
0,145,0,145,145,145,145,145,0,
134,134,0,134,134,134,134,134,0,
123,123,0,123,123,123,123,123,0,
112,112,112,112,0,0,112,112,0,
139,139,139,139,0,0,0,0,0,
122,122,122,122,122,122,0,122,122,
118,118,0,0,0,0,0,118,118,
0,0,0,108,108,0,0,108,108,
0,0,0,0,107,0,107,107,107,
97,97,0,0,0,0,0,0,0,
0,0,0,96,0,0,0,0,0,
95,95,0,95,95,95,95,95,0,
85,85,85,0,0,85,85,85,0,
80,80,80,80,80,80,80,80,0,
0,0,0,0,0,83,0,0,0,
82,82,82,82,0,82,82,82,0,
81,81,0,81,0,81,81,81,0,
80,80,0,80,80,80,80,80,0,
0,0,0,0,0,0,0,0,0,
0,0,0,0,0,0,0,0,0,
0,0,0,0,0,0,0,0,0.