[layer]
type=Tile Layer 1
data=
1,1,21,1,6,1,0,1,1,
0,0,0,1,21,1,0,0,0,
1,1,1,6,21,3,5,1,1,
0,0,21,1,0,0,0,0,0,
1,1,4,3,21,1,5,1,1,
0,1,0,1,21,1,0,0,0,
0,5,21,0,1,1,1,1,1,
1,1,21,1,0,1,1,3,1,
1,1,21,1,0,1,5,6,3,
1,0,0,1,21,0,0,1,3,
1,21,1,0,0,5,0,1,4,
3,21,1,1,0,1,1,1,1,
0,21,4,1,0,1,1,1,6,
0,21,0,0,0,0,1,3,0,
1,1,1,0,21,0,0,0,0,
0,0,0,1,0,1,21,1,0,
0,1,0,1,0,1,21,6,0,
0,4,0,0,0,1,0,1,21,
0,1,1,1,6,1,21,1,0,
0,4,0,0,0,0,21,1,0,
0,1,0,1,21,3,1,6,1,
0,0,0,0,0,0,0,0,0,
0,0,0,0,0,0,0,0,0,
0,0,0,0,0,0,0,0,0.
[layer]
type=Tile Layer 2
data=
127,127,0,127,127,127,0,127,127,
0,0,0,132,0,132,0,0,0,
117,117,117,117,0,117,117,117,117,
0,0,0,113,0,0,0,0,0,
94,94,94,94,0,94,94,94,94,
0,95,0,95,0,95,0,0,0,
0,86,0,0,86,86,86,86,86,
102,102,0,102,0,102,102,102,102,
94,94,0,94,0,94,94,94,94,
90,0,0,90,0,0,0,90,90,
82,0,82,0,0,82,0,82,82,
77,0,77,77,0,77,77,77,77,
0,0,73,73,0,73,73,73,73,
0,0,0,0,0,0,72,72,0,
71,71,71,0,0,0,0,0,0,
0,0,0,63,0,63,0,63,0,
0,62,0,62,0,62,0,62,0,
0,61,0,0,0,61,0,61,0,
0,60,60,60,60,60,0,60,0,
0,59,0,0,0,0,0,59,0,
0,58,0,58,0,58,58,58,58,
0,0,0,0,0,0,0,0,0,
0,0,0,0,0,0,0,0,0,
0,0,0,0,0,0,0,0,0.