[layer]
type=Tile Layer 1
data=
1,0,1,1,1,21,0,1,1,
1,21,0,0,0,1,1,0,1,
2,2,2,2,2,21,18,0,2,
0,1,1,1,21,1,0,1,0,
2,2,20,21,2,2,2,2,0,
0,1,1,1,21,1,1,6,4,
0,0,21,18,2,2,0,0,0,
0,1,1,1,1,1,21,1,0,
0,0,0,1,0,0,21,1,0,
0,0,0,0,0,0,0,0,0,
0,0,0,0,0,0,0,0,0,
0,0,0,0,0,0,0,0,0.
[layer]
type=Tile Layer 2
data=
75,0,75,75,75,0,0,75,75,
47,0,0,0,0,47,47,0,47,
47,47,47,47,47,0,0,0,47,
0,46,46,46,0,46,0,46,0,
45,45,0,0,45,45,45,45,0,
0,42,42,42,0,42,42,42,42,
0,0,0,0,43,43,0,0,0,
0,43,43,43,43,43,0,43,0,
0,0,0,42,0,0,0,42,0,
0,0,0,0,0,0,0,0,0,
0,0,0,0,0,0,0,0,0,
0,0,0,0,0,0,0,0,0.