[layer]
type=Tile Layer 1
data=
0,0,21,0,0,6,1,3,0,
1,4,1,1,21,1,1,1,0,
0,0,0,1,0,21,0,1,0,
0,1,21,1,1,6,0,1,0,
0,1,21,1,1,1,0,1,0,
0,1,1,6,3,1,21,1,4,
0,0,0,21,0,0,0,1,0,
1,1,1,3,21,1,0,5,1,
1,1,3,1,21,1,0,6,1,
1,1,1,1,21,6,0,1,1,
0,21,0,4,0,1,0,5,0,
0,4,1,1,1,1,21,1,1,
0,1,1,4,0,0,21,1,1,
1,4,6,1,1,21,3,1,1,
0,0,21,0,0,0,1,0,0,
1,1,1,1,6,21,1,0,4,
0,0,21,0,1,0,0,0,1,
1,1,1,21,1,4,1,1,5,
0,21,1,0,0,0,0,0,1,
1,0,4,6,1,21,1,0,1,
1,0,0,0,21,0,1,0,0,
1,1,6,1,1,0,1,21,0,
1,1,4,4,3,0,21,1,0,
1,1,1,1,3,1,21,1,0,
1,1,1,6,1,6,21,1,0,
1,0,0,21,0,1,4,0,0,
1,21,0,3,1,1,1,0,0,
6,1,21,0,0,1,1,1,0,
6,1,1,5,0,21,0,1,0,
1,1,1,3,1,1,21,1,0,
0,1,6,21,0,1,1,0,0,
4,1,1,21,4,3,1,1,0,
1,1,1,0,0,21,1,0,0,
0,0,0,0,3,21,1,0,1,
1,1,1,0,1,0,3,21,0,
5,1,1,21,1,1,4,1,0,
0,0,0,0,0,0,0,0,0,
0,0,0,0,0,0,0,0,0,
0,0,0,0,0,0,0,0,0.
[layer]
type=Tile Layer 2
data=
0,0,0,0,0,176,176,176,0,
175,175,175,175,0,175,175,175,0,
0,0,0,173,0,0,0,173,0,
0,140,0,140,140,140,0,140,0,
0,129,0,129,129,129,0,129,0,
0,118,118,118,118,118,0,118,118,
0,0,0,0,0,0,0,147,0,
135,135,135,135,0,135,0,135,135,
124,124,124,124,0,124,0,124,124,
113,113,113,113,0,113,0,113,113,
0,0,0,141,0,141,0,141,0,
0,130,130,130,130,130,0,130,130,
0,119,119,119,0,0,0,119,119,
104,104,104,104,104,0,104,104,104,
0,0,0,0,0,0,135,0,0,
125,125,125,125,125,0,125,0,125,
0,0,0,0,115,0,0,0,115,
100,100,100,0,100,100,100,100,100,
0,0,130,0,0,0,0,0,130,
120,0,120,120,120,0,120,0,120,
110,0,0,0,0,0,110,0,0,
100,100,100,100,100,0,100,0,0,
124,124,124,124,124,0,0,124,0,
114,114,114,114,114,114,0,114,0,
105,105,105,105,105,105,0,105,0,
96,0,0,0,0,96,96,0,0,
95,0,0,95,95,95,95,0,0,
86,86,0,0,0,86,86,86,0,
85,85,85,85,0,0,0,85,0,
84,84,84,84,84,84,0,84,0,
0,75,75,0,0,75,75,0,0,
74,74,74,0,74,74,74,74,0,
73,73,73,0,0,0,73,0,0,
0,0,0,0,72,0,72,0,72,
71,71,71,0,71,0,71,0,0,
70,70,70,0,70,70,70,70,0,
0,0,0,0,0,0,0,0,0,
0,0,0,0,0,0,0,0,0,
0,0,0,0,0,0,0,0,0.