[layer]
type=Tile Layer 1
data=
4,0,0,21,1,0,1,0,0,
1,2,2,21,2,24,2,1,5,
2,2,20,21,7,0,2,2,2,
1,21,2,2,1,0,1,1,5,
0,0,1,0,0,0,21,0,0,
2,21,1,6,1,0,1,4,1,
24,0,21,1,1,1,1,5,1,
0,2,21,1,1,3,6,1,1,
0,8,2,21,0,1,5,1,1,
0,0,2,1,0,21,1,1,1,
4,0,0,21,0,1,0,1,1,
1,1,6,5,1,1,21,1,4,
0,0,0,0,1,5,21,1,1,
0,0,1,1,0,21,0,1,1,
1,3,21,0,1,1,4,2,2,
1,21,1,0,1,2,2,2,10,
2,2,2,2,21,2,9,2,0,
2,21,1,4,1,0,2,8,5,
9,2,2,2,2,21,2,2,0,
2,21,1,1,4,0,1,6,1,
2,0,2,0,21,0,0,18,0,
2,21,1,3,1,6,2,2,1,
19,21,2,2,2,0,2,9,2,
2,2,1,1,1,21,2,2,2,
1,3,1,1,1,6,21,0,24,
2,2,2,2,2,7,21,2,24,
2,2,2,2,2,2,21,2,20,
5,1,1,21,2,2,0,0,0,
0,21,2,2,9,2,2,2,2,
1,1,0,21,2,2,0,0,3,
0,0,0,0,0,0,0,0,0,
0,0,0,0,0,0,0,0,0,
0,0,0,0,0,0,0,0,0.
[layer]
type=Tile Layer 2
data=
166,0,0,0,166,0,166,0,0,
164,164,164,0,164,0,164,164,164,
162,162,0,0,162,0,162,162,162,
112,0,112,112,112,0,112,112,112,
0,0,140,0,0,0,0,0,0,
129,0,129,129,129,0,129,129,129,
0,0,0,118,118,118,118,118,118,
0,108,0,108,108,108,108,108,108,
0,134,134,0,0,134,134,134,134,
0,0,124,124,0,0,124,124,124,
114,0,0,0,0,114,0,114,114,
99,99,99,99,99,99,0,99,99,
0,0,0,0,129,129,0,129,129,
0,0,119,119,0,0,0,119,119,
109,109,0,0,109,109,109,109,109,
99,0,99,0,99,99,99,99,99,
123,123,123,123,0,123,123,123,0,
113,0,113,113,113,0,113,113,113,
104,104,104,104,104,0,104,104,0,
95,0,95,95,95,0,95,95,95,
94,0,94,0,0,0,0,0,0,
81,0,81,81,81,81,81,81,81,
0,0,84,84,84,0,84,84,84,
79,79,79,79,79,0,79,79,79,
74,74,74,74,74,74,0,0,0,
73,73,73,73,73,73,0,73,0,
72,72,72,72,72,72,0,72,0,
71,71,71,0,71,71,0,0,0,
0,0,70,70,70,70,70,70,70,
69,69,0,0,69,69,0,0,69,
0,0,0,0,0,0,0,0,0,
0,0,0,0,0,0,0,0,0,
0,0,0,0,0,0,0,0,0.