[layer]
type=Tile Layer 1
data=
1,6,1,6,1,1,0,21,0,
1,5,1,1,1,1,1,1,21,
1,4,0,0,0,0,21,0,0,
1,1,21,0,0,0,1,1,1,
6,21,0,0,0,0,4,1,1,
1,21,0,1,1,1,5,5,1,
1,21,0,5,1,1,1,4,1,
6,21,0,1,1,1,1,1,1,
1,1,21,6,1,1,5,4,1,
0,1,1,1,21,4,0,1,5,
0,21,0,1,0,1,0,0,0,
0,1,21,1,0,3,1,3,1,
0,1,0,5,0,1,21,1,0,
0,4,1,6,0,1,0,1,21,
0,21,0,1,0,1,0,1,0,
1,1,1,1,21,6,0,1,1,
1,5,1,1,21,1,0,0,0,
1,1,5,6,21,1,1,3,1,
1,1,1,1,1,4,5,21,0,
3,1,0,0,21,0,0,0,0,
0,21,0,1,1,1,4,1,1,
21,1,1,1,6,5,1,1,4,
0,21,1,1,1,1,1,1,5,
1,21,6,1,4,1,1,1,1,
5,0,0,0,21,0,0,1,1,
1,1,1,0,0,21,0,3,1,
1,1,1,21,4,4,1,1,1,
1,1,21,0,0,0,0,1,6,
1,1,0,0,0,0,21,0,0,
1,1,1,1,5,3,21,1,0,
1,1,3,6,1,6,21,1,0,
1,5,1,1,3,21,1,1,0,
1,1,1,1,21,1,1,0,1,
0,0,0,21,1,1,0,4,1,
0,1,0,21,0,0,1,6,1,
0,21,1,1,1,3,3,1,1,
1,21,1,1,1,0,6,1,1,
5,0,1,1,1,0,1,21,0,
1,21,1,1,1,0,6,0,4,
1,0,0,21,6,0,1,0,1,
1,1,5,1,1,21,3,0,1,
0,0,0,0,0,0,1,21,1,
1,1,1,1,1,1,1,21,1,
0,0,1,4,3,0,0,0,21,
6,21,1,1,4,0,1,1,1,
1,1,1,5,3,1,0,21,0,
1,6,1,21,0,0,0,0,0,
0,0,21,0,1,1,1,3,1,
0,21,1,1,1,4,1,3,1,
5,21,0,5,1,1,1,1,1,
1,1,21,0,0,0,1,3,1,
0,0,0,0,0,0,0,0,0,
0,0,0,0,0,0,0,0,0,
0,0,0,0,0,0,0,0,0.
[layer]
type=Tile Layer 2
data=
234,234,234,234,234,234,0,0,0,
221,221,221,221,221,221,221,221,0,
231,231,0,0,0,0,0,0,0,
174,174,0,0,0,0,174,174,174,
159,0,0,0,0,0,159,159,159,
199,0,0,199,199,199,199,199,199,
184,0,0,184,184,184,184,184,184,
169,0,0,169,169,169,169,169,169,
147,147,0,147,147,147,147,147,147,
0,193,193,193,0,193,0,193,193,
0,0,0,179,0,179,0,0,0,
0,165,0,165,0,165,165,165,165,
0,150,0,150,0,150,0,150,0,
0,188,188,188,0,188,0,188,0,
0,0,0,174,0,174,0,174,0,
160,160,160,160,0,160,0,160,160,
146,146,146,146,0,146,0,0,0,
173,173,173,173,0,173,173,173,173,
168,168,168,168,168,168,168,0,0,
155,155,0,0,0,0,0,0,0,
0,0,0,142,142,142,142,142,142,
0,168,168,168,168,168,168,168,168,
0,0,163,163,163,163,163,163,163,
143,0,143,143,143,143,143,143,143,
137,0,0,0,0,0,0,137,137,
171,171,171,0,0,0,0,171,171,
151,151,151,0,151,151,151,151,151,
145,145,0,0,0,0,0,145,145,
133,133,0,0,0,0,0,0,0,
165,165,165,165,165,165,0,165,0,
153,153,153,153,153,153,0,153,0,
141,141,141,141,141,0,141,141,0,
128,128,128,128,0,128,128,0,128,
0,0,0,0,160,160,0,160,160,
0,148,0,0,0,0,148,148,148,
0,0,136,136,136,136,136,136,136,
124,0,124,124,124,0,124,124,124,
154,0,154,154,154,0,154,0,0,
142,0,142,142,142,0,142,0,142,
131,0,0,0,131,0,131,0,131,
120,120,120,120,120,0,120,0,120,
0,0,0,0,0,0,119,0,119,
103,103,103,103,103,103,103,0,103,
0,0,107,107,107,0,0,0,0,
106,0,106,106,106,0,106,106,106,
95,95,95,95,95,95,0,0,0,
94,94,94,0,0,0,0,0,0,
0,0,0,0,93,93,93,93,93,
0,0,92,92,92,92,92,92,92,
91,0,0,91,91,91,91,91,91,
90,90,0,0,0,0,90,90,90,
0,0,0,0,0,0,0,0,0,
0,0,0,0,0,0,0,0,0,
0,0,0,0,0,0,0,0,0.