[layer]
type=Tile Layer 1
data=
1,4,0,1,21,0,0,1,0,
4,5,21,1,0,1,1,1,1,
0,21,0,6,0,1,1,1,1,
1,5,21,1,0,1,1,1,6,
6,1,0,1,0,0,0,21,0,
1,3,21,1,1,1,0,1,1,
0,21,0,2,2,0,0,1,0,
2,2,2,9,2,2,2,2,21,
0,1,2,21,2,0,0,0,0,
7,2,2,2,2,2,2,21,0,
5,4,0,21,1,1,1,0,1,
1,1,1,21,0,0,1,0,6,
2,2,1,5,3,0,1,21,0,
10,2,1,0,0,0,21,0,0,
2,2,1,21,2,2,2,1,1,
21,1,1,1,2,8,2,2,2,
0,2,2,2,21,2,2,2,9,
5,1,3,1,21,1,0,2,2,
7,2,2,21,2,2,2,0,2,
0,2,2,2,2,2,7,21,2,
1,1,6,21,1,1,4,0,1,
0,0,0,21,0,0,1,0,0,
1,3,1,1,1,21,5,1,1,
1,21,0,0,6,0,3,1,1,
0,0,0,0,0,0,0,0,0,
0,0,0,0,0,0,0,0,0,
0,0,0,0,0,0,0,0,0.
[layer]
type=Tile Layer 2
data=
138,138,0,138,0,0,0,138,0,
130,130,0,130,0,130,130,130,130,
0,0,0,135,0,135,135,135,135,
104,104,0,104,0,104,104,104,104,
100,100,0,100,0,0,0,0,0,
86,86,0,86,86,86,0,86,86,
0,0,0,113,113,0,0,113,0,
99,99,99,99,99,99,99,99,0,
0,95,95,0,95,0,0,0,0,
86,86,86,86,86,86,86,0,0,
107,107,0,0,107,107,107,0,107,
98,98,98,0,0,0,98,0,98,
90,90,90,90,90,0,90,0,0,
82,82,82,0,0,0,0,0,0,
73,73,73,0,73,73,73,73,73,
0,69,69,69,69,69,69,69,69,
0,72,72,72,0,72,72,72,72,
67,67,67,67,0,67,0,67,67,
63,63,63,0,63,63,63,0,63,
0,62,62,62,62,62,62,0,62,
58,58,58,0,58,58,58,0,58,
0,0,0,0,0,0,60,0,0,
54,54,54,54,54,0,54,54,54,
58,0,0,0,58,0,58,58,58,
0,0,0,0,0,0,0,0,0,
0,0,0,0,0,0,0,0,0,
0,0,0,0,0,0,0,0,0.