[layer]
type=Tile Layer 1
data=
1,1,1,1,1,21,1,1,1,
0,21,1,1,1,1,1,0,1,
1,1,1,1,1,21,1,1,1,
0,0,0,21,1,0,1,1,1,
1,1,1,21,1,1,1,1,1,
1,1,1,21,1,0,1,1,1,
1,1,1,21,1,0,1,1,1,
1,1,1,21,0,0,0,0,0,
1,1,1,21,1,1,1,0,1,
1,21,1,1,1,0,1,1,1,
1,21,0,1,1,0,0,0,0,
1,1,0,21,0,1,1,1,0,
1,0,21,1,0,1,1,1,1,
1,21,1,1,0,1,1,1,1,
1,0,21,0,0,0,0,1,1,
1,1,21,0,1,1,0,0,1,
1,1,1,0,21,0,0,0,1,
0,0,0,0,21,0,0,1,1,
1,21,1,0,1,1,1,0,1,
1,21,1,0,1,1,1,0,1,
1,21,1,1,1,1,1,0,1,
1,0,0,0,21,0,1,0,1,
1,1,1,1,1,21,1,1,1,
1,1,1,1,1,0,0,21,0,
1,1,1,1,1,21,1,1,1,
1,1,1,1,1,21,1,0,0,
1,1,1,1,1,21,1,0,1,
0,1,0,0,0,0,0,21,0,
1,1,21,1,0,1,1,1,1,
1,1,21,1,0,1,1,1,1,
1,1,21,1,1,1,1,1,1,
0,0,0,1,0,0,0,1,21,
1,1,21,1,1,1,1,1,1,
0,1,0,1,1,1,1,1,21,
1,1,21,1,1,1,1,1,0,
1,1,21,1,1,1,1,1,0,
1,1,1,0,0,21,0,0,0,
1,1,0,0,1,21,0,1,1,
1,1,21,1,1,1,0,1,1,
1,1,1,1,0,0,21,0,1,
1,0,0,1,1,0,0,21,0,
0,0,21,0,0,0,1,1,1,
0,1,1,21,1,1,1,1,1,
0,1,1,21,0,0,0,1,1,
0,0,21,0,0,0,0,1,1,
1,1,1,1,0,1,0,21,0,
1,1,1,1,21,1,0,1,0,
1,1,1,1,0,1,21,1,0,
1,1,1,1,21,1,1,1,1,
0,1,0,0,0,0,0,0,21,
21,1,1,1,1,1,1,1,1,
0,0,0,0,0,0,0,0,0,
0,0,0,0,0,0,0,0,0,
0,0,0,0,0,0,0,0,0.
[layer]
type=Tile Layer 2
data=
223,223,223,223,223,0,223,223,223,
0,0,233,233,233,233,233,0,233,
220,220,220,220,220,0,220,220,220,
0,0,0,0,174,0,174,174,174,
152,152,152,0,152,152,152,152,152,
199,199,199,0,199,0,199,199,199,
184,184,184,0,184,0,184,184,184,
169,169,169,0,0,0,0,0,0,
155,155,155,0,155,155,155,0,155,
193,0,193,193,193,0,193,193,193,
179,0,0,179,179,0,0,0,0,
165,165,0,0,0,165,165,165,0,
150,0,0,150,0,150,150,150,150,
188,0,188,188,0,188,188,188,188,
174,0,0,0,0,0,0,174,174,
160,160,0,0,160,160,0,0,160,
146,146,146,0,0,0,0,0,146,
0,0,0,0,0,0,0,182,182,
168,0,168,0,168,168,168,0,168,
155,0,155,0,155,155,155,0,155,
142,0,142,142,142,142,142,0,142,
177,0,0,0,0,0,177,0,177,
155,155,155,155,155,0,155,155,155,
150,150,150,150,150,0,0,0,0,
131,131,131,131,131,0,131,131,131,
171,171,171,171,171,0,171,0,0,
158,158,158,158,158,0,158,0,158,
0,145,0,0,0,0,0,0,0,
133,133,0,133,0,133,133,133,133,
165,165,0,165,0,165,165,165,165,
146,146,0,146,146,146,146,146,146,
0,0,0,141,0,0,0,141,0,
122,122,0,122,122,122,122,122,122,
0,160,0,160,160,160,160,160,0,
148,148,0,148,148,148,148,148,0,
136,136,0,136,136,136,136,136,0,
124,124,124,0,0,0,0,0,0,
154,154,0,0,154,0,0,154,154,
142,142,0,142,142,142,0,142,142,
131,131,131,131,0,0,0,0,131,
120,0,0,120,120,0,0,0,0,
0,0,0,0,0,0,119,119,119,
0,108,108,0,108,108,108,108,108,
0,107,107,0,0,0,0,107,107,
0,0,0,0,0,0,0,106,106,
95,95,95,95,0,95,0,0,0,
94,94,94,94,0,94,0,94,0,
93,93,93,93,0,93,0,93,0,
88,88,88,88,0,88,88,88,88,
0,91,0,0,0,0,0,0,0,
0,86,86,86,86,86,86,86,86,
0,0,0,0,0,0,0,0,0,
0,0,0,0,0,0,0,0,0,
0,0,0,0,0,0,0,0,0.