[layer]
type=Tile Layer 1
data=
1,5,1,21,1,5,1,1,1,
0,0,1,0,0,21,1,0,1,
1,6,1,21,1,1,4,0,1,
1,6,1,0,1,1,1,21,0,
1,6,4,21,1,1,1,0,1,
1,1,1,21,0,0,0,0,5,
1,1,4,21,1,1,1,6,1,
0,0,0,0,1,0,21,0,0,
1,3,6,0,1,21,1,0,1,
0,5,1,3,1,1,4,21,1,
0,0,0,0,0,5,1,21,0,
1,1,1,1,0,21,0,1,0,
1,1,1,0,1,1,0,21,0,
6,1,5,21,0,1,3,1,0,
1,1,6,1,21,0,1,1,0,
4,1,1,5,1,21,1,1,0,
1,1,1,3,1,21,1,0,0,
3,4,1,1,1,21,1,0,1,
1,1,6,5,4,21,1,6,5,
1,1,0,21,1,0,0,1,1,
1,21,1,1,1,1,1,1,1,
1,0,1,0,0,0,21,0,0,
6,0,1,21,5,1,1,0,1,
1,0,3,21,1,6,1,0,1,
4,0,1,21,1,1,1,0,1,
0,0,1,21,3,1,5,0,1,
1,0,1,21,1,1,3,0,1,
0,21,1,1,1,1,1,1,0,
0,0,1,1,1,4,1,4,21,
0,21,5,3,1,1,1,1,0,
0,21,5,1,6,1,1,1,1,
3,21,0,0,0,0,0,0,0,
6,1,1,21,1,1,1,1,0,
0,0,0,0,0,0,0,0,0,
0,0,0,0,0,0,0,0,0,
0,0,0,0,0,0,0,0,0.
[layer]
type=Tile Layer 2
data=
162,162,162,0,162,162,162,162,162,
0,0,169,0,0,0,169,0,169,
167,167,167,0,167,167,167,0,167,
146,146,146,0,146,146,146,0,0,
134,134,134,0,134,134,134,0,134,
123,123,123,0,0,0,0,0,123,
107,107,107,0,107,107,107,107,107,
0,0,0,0,140,0,0,0,0,
129,129,129,0,129,0,129,0,129,
0,118,118,118,118,118,118,0,118,
0,0,0,0,0,108,108,0,0,
134,134,134,134,0,0,0,134,0,
124,124,124,0,124,124,0,0,0,
114,114,114,0,0,114,114,114,0,
103,103,103,103,0,0,103,103,0,
129,129,129,129,129,0,129,129,0,
119,119,119,119,119,0,119,0,0,
109,109,109,109,109,0,109,0,109,
94,94,94,94,94,0,94,94,94,
123,123,0,0,123,0,0,123,123,
108,0,108,108,108,108,108,108,108,
104,0,104,0,0,0,0,0,0,
95,0,95,0,95,95,95,0,95,
94,0,94,0,94,94,94,0,94,
85,0,85,0,85,85,85,0,85,
0,0,84,0,84,84,84,0,84,
83,0,83,0,83,83,83,0,83,
0,0,74,74,74,74,74,74,0,
0,0,73,73,73,73,73,73,0,
0,0,72,72,72,72,72,72,0,
0,0,71,71,71,71,71,71,71,
70,0,0,0,0,0,0,0,0,
69,69,69,0,69,69,69,69,0,
0,0,0,0,0,0,0,0,0,
0,0,0,0,0,0,0,0,0,
0,0,0,0,0,0,0,0,0.