[layer]
type=Tile Layer 1
data=
3,6,6,3,21,5,5,1,5,
0,21,0,3,0,6,0,0,0,
5,5,21,1,6,3,1,1,6,
0,0,0,3,4,21,1,4,1,
4,5,5,1,3,21,0,3,5,
3,4,3,5,1,21,5,0,1,
6,6,5,1,4,0,21,0,0,
6,4,5,1,0,21,5,4,0,
1,4,21,0,0,1,0,0,0,
0,0,1,6,6,1,21,4,4,
0,0,3,6,1,4,21,3,1,
3,6,0,21,0,1,0,0,4,
0,1,5,1,0,3,21,6,1,
0,3,21,1,1,3,1,0,0,
1,6,5,5,21,1,6,6,5,
0,0,21,1,0,6,1,3,0,
1,6,4,4,4,1,1,1,21,
0,3,3,6,1,4,21,3,0,
0,1,6,1,5,1,21,6,0,
0,4,4,5,4,1,0,6,21,
0,5,4,1,6,5,21,5,4,
1,21,0,3,3,6,3,1,3,
4,6,21,4,6,1,4,4,1,
6,21,0,1,6,4,1,3,3,
1,0,21,0,0,0,0,0,0,
5,6,3,3,5,3,5,1,21,
1,6,0,0,0,0,0,21,0,
0,0,0,0,0,0,0,0,0,
0,0,0,0,0,0,0,0,0,
0,0,0,0,0,0,0,0,0.
[layer]
type=Tile Layer 2
data=
152,152,152,152,0,152,152,152,152,
0,0,0,158,0,158,0,0,0,
149,149,0,149,149,149,149,149,149,
0,0,0,117,117,0,117,117,117,
107,107,107,107,107,0,0,107,107,
133,133,133,133,133,0,133,0,133,
123,123,123,123,123,0,0,0,0,
113,113,113,113,0,0,113,113,0,
102,102,0,0,0,102,0,0,0,
0,0,128,128,128,128,0,128,128,
0,0,118,118,118,118,0,118,118,
108,108,0,0,0,5,0,0,108,
0,98,98,78,0,78,0,98,98,
0,122,0,6,6,98,6,0,0,
5,90,90,90,0,90,90,90,90,
0,0,0,103,0,103,5,103,0,
4,75,75,75,94,75,4,75,0,
0,93,93,93,93,93,0,93,0,
0,84,84,84,84,84,0,84,0,
0,83,83,83,83,83,0,83,0,
0,82,82,82,82,82,0,82,82,
73,0,0,73,73,73,73,73,73,
69,69,0,69,69,69,69,69,69,
71,0,0,71,71,71,71,71,71,
70,0,0,0,0,0,0,0,0,
66,66,66,66,66,66,66,66,0,
68,68,0,0,0,0,0,0,0,
0,0,0,0,0,0,0,0,0,
0,0,0,0,0,0,0,0,0,
0,0,0,0,0,0,0,0,0.