[layer]
type=Tile Layer 1
data=
2,9,2,2,2,2,21,2,0,
4,2,0,0,1,1,21,0,3,
0,19,21,1,1,1,1,1,1,
1,2,0,1,1,1,0,21,0,
1,5,21,2,2,2,1,4,1,
7,2,2,2,19,2,2,21,0,
0,1,1,2,0,2,10,2,21,
0,5,1,4,0,2,2,2,21,
0,2,0,21,0,1,2,2,0,
1,19,21,1,1,5,2,10,1,
0,2,0,1,0,6,21,0,0,
0,1,0,1,21,2,2,2,0,
0,2,0,2,0,2,20,21,0,
0,1,21,1,0,2,2,2,0,
0,4,0,0,21,1,6,1,0,
1,2,21,19,0,2,2,5,1,
2,8,2,0,21,20,2,2,2,
1,2,0,0,2,0,21,0,0,
1,1,21,3,2,2,2,1,0,
0,21,2,2,2,9,2,2,2,
0,2,2,2,2,20,21,2,10,
0,0,0,0,0,0,0,0,0,
0,0,0,0,0,0,0,0,0,
0,0,0,0,0,0,0,0,0.
[layer]
type=Tile Layer 2
data=
133,133,133,133,133,133,0,133,0,
132,132,0,0,132,132,0,0,132,
0,0,0,130,130,130,130,130,130,
113,113,0,113,113,113,0,0,0,
94,94,0,94,94,94,94,94,94,
95,95,95,95,0,95,95,0,0,
0,86,86,86,0,86,86,86,0,
0,107,107,107,0,107,107,107,0,
0,98,0,0,0,98,98,98,0,
90,0,0,90,90,90,90,90,90,
0,82,0,82,0,82,0,0,0,
0,81,0,81,0,81,81,81,0,
0,73,0,73,0,73,0,0,0,
0,72,0,72,0,72,72,72,0,
0,71,0,0,0,71,71,71,0,
63,63,0,0,0,63,63,63,63,
62,62,62,0,0,0,62,62,62,
61,61,0,0,61,0,0,0,0,
57,57,0,57,57,57,57,57,0,
0,0,59,59,59,59,59,59,59,
0,58,58,58,58,0,0,58,58,
0,0,0,0,0,0,0,0,0,
0,0,0,0,0,0,0,0,0,
0,0,0,0,0,0,0,0,0.