[layer]
type=Tile Layer 1
data=
20,1,1,1,1,1,1,1,20,
1,20,0,1,1,1,0,20,1,
1,1,20,0,1,0,20,1,1,
1,1,1,20,1,20,1,1,1,
1,1,1,1,1,1,1,1,1,
0,0,0,0,2,0,0,0,0,
0,0,0,0,19,0,0,0,0,
0,0,0,0,0,0,0,0,0,
0,0,0,0,0,0,0,0,0.
[layer]
type=Tile Layer 2
data=
0,35,35,35,35,35,35,35,0,
37,0,0,37,37,37,0,0,37,
37,37,0,0,37,0,0,37,37,
35,35,35,0,35,0,35,35,35,
31,31,31,31,31,31,31,31,31,
0,0,0,0,37,0,0,0,0,
0,0,0,0,0,0,0,0,0,
0,0,0,0,0,0,0,0,0,
0,0,0,0,0,0,0,0,0.