[layer]
type=Tile Layer 1
data=
3,1,0,0,0,21,4,1,0,
1,1,21,1,1,1,1,1,0,
6,1,0,1,1,21,0,4,0,
1,1,0,1,0,1,6,21,0,
1,1,1,6,21,1,4,0,0,
1,5,0,21,0,0,1,1,0,
1,21,1,1,1,1,5,5,1,
0,0,21,0,0,0,0,1,0,
0,1,1,1,21,3,1,4,1,
0,4,1,1,0,0,0,0,21,
21,1,1,1,1,3,5,1,1,
0,1,1,3,0,21,0,0,0,
0,1,3,1,21,1,1,6,1,
0,0,0,1,0,3,0,0,21,
1,1,1,1,21,1,1,4,1,
1,0,21,0,0,0,1,5,1,
1,21,3,0,1,1,1,1,1,
1,0,1,6,1,5,21,0,0,
0,1,1,1,0,21,0,1,5,
0,0,0,21,0,1,5,1,4,
1,6,0,0,21,0,1,1,1,
0,0,0,0,0,0,0,0,0,
0,0,0,0,0,0,0,0,0,
0,0,0,0,0,0,0,0,0.
[layer]
type=Tile Layer 2
data=
133,133,0,0,0,0,133,133,0,
125,125,0,125,125,125,125,125,0,
130,130,0,130,130,0,0,130,0,
113,113,0,113,0,113,113,0,0,
104,104,104,104,0,104,104,0,0,
95,95,0,0,0,0,95,95,0,
78,0,78,78,78,78,78,78,78,
0,0,0,0,0,0,0,107,0,
0,94,94,94,0,94,94,94,94,
0,90,90,90,0,0,0,0,0,
0,74,74,74,74,74,74,74,74,
0,81,81,81,0,0,0,0,0,
0,69,69,69,0,69,69,69,69,
0,0,0,72,0,72,0,0,0,
64,64,64,64,0,64,64,64,64,
63,0,0,0,0,0,63,63,63,
59,0,59,0,59,59,59,59,59,
61,0,61,61,61,61,0,0,0,
0,60,60,60,0,0,0,60,60,
0,0,0,0,0,59,59,59,59,
58,58,0,0,0,0,58,58,58,
0,0,0,0,0,0,0,0,0,
0,0,0,0,0,0,0,0,0,
0,0,0,0,0,0,0,0,0.