[layer]
type=Tile Layer 1
data=
1,5,21,1,0,1,1,6,0,
0,2,21,2,0,2,2,2,20,
0,10,21,2,0,2,2,2,18,
1,2,2,4,1,2,2,21,1,
0,21,2,2,2,2,9,2,2,
5,1,1,1,2,2,2,21,1,
1,0,0,0,2,19,2,21,0,
4,1,1,21,2,0,2,3,1,
2,0,21,18,2,0,2,2,2,
7,21,2,2,2,0,2,2,2,
0,21,1,0,0,0,0,19,0,
1,21,6,1,5,0,2,2,1,
2,2,0,21,6,0,1,0,0,
8,2,1,21,1,0,1,0,1,
2,0,2,2,1,0,21,0,4,
1,21,10,2,1,5,1,6,1,
1,21,2,2,1,0,0,0,5,
1,21,1,0,1,0,1,3,1,
0,0,1,0,0,21,2,0,0,
2,2,2,21,2,2,2,20,2,
0,21,9,2,2,2,2,2,2,
1,2,2,2,10,0,0,21,0,
2,2,2,2,2,21,2,2,20,
6,1,2,2,21,0,1,2,0,
0,0,21,19,0,1,0,1,0,
0,3,2,2,2,1,0,0,21,
0,21,2,2,2,2,2,2,18,
6,21,0,3,1,1,4,1,0,
1,1,21,1,3,1,1,0,0,
1,1,21,1,1,1,1,0,4,
0,21,5,1,1,1,0,6,0,
2,2,2,2,2,7,2,21,0,
10,0,0,21,0,0,0,1,1,
2,2,1,1,1,21,5,0,0,
2,7,2,2,2,21,2,2,20,
2,2,2,0,21,2,2,2,18,
0,0,0,0,0,0,0,0,0,
0,0,0,0,0,0,0,0,0,
0,0,0,0,0,0,0,0,0.
[layer]
type=Tile Layer 2
data=
192,192,0,192,0,192,192,192,0,
0,191,0,191,0,191,191,191,0,
0,189,0,189,0,189,189,189,0,
146,146,146,146,146,146,146,0,146,
0,0,141,141,141,141,141,141,141,
122,122,122,122,122,122,122,0,122,
161,0,0,0,161,0,161,0,0,
148,148,148,0,148,0,148,148,148,
136,0,0,0,136,0,136,136,136,
124,0,124,124,124,0,124,124,124,
0,0,155,0,0,0,0,0,0,
143,0,143,143,143,0,143,143,143,
131,131,0,0,131,0,131,0,0,
120,120,120,0,120,0,120,0,120,
149,0,149,149,149,0,0,0,149,
138,0,138,138,138,138,138,138,138,
127,0,127,127,127,0,0,0,127,
115,0,115,0,115,0,115,115,115,
0,0,144,0,0,0,144,0,0,
133,133,133,0,133,133,133,0,133,
0,0,122,122,122,122,122,122,122,
111,111,111,111,111,0,0,0,0,
138,138,138,138,138,0,138,138,0,
127,127,127,127,0,0,127,127,0,
0,0,0,0,0,117,0,117,0,
0,107,107,107,107,107,0,0,0,
0,0,106,106,106,106,106,106,0,
96,0,0,96,96,96,96,96,0,
95,95,0,95,95,95,95,0,0,
94,94,0,94,94,94,94,0,94,
0,0,84,84,84,84,0,84,0,
83,83,83,83,83,83,83,0,0,
82,0,0,0,0,0,0,82,82,
81,81,81,81,81,0,81,0,0,
80,80,80,80,80,0,80,80,0,
79,79,79,0,0,79,79,79,0,
0,0,0,0,0,0,0,0,0,
0,0,0,0,0,0,0,0,0,
0,0,0,0,0,0,0,0,0.