[layer]
type=Tile Layer 1
data=
2,2,2,2,9,2,2,2,21,
1,8,2,2,2,0,0,21,0,
1,2,2,21,1,1,1,1,1,
0,0,0,21,1,1,1,1,1,
1,1,1,21,1,1,1,2,2,
2,2,2,2,21,2,2,0,9,
1,21,1,1,1,0,1,2,2,
0,0,21,0,1,0,1,0,1,
1,1,1,1,1,21,1,0,1,
1,0,1,1,1,0,21,0,1,
1,21,1,1,1,0,1,1,1,
0,0,1,1,1,0,21,0,0,
0,1,1,1,1,1,1,1,21,
0,0,0,21,1,1,1,1,0,
1,1,1,0,0,0,21,0,0,
1,1,1,1,1,1,1,1,21,
1,1,1,1,1,21,1,1,0,
2,2,2,7,2,21,2,0,2,
0,0,1,0,1,1,1,21,0,
0,1,1,1,1,1,21,1,1,
0,1,1,1,1,1,0,1,21,
0,1,1,1,1,1,21,1,0,
0,0,0,1,0,0,21,0,0,
1,1,1,1,1,2,2,2,21,
0,0,0,0,21,2,10,2,0,
1,1,21,1,1,2,2,2,0,
0,2,2,2,21,2,9,2,2,
0,1,1,1,0,21,2,2,1,
2,21,0,2,2,2,9,2,2,
0,2,21,2,7,2,2,2,2,
0,8,21,0,0,0,0,1,1,
21,2,2,1,1,2,2,2,1,
0,1,1,0,21,2,10,2,1,
0,0,0,0,0,0,0,0,0,
0,0,0,0,0,0,0,0,0,
0,0,0,0,0,0,0,0,0.
[layer]
type=Tile Layer 2
data=
170,170,170,170,170,170,170,170,0,
169,169,169,169,169,0,0,0,0,
159,159,159,0,159,159,159,159,159,
0,0,0,0,146,146,146,146,146,
128,128,128,0,128,128,128,128,128,
123,123,123,123,0,123,123,0,123,
112,0,112,112,112,0,112,112,112,
0,0,0,0,140,0,140,0,140,
129,129,129,129,129,0,129,0,129,
118,0,118,118,118,0,0,0,118,
108,0,108,108,108,0,108,108,108,
0,0,134,134,134,0,0,0,0,
0,124,124,124,124,124,124,124,0,
0,0,0,0,114,114,114,114,0,
103,103,103,0,0,0,0,0,0,
123,123,123,123,123,123,123,123,0,
119,119,119,119,119,0,119,119,0,
109,109,109,109,109,0,109,0,109,
0,0,99,0,99,99,99,0,0,
0,123,123,123,123,123,0,123,123,
0,113,113,113,113,113,0,113,0,
0,104,104,104,104,104,0,104,0,
0,0,0,95,0,0,0,0,0,
89,89,89,89,89,89,89,89,0,
0,0,0,0,0,85,85,85,0,
84,84,0,84,84,84,84,84,0,
0,83,83,83,0,83,83,83,83,
0,74,74,74,0,0,74,74,74,
73,0,0,73,73,73,73,73,73,
0,72,0,72,72,72,72,72,72,
0,71,0,0,0,0,0,71,71,
0,67,67,67,67,67,67,67,67,
0,69,69,0,0,69,69,69,69,
0,0,0,0,0,0,0,0,0,
0,0,0,0,0,0,0,0,0,
0,0,0,0,0,0,0,0,0.