[layer]
type=Tile Layer 1
data=
1,1,1,0,1,21,1,1,1,
1,1,0,21,4,1,1,1,1,
0,0,0,21,5,1,0,0,0,
3,5,6,21,0,5,1,1,1,
0,0,0,4,3,0,0,0,21,
1,3,5,1,1,1,3,21,1,
0,0,0,0,0,0,0,0,0,
0,0,0,0,0,0,0,0,0,
0,0,0,0,0,0,0,0,0.
[layer]
type=Tile Layer 2
data=
36,36,36,0,36,0,36,36,36,
35,35,0,0,35,35,35,35,35,
0,0,0,0,38,38,0,0,0,
34,34,34,0,0,34,34,34,34,
0,0,0,37,37,0,0,0,0,
31,31,31,31,31,31,31,0,31,
0,0,0,0,0,0,0,0,0,
0,0,0,0,0,0,0,0,0,
0,0,0,0,0,0,0,0,0.