[layer]
type=Tile Layer 1
data=
0,1,0,1,1,1,21,1,0,
0,0,0,1,21,1,0,1,0,
2,2,0,1,0,1,21,1,0,
10,2,0,1,0,1,21,1,0,
2,2,1,1,21,1,0,1,1,
1,1,0,1,0,0,21,0,0,
1,1,21,1,0,1,1,1,1,
0,2,21,2,2,2,2,7,2,
0,1,1,1,21,1,1,1,1,
0,0,1,0,0,21,0,0,1,
0,0,1,1,1,21,0,0,1,
2,21,1,1,1,0,1,1,1,
8,21,1,1,1,0,1,1,1,
7,21,2,2,2,0,2,2,2,
1,2,2,2,21,1,0,1,1,
1,2,8,2,21,1,0,1,1,
1,2,2,2,21,0,0,0,1,
1,1,2,2,2,1,0,21,0,
0,2,2,9,2,2,2,2,21,
0,21,2,2,0,1,0,2,2,
0,1,1,1,21,1,0,2,10,
0,0,0,1,21,0,0,2,0,
0,0,21,0,0,0,0,0,1,
1,1,1,1,1,1,1,21,1,
0,0,0,0,0,0,0,0,0,
0,0,0,0,0,0,0,0,0,
0,0,0,0,0,0,0,0,0.
[layer]
type=Tile Layer 2
data=
0,139,0,139,139,139,0,139,0,
0,0,0,137,0,137,0,137,0,
136,136,0,136,0,136,0,136,0,
110,110,0,110,0,110,0,110,0,
96,96,96,96,0,96,0,96,96,
91,91,0,91,0,0,0,0,0,
108,108,0,108,0,108,108,108,108,
0,105,0,105,105,105,105,105,105,
0,91,91,91,0,91,91,91,91,
0,0,87,0,0,0,0,0,87,
0,0,108,108,108,0,0,0,108,
95,0,95,95,95,0,95,95,95,
91,0,91,91,91,0,91,91,91,
83,0,83,83,83,0,83,83,83,
78,78,78,78,0,78,0,78,78,
74,74,74,74,0,74,0,74,74,
73,73,73,73,0,0,0,0,73,
72,72,72,72,72,72,0,0,0,
0,64,64,64,64,64,64,64,0,
0,0,63,63,0,63,0,63,63,
0,62,62,62,0,62,0,62,62,
0,0,0,61,0,0,0,61,0,
0,0,0,0,0,0,0,0,60,
54,54,54,54,54,54,54,0,54,
0,0,0,0,0,0,0,0,0,
0,0,0,0,0,0,0,0,0,
0,0,0,0,0,0,0,0,0.