[layer]
type=Tile Layer 1
data=
1,1,1,1,1,0,21,1,0,
1,1,1,1,1,1,0,21,0,
0,1,1,1,1,1,21,1,1,
0,0,0,21,1,1,0,0,0,
1,1,1,0,0,1,1,21,0,
1,1,1,0,21,1,1,0,1,
1,1,1,21,1,1,1,1,1,
0,0,0,21,1,1,1,1,1,
1,1,1,21,1,1,1,1,1,
1,1,1,0,0,0,0,21,0,
1,1,1,21,1,1,1,1,1,
0,0,21,0,1,0,0,0,1,
1,1,1,1,1,1,1,21,1,
1,0,21,0,0,0,1,0,0,
1,1,1,1,1,21,1,0,1,
1,0,1,0,1,21,1,0,1,
1,0,0,21,1,0,1,0,1,
1,1,1,1,1,21,1,0,1,
0,0,0,0,1,21,1,0,0,
1,1,1,1,1,21,1,0,1,
1,0,0,21,1,0,1,0,0,
1,0,1,21,1,0,1,1,1,
1,21,1,0,0,0,1,0,1,
1,21,1,1,1,1,1,0,1,
0,1,1,1,1,1,0,0,21,
21,1,1,1,1,1,1,1,1,
0,1,21,0,0,1,0,1,1,
0,1,21,1,1,1,0,1,1,
0,1,21,1,0,0,0,0,0,
1,1,21,1,1,1,1,1,1,
0,0,0,0,0,0,0,0,0,
0,0,0,0,0,0,0,0,0,
0,0,0,0,0,0,0,0,0.
[layer]
type=Tile Layer 2
data=
166,166,166,166,166,0,0,166,0,
164,164,164,164,164,164,0,0,0,
0,162,162,162,162,162,0,162,162,
0,0,0,0,112,112,0,0,0,
140,140,140,0,0,140,140,0,0,
129,129,129,0,0,129,129,0,129,
113,113,113,0,113,113,113,113,113,
0,0,0,0,108,108,108,108,108,
128,128,128,0,128,128,128,128,128,
124,124,124,0,0,0,0,0,0,
108,108,108,0,108,108,108,108,108,
0,0,0,0,103,0,0,0,103,
123,123,123,123,123,123,123,0,123,
119,0,0,0,0,0,119,0,0,
109,109,109,109,109,0,109,0,109,
99,0,99,0,99,0,99,0,99,
123,0,0,0,123,0,123,0,123,
113,113,113,113,113,0,113,0,113,
0,0,0,0,104,0,104,0,0,
95,95,95,95,95,0,95,0,95,
94,0,0,0,94,0,94,0,0,
85,0,85,0,85,0,85,85,85,
84,0,84,0,0,0,84,0,84,
83,0,83,83,83,83,83,0,83,
0,74,74,74,74,74,0,0,0,
0,70,70,70,70,70,70,70,70,
0,72,0,0,0,72,0,72,72,
0,71,0,71,71,71,0,71,71,
0,70,0,70,0,0,0,0,0,
66,66,0,66,66,66,66,66,66,
0,0,0,0,0,0,0,0,0,
0,0,0,0,0,0,0,0,0,
0,0,0,0,0,0,0,0,0.