[layer]
type=Tile Layer 1
data=
1,1,1,1,1,21,1,1,1,
1,1,1,1,1,0,1,21,0,
1,1,1,1,1,21,1,1,1,
2,0,21,0,18,0,0,0,0,
1,21,1,1,1,1,1,1,1,
1,21,1,1,1,0,0,0,1,
0,2,21,18,2,2,2,2,2,
0,21,2,19,0,1,1,1,1,
1,21,0,2,0,0,1,1,1,
1,1,0,1,1,21,0,1,1,
1,1,0,1,1,1,21,0,1,
0,0,0,1,1,1,1,21,0,
0,1,1,1,1,1,1,1,21,
1,1,1,1,1,1,21,1,0,
1,1,1,0,0,0,21,1,0,
2,21,2,2,2,2,2,18,2,
2,0,0,21,0,20,0,0,2,
1,1,1,1,2,2,21,1,1,
1,1,1,1,1,1,21,1,1,
0,0,21,1,0,1,0,1,0,
1,1,1,1,21,1,1,1,0,
1,1,1,1,21,1,0,0,0,
2,2,2,2,21,2,2,2,18,
1,0,0,0,0,0,21,0,1,
0,21,1,1,1,1,0,0,0,
0,1,1,1,1,1,21,1,1,
0,1,1,1,1,1,21,1,1,
1,1,1,1,0,21,0,0,1,
2,2,2,21,18,2,2,0,0,
0,0,0,21,1,1,1,1,0,
0,0,0,0,0,0,0,0,0,
0,0,0,0,0,0,0,0,0,
0,0,0,0,0,0,0,0,0.
[layer]
type=Tile Layer 2
data=
158,158,158,158,158,0,158,158,158,
164,164,164,164,164,0,164,0,0,
154,154,154,154,154,0,154,154,154,
112,0,0,0,0,0,0,0,0,
133,0,133,133,133,133,133,133,133,
129,0,129,129,129,0,0,0,129,
0,118,0,0,118,118,118,118,118,
0,0,108,0,0,108,108,108,108,
134,0,0,134,0,0,134,134,134,
124,124,0,124,124,0,0,124,124,
114,114,0,114,114,114,0,0,114,
0,0,0,103,103,103,103,0,0,
0,129,129,129,129,129,129,129,0,
119,119,119,119,119,119,0,119,0,
109,109,109,0,0,0,0,109,0,
99,0,99,99,99,99,99,0,99,
123,0,0,0,0,0,0,0,123,
108,108,108,108,108,108,0,108,108,
99,99,99,99,99,99,0,99,99,
0,0,0,95,0,95,0,95,0,
94,94,94,94,0,94,94,94,0,
85,85,85,85,0,85,0,0,0,
84,84,84,84,0,84,84,84,0,
83,0,0,0,0,0,0,0,83,
0,0,74,74,74,74,0,0,0,
0,73,73,73,73,73,0,73,73,
0,72,72,72,72,72,0,72,72,
71,71,71,71,0,0,0,0,71,
70,70,70,0,0,70,70,0,0,
0,0,0,0,69,69,69,69,0,
0,0,0,0,0,0,0,0,0,
0,0,0,0,0,0,0,0,0,
0,0,0,0,0,0,0,0,0.