[layer]
type=Tile Layer 1
data=
5,4,1,1,1,1,1,21,1,
0,0,1,21,5,0,0,0,1,
1,1,1,21,1,0,1,6,1,
1,3,1,0,3,0,1,21,0,
1,1,1,21,6,0,1,1,1,
4,1,1,21,1,0,0,0,1,
0,1,0,0,0,21,0,0,0,
1,1,21,1,1,3,1,1,0,
0,1,21,1,1,5,4,5,0,
1,1,1,1,1,1,1,4,21,
0,0,0,0,0,0,21,6,0,
6,1,21,1,0,1,3,1,0,
1,1,21,1,0,4,6,1,0,
5,1,1,1,1,1,1,1,21,
5,1,0,21,0,0,0,1,0,
0,0,1,0,3,0,21,0,0,
1,0,1,21,1,0,1,4,1,
1,21,5,0,0,0,1,0,0,
1,21,1,1,1,4,1,0,4,
3,0,1,0,0,0,21,0,1,
1,21,1,5,1,1,1,0,1,
4,0,0,0,0,21,1,0,1,
1,1,1,1,5,21,1,0,1,
1,0,21,0,3,0,0,0,1,
5,1,1,21,1,1,1,1,0,
6,1,1,21,0,0,6,0,0,
1,1,1,4,1,21,1,0,1,
4,4,1,21,0,0,0,0,5,
6,1,0,0,1,21,0,1,1,
1,1,21,1,1,0,1,1,1,
6,1,21,1,1,1,0,0,5,
4,6,0,21,0,0,1,1,0,
1,1,1,1,1,1,21,0,0,
3,0,21,1,5,1,1,0,1,
3,0,0,1,4,1,1,21,0,
1,1,1,1,1,1,1,21,0,
4,3,1,1,1,1,1,21,0,
1,1,6,0,21,0,0,0,0,
1,1,1,21,6,1,0,1,0,
0,0,0,0,0,0,0,0,0,
0,0,0,0,0,0,0,0,0,
0,0,0,0,0,0,0,0,0.
[layer]
type=Tile Layer 2
data=
187,187,187,187,187,187,187,0,187,
0,0,195,0,195,0,0,0,195,
194,194,194,0,194,0,194,194,194,
146,146,146,0,146,0,146,0,0,
133,133,133,0,133,0,133,133,133,
166,166,166,0,166,0,0,0,166,
0,153,0,0,0,0,0,0,0,
141,141,0,141,141,141,141,141,0,
0,129,0,129,129,129,129,129,0,
153,153,153,153,153,153,153,153,0,
0,0,0,0,0,0,0,148,0,
136,136,0,136,0,136,136,136,0,
124,124,0,124,0,124,124,124,0,
147,147,147,147,147,147,147,147,0,
143,143,0,0,0,0,0,143,0,
0,0,131,0,131,0,0,0,0,
120,0,120,0,120,0,120,120,120,
149,0,149,0,0,0,149,0,0,
138,0,138,138,138,138,138,0,138,
127,0,127,0,0,0,0,0,127,
115,0,115,115,115,115,115,0,115,
144,0,0,0,0,0,144,0,144,
133,133,133,133,133,0,133,0,133,
122,0,0,0,122,0,0,0,122,
111,111,111,0,111,111,111,111,0,
138,138,138,0,0,0,138,0,0,
127,127,127,127,127,0,127,0,127,
117,117,117,0,0,0,0,0,117,
107,107,0,0,107,0,0,107,107,
106,106,0,106,106,0,106,106,106,
96,96,0,96,96,96,0,0,96,
95,95,0,0,0,0,95,95,0,
94,94,94,94,94,94,0,0,0,
84,0,0,84,84,84,84,0,84,
83,0,0,83,83,83,83,0,0,
82,82,82,82,82,82,82,0,0,
81,81,81,81,81,81,81,0,0,
80,80,80,0,0,0,0,0,0,
79,79,79,0,79,79,0,79,0,
0,0,0,0,0,0,0,0,0,
0,0,0,0,0,0,0,0,0,
0,0,0,0,0,0,0,0,0.