[layer]
type=Tile Layer 1
data=
6,0,0,0,21,1,1,1,1,
2,2,2,0,0,21,2,2,18,
1,1,5,4,1,0,21,0,0,
1,0,1,1,21,1,6,4,1,
2,21,0,20,2,2,2,2,2,
1,3,0,1,21,1,0,6,3,
1,1,1,21,4,5,18,1,1,
1,1,1,21,4,1,1,1,1,
1,1,1,1,21,1,1,5,1,
0,0,0,0,0,0,0,0,0,
0,0,0,0,0,0,0,0,0,
0,0,0,0,0,0,0,0,0.
[layer]
type=Tile Layer 2
data=
67,0,0,0,0,67,67,67,67,
42,42,42,0,0,0,42,42,0,
42,42,42,42,42,0,0,0,0,
41,0,41,2,0,2,41,41,41,
40,0,0,0,32,32,40,40,40,
39,39,0,1,0,1,0,39,39,
31,31,31,0,31,31,0,31,1,
1,1,30,0,30,30,1,30,1,
1,1,30,1,0,1,1,30,1,
0,0,0,0,0,0,0,0,0,
0,0,0,0,0,0,0,0,0,
0,0,0,0,0,0,0,0,0.