[layer]
type=Tile Layer 1
data=
0,0,21,0,1,1,1,1,0,
0,3,5,1,3,1,1,1,21,
0,2,2,1,1,1,1,4,21,
0,20,2,2,2,2,2,0,21,
2,0,0,19,2,21,18,0,0,
2,2,2,0,21,18,2,2,2,
0,1,1,2,24,21,5,1,1,
1,0,21,6,1,0,6,1,1,
0,3,21,1,1,0,1,1,1,
0,1,21,0,0,0,0,1,1,
21,1,6,1,3,4,1,1,6,
0,1,1,21,0,1,1,1,1,
2,0,2,2,0,21,18,0,0,
2,2,2,21,2,2,2,18,0,
1,0,0,21,6,1,0,0,1,
1,0,1,0,0,21,1,0,0,
1,21,1,0,1,3,5,0,1,
1,0,1,0,6,0,21,0,1,
2,21,2,18,2,0,2,0,2,
0,21,1,0,1,0,1,0,1,
1,21,6,0,4,1,1,0,1,
1,0,1,21,1,0,0,0,1,
1,5,1,21,1,0,1,4,6,
0,0,18,0,2,0,0,21,0,
0,0,21,1,1,1,0,0,0,
1,1,21,5,4,1,1,3,1,
5,1,21,1,1,1,0,0,0,
1,1,21,1,4,5,1,1,1,
5,0,0,0,0,21,0,1,1,
1,1,4,1,3,1,21,1,1,
18,0,0,2,21,2,0,2,2,
1,1,1,1,21,4,1,5,3,
1,1,2,2,0,1,0,21,0,
0,0,2,24,21,0,3,0,1,
1,1,1,21,1,4,1,0,3,
1,1,1,21,1,1,5,0,1,
6,1,3,1,1,1,3,21,1,
1,4,1,0,21,0,0,0,1,
1,1,1,21,1,6,1,0,1,
0,0,0,0,0,0,0,0,0,
0,0,0,0,0,0,0,0,0,
0,0,0,0,0,0,0,0,0.
[layer]
type=Tile Layer 2
data=
0,0,0,0,198,198,198,198,0,
0,196,196,196,196,196,196,196,0,
0,195,195,195,195,195,195,195,0,
0,0,147,147,147,147,147,0,0,
134,0,0,0,134,0,0,0,0,
167,167,167,0,0,0,167,167,167,
0,154,154,154,0,0,154,154,154,
142,0,0,142,142,0,142,142,142,
0,130,0,130,130,0,130,130,130,
0,162,0,0,0,0,0,162,162,
0,142,142,142,142,142,142,142,142,
0,137,137,0,0,137,137,137,137,
125,0,125,125,0,0,0,0,0,
156,156,156,0,156,156,156,0,0,
144,0,0,0,144,144,0,0,144,
132,0,132,0,0,0,132,0,0,
121,0,121,0,121,121,121,0,121,
150,0,150,0,150,0,0,0,150,
139,0,139,0,139,0,139,0,139,
0,0,128,0,128,0,128,0,128,
116,0,116,0,116,116,116,0,116,
145,0,145,0,145,0,0,0,145,
134,134,134,0,134,0,134,134,134,
0,0,0,0,123,0,0,0,0,
0,0,0,112,112,112,0,0,0,
133,133,0,133,133,133,133,133,133,
128,128,0,128,128,128,0,0,0,
112,112,0,112,112,112,112,112,112,
108,0,0,0,0,0,0,108,108,
102,102,102,102,102,102,0,102,102,
0,0,0,97,0,97,0,97,97,
91,91,91,91,0,91,91,91,91,
95,95,95,95,0,95,0,0,0,
0,0,85,0,0,0,85,0,85,
84,84,84,0,84,84,84,0,84,
83,83,83,0,83,83,83,0,83,
78,78,78,78,78,78,78,0,78,
81,81,81,0,0,0,0,0,81,
80,80,80,0,80,80,80,0,80,
0,0,0,0,0,0,0,0,0,
0,0,0,0,0,0,0,0,0,
0,0,0,0,0,0,0,0,0.