[layer]
type=Tile Layer 1
data=
1,1,1,21,1,1,0,1,1,
1,1,1,0,0,1,0,21,0,
1,1,1,1,21,0,0,0,0,
0,21,0,0,0,0,1,1,1,
1,21,1,1,1,0,1,1,1,
1,0,1,21,0,0,1,1,1,
1,21,1,1,1,0,1,1,1,
1,0,1,1,1,0,21,0,1,
1,21,1,1,1,1,1,1,1,
0,0,21,0,0,0,1,0,0,
1,1,1,1,1,21,1,0,1,
1,1,1,1,1,21,1,0,1,
1,1,1,1,1,1,1,21,1,
0,0,1,0,0,0,1,21,1,
1,21,1,0,1,0,1,0,1,
0,0,1,21,1,0,0,0,1,
1,1,1,21,1,1,1,1,1,
1,0,21,0,0,0,1,0,1,
1,1,1,1,1,21,1,0,1,
0,0,0,0,1,21,1,0,0,
1,1,1,21,1,0,1,1,1,
1,1,1,1,1,1,21,1,1,
1,1,21,0,0,1,0,1,1,
1,1,21,1,1,1,0,1,1,
0,21,0,0,0,0,0,1,0,
1,1,1,1,21,1,1,1,0,
0,21,0,1,0,1,1,1,0,
0,0,0,0,0,0,0,0,0,
0,0,0,0,0,0,0,0,0,
0,0,0,0,0,0,0,0,0.
[layer]
type=Tile Layer 2
data=
160,160,160,0,160,160,0,160,160,
158,158,158,0,0,158,0,0,0,
157,157,157,157,0,0,0,0,0,
0,0,0,0,0,0,117,117,117,
107,0,107,107,107,0,107,107,107,
133,0,133,0,0,0,133,133,133,
123,0,123,123,123,0,123,123,123,
113,0,113,113,113,0,0,0,113,
98,0,98,98,98,98,98,98,98,
0,0,0,0,0,0,128,0,0,
118,118,118,118,118,0,118,0,118,
108,108,108,108,108,0,108,0,108,
93,93,93,93,93,93,93,0,93,
0,0,122,0,0,0,122,0,122,
112,0,112,0,112,0,112,0,112,
0,0,103,0,103,0,0,0,103,
89,89,89,0,89,89,89,89,89,
93,0,0,0,0,0,93,0,93,
84,84,84,84,84,0,84,0,84,
0,0,0,0,83,0,83,0,0,
82,82,82,0,82,0,82,82,82,
69,69,69,69,69,69,0,69,69,
72,72,0,0,0,72,0,72,72,
71,71,0,71,71,71,0,71,71,
0,0,0,0,0,0,0,70,0,
69,69,69,69,0,69,69,69,0,
0,0,0,68,0,68,68,68,0,
0,0,0,0,0,0,0,0,0,
0,0,0,0,0,0,0,0,0,
0,0,0,0,0,0,0,0,0.