[layer]
type=Tile Layer 1
data=
0,5,21,1,1,1,0,5,1,
0,3,1,1,1,1,21,4,1,
0,1,0,0,1,1,21,0,2,
1,1,1,0,0,21,0,2,10,
1,6,1,1,1,21,1,2,2,
2,2,21,0,0,3,0,2,8,
9,2,2,2,2,2,2,21,0,
0,2,7,2,21,2,2,2,2,
0,0,0,21,1,1,1,3,1,
0,0,0,21,0,1,1,1,6,
0,1,1,4,21,0,2,2,1,
0,2,2,2,2,21,2,9,2,
1,0,1,0,0,21,2,0,0,
4,21,1,6,1,0,1,1,1,
2,2,1,0,0,21,5,0,1,
10,21,1,1,1,1,1,0,1,
2,0,0,21,0,0,0,0,1,
5,1,6,21,6,1,4,0,1,
0,0,0,0,0,0,0,0,0,
0,0,0,0,0,0,0,0,0,
0,0,0,0,0,0,0,0,0.
[layer]
type=Tile Layer 2
data=
0,128,0,128,128,128,0,128,128,
0,121,121,121,121,121,0,121,121,
0,125,0,0,125,125,0,0,125,
86,86,86,0,0,0,0,86,86,
97,97,97,97,97,0,97,97,97,
98,98,0,0,0,98,0,98,98,
90,90,90,90,90,90,90,0,0,
0,82,82,82,0,82,82,82,82,
0,0,0,0,81,81,81,81,81,
0,0,0,0,0,73,73,73,73,
0,72,72,72,0,0,72,72,72,
0,71,71,71,71,0,71,71,71,
63,0,63,0,0,0,63,0,0,
59,0,59,59,59,0,59,59,59,
61,61,61,0,0,0,61,0,61,
60,0,60,60,60,60,60,0,60,
59,0,0,0,0,0,0,0,59,
56,56,56,0,56,56,56,0,56,
0,0,0,0,0,0,0,0,0,
0,0,0,0,0,0,0,0,0,
0,0,0,0,0,0,0,0,0.