[layer]
type=Tile Layer 1
data=
0,0,0,0,1,1,1,21,1,
1,1,1,21,1,1,1,1,1,
0,0,1,0,1,1,1,0,21,
1,1,1,21,1,1,1,0,1,
2,2,2,2,2,2,21,0,7,
1,1,1,1,1,1,1,21,1,
1,1,1,21,1,1,1,1,1,
2,2,1,21,1,1,1,1,1,
8,2,1,0,0,21,1,0,0,
2,2,1,21,1,0,1,0,1,
2,2,21,2,7,2,2,2,2,
2,21,2,2,2,2,9,2,2,
1,0,0,21,1,2,2,0,1,
1,2,2,21,1,1,1,0,1,
1,2,10,2,1,0,21,0,0,
0,2,2,0,0,0,0,21,1,
1,1,1,1,1,1,1,21,1,
0,0,1,0,0,0,0,21,1,
1,21,1,0,1,1,2,10,1,
1,0,1,0,1,21,2,2,1,
1,21,1,0,1,1,1,0,1,
1,0,1,0,21,0,1,0,1,
2,21,1,1,1,0,1,0,1,
8,0,0,21,1,0,1,0,1,
2,2,1,21,0,1,0,0,0,
1,1,1,1,0,21,0,2,1,
1,1,1,1,1,2,10,21,0,
1,1,1,1,21,2,2,2,1,
1,1,1,1,21,1,0,0,0,
2,7,2,21,2,2,2,2,0,
0,0,1,0,0,0,0,21,1,
0,0,0,21,1,1,1,1,1,
1,1,0,0,0,0,21,0,1,
1,1,2,2,2,1,21,0,0,
2,2,2,9,2,2,21,2,0,
7,2,2,2,2,2,21,2,0,
1,1,1,0,0,0,21,0,0,
0,0,21,0,2,2,2,1,0,
1,1,0,0,2,8,21,0,1,
0,0,0,0,0,0,0,0,0,
0,0,0,0,0,0,0,0,0,
0,0,0,0,0,0,0,0,0.
[layer]
type=Tile Layer 2
data=
0,0,0,0,198,198,198,0,198,
187,187,187,0,187,187,187,187,187,
0,0,195,0,195,195,195,0,0,
147,147,147,0,147,147,147,0,147,
134,134,134,134,134,134,0,0,134,
159,159,159,159,159,159,159,0,159,
147,147,147,0,147,147,147,147,147,
135,135,135,0,135,135,135,135,135,
130,130,130,0,0,0,130,0,0,
162,162,162,0,162,0,162,0,162,
149,149,0,149,149,149,149,149,149,
137,0,137,137,137,137,137,137,137,
125,0,0,0,125,125,125,0,125,
156,156,156,0,156,156,156,0,156,
144,144,144,144,144,0,0,0,0,
0,132,132,0,0,0,0,0,132,
115,115,115,115,115,115,115,0,115,
0,0,150,0,0,0,0,0,150,
139,0,139,0,139,139,139,139,139,
128,0,128,0,128,0,128,128,128,
116,0,116,0,116,116,116,0,116,
145,0,145,0,0,0,145,0,145,
134,0,134,134,134,0,134,0,134,
123,0,0,0,123,0,123,0,123,
112,112,112,0,0,112,0,0,0,
139,139,139,139,0,0,0,139,139,
128,128,128,128,128,128,128,0,0,
112,112,112,112,0,112,112,112,112,
108,108,108,108,0,108,0,0,0,
107,107,107,0,107,107,107,107,0,
0,0,97,0,0,0,0,0,97,
0,0,0,0,96,96,96,96,96,
95,95,0,0,0,0,0,0,95,
85,85,85,85,85,85,0,0,0,
84,84,84,84,84,84,0,84,0,
83,83,83,83,83,83,0,83,0,
82,82,82,0,0,0,0,0,0,
0,0,0,0,81,81,81,81,0,
80,80,0,0,80,80,0,0,80,
0,0,0,0,0,0,0,0,0,
0,0,0,0,0,0,0,0,0,
0,0,0,0,0,0,0,0,0.