[layer]
type=Tile Layer 1
data=
1,4,1,0,5,21,0,1,1,
6,1,1,21,6,1,0,0,0,
1,0,21,0,1,1,1,0,0,
0,0,1,4,0,21,0,0,1,
0,1,1,1,21,1,0,1,6,
0,21,0,0,0,0,0,5,1,
0,0,21,0,1,1,3,4,1,
0,1,1,21,1,1,1,1,3,
0,0,21,6,1,1,1,1,1,
1,21,1,1,1,1,5,0,1,
0,0,3,21,0,0,1,0,0,
1,1,1,21,1,0,6,1,5,
3,0,0,0,1,21,0,0,1,
1,21,6,1,1,1,1,1,1,
0,21,5,0,0,0,0,0,0,
0,0,0,0,0,0,0,0,0,
0,0,0,0,0,0,0,0,0,
0,0,0,0,0,0,0,0,0.
[layer]
type=Tile Layer 2
data=
123,123,123,0,123,0,0,123,123,
121,121,121,0,121,121,0,0,0,
119,0,0,0,119,119,119,0,0,
0,0,89,89,0,0,0,0,89,
0,81,81,81,0,81,0,81,81,
0,0,0,0,0,0,0,80,80,
0,0,0,0,72,72,72,72,72,
0,67,67,0,67,67,67,67,67,
0,0,0,70,70,70,70,70,70,
59,0,59,59,59,59,59,0,59,
0,0,61,0,0,0,61,0,0,
57,57,57,0,57,0,57,57,57,
59,0,0,0,59,0,0,0,59,
53,0,53,53,53,53,53,53,53,
0,0,57,0,0,0,0,0,0,
0,0,0,0,0,0,0,0,0,
0,0,0,0,0,0,0,0,0,
0,0,0,0,0,0,0,0,0.