[layer]
type=Tile Layer 1
data=
5,21,6,5,1,6,5,0,3,
5,21,0,0,0,0,3,0,0,
5,6,6,1,1,21,3,1,3,
0,0,21,0,3,1,4,4,6,
0,4,1,21,1,6,4,1,3,
0,1,3,4,1,21,3,6,6,
0,0,1,3,21,1,3,6,3,
0,1,4,4,21,4,1,6,4,
1,1,1,3,1,1,1,21,6,
0,4,5,4,3,3,1,21,4,
0,0,1,1,4,1,0,21,0,
3,21,0,5,1,5,3,5,0,
0,4,6,5,0,4,21,6,0,
0,1,1,4,0,1,0,5,21,
0,4,0,6,0,5,0,1,21,
6,4,1,5,21,1,0,6,0,
0,0,0,21,0,4,0,4,0,
5,6,6,4,1,5,5,1,21,
4,5,5,21,6,4,4,4,6,
0,0,1,0,1,21,4,1,1,
5,21,6,5,1,0,5,6,6,
4,4,0,1,4,0,21,0,0,
5,5,0,21,0,0,1,3,1,
1,3,0,5,4,21,3,0,0,
4,6,21,1,6,3,3,3,0,
4,1,21,4,3,3,6,1,0,
4,6,21,0,0,0,1,6,0,
0,0,0,0,0,0,0,0,0,
0,0,0,0,0,0,0,0,0,
0,0,0,0,0,0,0,0,0.
[layer]
type=Tile Layer 2
data=
137,0,137,137,137,137,137,0,137,
142,0,0,0,0,0,142,0,0,
127,127,127,127,127,0,127,127,127,
0,0,0,0,105,105,105,105,105,
0,96,96,0,4,96,96,96,96,
0,119,119,95,5,0,119,119,119,
0,0,88,88,0,5,88,110,110,
0,5,80,80,0,80,80,80,101,
4,73,73,73,4,4,4,0,73,
0,91,91,91,91,91,5,0,114,
0,0,105,105,105,105,0,0,0,
96,0,0,96,96,96,96,96,0,
0,87,87,87,0,87,0,87,0,
0,108,108,108,0,108,0,108,0,
0,99,0,99,0,99,0,99,0,
91,91,91,91,0,91,0,91,0,
0,0,0,0,0,83,0,83,0,
74,74,74,74,74,74,74,74,0,
67,67,67,0,67,67,67,67,67,
0,0,73,0,73,0,73,73,73,
68,0,68,68,68,0,68,68,68,
64,64,0,64,64,0,0,0,0,
63,63,0,0,0,0,63,63,63,
62,62,0,62,62,0,62,0,0,
58,58,0,58,58,58,58,58,0,
58,58,0,58,58,58,58,58,0,
59,59,0,0,0,0,59,59,0,
0,0,0,0,0,0,0,0,0,
0,0,0,0,0,0,0,0,0,
0,0,0,0,0,0,0,0,0.