[layer]
type=Tile Layer 1
data=
1,1,1,0,1,21,1,0,0,
1,1,1,21,1,0,1,1,1,
0,0,1,21,1,0,0,0,0,
1,1,1,21,1,1,1,1,1,
1,0,0,0,1,0,21,0,0,
1,21,1,1,1,1,1,1,1,
1,21,1,0,1,1,1,1,1,
1,21,1,1,1,1,1,1,1,
1,21,1,0,0,0,0,0,0,
1,1,1,1,1,1,1,21,0,
1,1,1,1,1,1,0,21,0,
1,1,1,1,1,0,21,1,0,
1,1,1,1,1,21,1,1,0,
1,1,1,1,0,21,0,1,0,
0,0,0,0,0,1,1,21,0,
0,21,1,1,1,1,1,0,0,
1,21,0,0,0,1,1,0,0,
1,1,1,1,21,1,1,0,1,
0,21,1,0,1,0,1,1,1,
1,1,1,21,1,0,1,1,1,
1,0,0,21,0,0,0,0,1,
1,1,1,1,1,1,1,21,1,
0,0,0,0,21,0,1,0,1,
1,1,1,1,1,21,1,0,1,
1,1,1,1,1,21,1,0,0,
1,1,1,1,1,21,1,0,1,
1,1,1,1,1,21,1,0,1,
1,1,1,21,0,1,1,1,1,
1,1,1,21,0,1,1,1,1,
0,21,1,0,1,1,1,1,1,
0,1,1,21,0,1,1,1,1,
0,1,1,1,0,21,0,0,1,
0,0,21,1,1,1,1,0,1,
0,0,0,0,0,0,0,0,0,
0,0,0,0,0,0,0,0,0,
0,0,0,0,0,0,0,0,0.
[layer]
type=Tile Layer 2
data=
170,170,170,0,170,0,170,0,0,
169,169,169,0,169,0,169,169,169,
0,0,167,0,167,0,0,0,0,
139,139,139,0,139,139,139,139,139,
134,0,0,0,134,0,0,0,0,
117,0,117,117,117,117,117,117,117,
112,0,112,0,112,112,112,112,112,
133,0,133,133,133,133,133,133,133,
129,0,129,0,0,0,0,0,0,
118,118,118,118,118,118,118,0,0,
108,108,108,108,108,108,0,0,0,
134,134,134,134,134,0,0,134,0,
124,124,124,124,124,0,124,124,0,
114,114,114,114,0,0,0,114,0,
0,0,0,0,0,103,103,0,0,
0,0,129,129,129,129,129,0,0,
119,0,0,0,0,119,119,0,0,
109,109,109,109,0,109,109,0,109,
0,0,99,0,99,0,99,99,99,
123,123,123,0,123,0,123,123,123,
113,0,0,0,0,0,0,0,113,
99,99,99,99,99,99,99,0,99,
0,0,0,0,0,0,95,0,95,
94,94,94,94,94,0,94,0,94,
85,85,85,85,85,0,85,0,0,
84,84,84,84,84,0,84,0,84,
83,83,83,83,83,0,83,0,83,
74,74,74,0,0,74,74,74,74,
73,73,73,0,0,73,73,73,73,
0,0,72,0,72,72,72,72,72,
0,71,71,0,0,71,71,71,71,
0,70,70,70,0,0,0,0,70,
0,0,0,69,69,69,69,0,69,
0,0,0,0,0,0,0,0,0,
0,0,0,0,0,0,0,0,0,
0,0,0,0,0,0,0,0,0.