[layer]
type=Tile Layer 1
data=
1,1,4,21,1,1,6,1,1,
0,0,0,0,1,0,0,0,21,
1,21,1,1,1,5,6,1,1,
0,1,1,1,21,0,3,1,1,
0,4,1,1,0,21,5,1,5,
0,0,0,1,1,21,1,1,1,
3,1,0,0,1,21,0,0,0,
6,4,1,21,1,1,1,1,0,
1,6,21,1,1,1,1,0,1,
1,1,21,0,0,0,1,6,0,
4,1,1,1,1,1,21,1,0,
1,4,1,3,1,1,1,21,0,
0,0,21,1,1,3,0,0,0,
1,1,21,1,1,6,1,1,1,
4,1,21,1,6,1,0,1,1,
1,1,21,1,1,1,0,1,1,
0,0,21,0,0,0,0,3,1,
4,1,1,4,21,6,1,1,1,
0,0,0,4,0,1,1,21,0,
1,1,1,6,21,4,5,1,1,
0,0,21,1,0,1,1,1,0,
0,21,0,1,4,1,5,1,1,
0,6,21,5,1,1,1,1,1,
0,0,1,1,0,21,0,1,1,
1,21,1,1,5,1,0,1,1,
4,0,1,1,1,1,4,21,0,
6,1,1,0,0,0,21,0,1,
0,0,0,0,0,0,0,0,0,
0,0,0,0,0,0,0,0,0,
0,0,0,0,0,0,0,0,0.
[layer]
type=Tile Layer 2
data=
152,152,152,0,152,152,152,152,152,
0,0,0,0,158,0,0,0,0,
149,0,149,149,149,149,149,149,149,
0,117,117,117,0,0,117,117,117,
0,107,107,107,0,0,107,107,107,
0,0,0,133,133,0,133,133,133,
123,123,0,0,123,0,0,0,0,
113,113,113,0,113,113,113,113,0,
102,102,0,102,102,102,102,0,102,
128,128,0,0,0,0,128,128,0,
118,118,118,118,118,118,0,118,0,
108,108,108,108,108,108,108,0,0,
0,0,0,98,98,98,0,0,0,
116,116,0,116,116,116,116,116,116,
112,112,0,112,112,112,0,112,112,
103,103,0,103,103,103,0,103,103,
0,0,0,0,0,0,0,94,94,
88,88,88,88,0,88,88,88,88,
0,0,0,84,0,84,84,0,0,
79,79,79,79,0,79,79,79,79,
0,0,0,82,0,82,82,82,0,
0,0,0,73,73,73,73,73,73,
0,72,0,72,72,72,72,72,72,
0,0,71,71,0,0,0,71,71,
70,0,70,70,70,70,0,70,70,
69,0,69,69,69,69,69,0,0,
68,68,68,0,0,0,0,0,68,
0,0,0,0,0,0,0,0,0,
0,0,0,0,0,0,0,0,0,
0,0,0,0,0,0,0,0,0.