[layer]
type=Tile Layer 1
data=
1,1,1,1,1,21,1,1,1,
1,1,1,1,1,21,1,1,1,
1,1,1,1,1,21,1,1,1,
1,0,0,21,0,0,1,1,0,
1,1,1,1,1,0,1,21,0,
0,0,1,1,1,0,1,21,1,
0,0,0,21,1,1,1,1,0,
1,1,1,21,0,0,1,1,0,
0,0,0,21,1,1,1,0,0,
0,0,1,1,1,1,21,1,1,
1,1,21,1,1,1,0,1,1,
1,1,0,0,0,21,0,1,1,
0,1,21,1,1,1,1,1,0,
0,1,1,1,1,1,1,1,21,
1,0,21,0,0,0,0,1,0,
1,1,1,1,1,1,21,1,1,
1,1,1,1,21,1,0,1,1,
1,1,1,1,21,1,0,1,1,
1,1,1,1,21,1,0,1,1,
1,1,1,1,21,1,0,1,1,
0,0,0,0,0,1,21,0,0,
0,21,0,0,0,0,1,0,0,
1,1,1,1,1,21,1,1,1,
1,1,1,1,1,0,21,0,1,
1,1,1,1,1,21,1,0,1,
0,0,0,21,1,0,1,0,1,
1,1,1,1,1,1,1,21,1,
1,1,1,1,1,1,1,21,1,
1,0,21,0,1,1,0,1,1,
1,1,1,1,1,1,21,1,1,
0,1,1,0,0,21,0,1,1,
0,0,1,0,0,1,1,21,0,
0,0,1,1,21,0,1,0,1,
0,0,0,0,1,1,21,1,1,
1,1,1,21,1,1,1,0,1,
1,1,1,21,1,1,1,0,1,
1,0,0,1,1,0,21,0,0,
1,0,1,1,21,1,1,0,0,
0,0,0,0,21,1,1,0,1,
1,21,1,1,1,1,1,1,1,
1,21,0,0,1,1,1,1,1,
1,21,1,1,1,1,1,1,1,
1,21,1,0,0,0,0,1,0,
1,21,1,0,1,1,1,0,1,
1,21,1,0,1,1,1,0,0,
0,0,0,0,0,0,0,0,0,
0,0,0,0,0,0,0,0,0,
0,0,0,0,0,0,0,0,0.
[layer]
type=Tile Layer 2
data=
198,198,198,198,198,0,198,198,198,
196,196,196,196,196,0,196,196,196,
194,194,194,194,194,0,194,194,194,
178,0,0,0,0,0,178,178,0,
165,165,165,165,165,0,165,0,0,
0,0,152,152,152,0,152,0,152,
0,0,0,0,138,138,138,138,0,
173,173,173,0,0,0,173,173,0,
0,0,0,0,160,160,160,0,0,
0,0,147,147,147,147,0,147,147,
134,134,0,134,134,134,0,134,134,
167,167,0,0,0,0,0,167,167,
0,154,0,154,154,154,154,154,0,
0,142,142,142,142,142,142,142,0,
130,0,0,0,0,0,0,130,0,
154,154,154,154,154,154,0,154,154,
149,149,149,149,0,149,0,149,149,
137,137,137,137,0,137,0,137,137,
125,125,125,125,0,125,0,125,125,
156,156,156,156,0,156,0,156,156,
0,0,0,0,0,144,0,0,0,
0,0,0,0,0,0,132,0,0,
115,115,115,115,115,0,115,115,115,
150,150,150,150,150,0,0,0,150,
139,139,139,139,139,0,139,0,139,
0,0,0,0,128,0,128,0,128,
111,111,111,111,111,111,111,0,111,
138,138,138,138,138,138,138,0,138,
134,0,0,0,134,134,0,134,134,
117,117,117,117,117,117,0,117,117,
0,112,112,0,0,0,0,112,112,
0,0,139,0,0,139,139,0,0,
0,0,128,128,0,0,128,0,128,
0,0,0,0,118,118,0,118,118,
108,108,108,0,108,108,108,0,108,
107,107,107,0,107,107,107,0,107,
97,0,0,97,97,0,0,0,0,
96,0,96,96,0,96,96,0,0,
0,0,0,0,0,95,95,0,95,
81,0,81,81,81,81,81,81,81,
84,0,0,0,84,84,84,84,84,
79,0,79,79,79,79,79,79,79,
82,0,82,0,0,0,0,82,0,
81,0,81,0,81,81,81,0,81,
80,0,80,0,80,80,80,0,0,
0,0,0,0,0,0,0,0,0,
0,0,0,0,0,0,0,0,0,
0,0,0,0,0,0,0,0,0.