[layer]
type=Tile Layer 1
data=
3,0,0,0,21,1,0,1,0,
1,0,1,6,1,21,0,0,0,
1,0,21,0,0,0,1,1,5,
1,21,5,0,1,1,6,1,3,
6,0,1,0,0,0,21,0,1,
1,21,1,1,1,1,1,0,1,
1,0,0,21,4,1,1,0,1,
6,1,1,3,1,1,1,21,1,
0,21,0,0,0,0,6,0,1,
1,1,1,1,6,1,1,21,1,
0,0,0,0,1,0,0,0,21,
1,6,1,21,4,0,1,5,1,
0,21,0,0,0,0,1,1,6,
0,1,1,1,1,21,1,1,3,
0,21,0,1,4,0,0,0,0,
1,1,0,0,21,1,3,6,0,
1,1,21,1,6,1,4,1,0,
1,1,0,1,21,0,1,1,0,
0,0,0,0,0,0,0,0,0,
0,0,0,0,0,0,0,0,0,
0,0,0,0,0,0,0,0,0.
[layer]
type=Tile Layer 2
data=
128,0,0,0,0,128,0,128,0,
127,0,127,127,127,0,0,0,0,
125,0,0,0,0,0,125,125,125,
82,0,82,0,82,82,82,82,82,
107,0,107,0,0,0,0,0,107,
94,0,94,94,94,94,94,0,94,
90,0,0,0,90,90,90,0,90,
74,74,74,74,74,74,74,0,74,
0,0,0,0,0,0,81,0,81,
66,66,66,66,66,66,66,0,66,
0,0,0,0,72,0,0,0,0,
67,67,67,0,67,0,67,67,67,
0,0,0,0,0,0,63,63,63,
0,59,59,59,59,0,59,59,59,
0,0,0,61,61,0,0,0,0,
60,60,0,0,0,60,60,60,0,
57,57,0,57,57,57,57,57,0,
58,58,0,58,0,0,58,58,0,
0,0,0,0,0,0,0,0,0,
0,0,0,0,0,0,0,0,0,
0,0,0,0,0,0,0,0,0.