[layer]
type=Tile Layer 1
data=
1,1,21,1,1,1,1,0,0,
0,0,0,1,1,1,1,0,21,
0,0,1,1,1,1,1,21,1,
1,1,1,1,1,21,1,0,0,
1,1,1,21,0,0,1,1,0,
1,1,1,21,0,0,0,1,0,
1,1,21,0,1,1,1,1,0,
1,1,0,1,0,21,0,0,0,
1,1,0,0,21,0,1,0,0,
1,1,1,1,1,21,1,0,1,
1,0,0,21,0,0,1,0,1,
1,21,1,1,1,1,1,0,1,
1,0,1,0,0,21,0,0,1,
1,21,1,0,1,1,1,1,1,
1,21,1,0,1,1,1,1,1,
1,1,1,21,1,1,1,1,1,
0,0,0,21,1,1,0,0,0,
21,1,1,1,1,1,1,1,1,
0,1,1,1,21,1,1,1,0,
1,1,0,0,1,1,1,21,0,
1,0,0,0,1,0,1,21,0,
1,1,1,21,1,1,1,1,1,
0,0,1,0,0,1,1,21,1,
0,0,1,1,0,21,1,1,1,
0,0,0,0,0,0,0,0,0,
0,0,0,0,0,0,0,0,0,
0,0,0,0,0,0,0,0,0.
[layer]
type=Tile Layer 2
data=
139,139,0,139,139,139,139,0,0,
0,0,0,137,137,137,137,0,0,
0,0,136,136,136,136,136,0,136,
110,110,110,110,110,0,110,0,0,
101,101,101,0,0,0,101,101,0,
91,91,91,0,0,0,0,91,0,
114,114,0,0,114,114,114,114,0,
105,105,0,105,0,0,0,0,0,
96,96,0,0,0,0,96,0,0,
83,83,83,83,83,0,83,0,83,
108,0,0,0,0,0,108,0,108,
95,0,95,95,95,95,95,0,95,
91,0,91,0,0,0,0,0,91,
79,0,79,0,79,79,79,79,79,
78,0,78,0,78,78,78,78,78,
67,67,67,0,67,67,67,67,67,
0,0,0,0,73,73,0,0,0,
0,65,65,65,65,65,65,65,65,
0,64,64,64,0,64,64,64,0,
63,63,0,0,63,63,63,0,0,
62,0,0,0,62,0,62,0,0,
56,56,56,0,56,56,56,56,56,
0,0,60,0,0,60,60,0,60,
0,0,59,59,0,0,59,59,59,
0,0,0,0,0,0,0,0,0,
0,0,0,0,0,0,0,0,0,
0,0,0,0,0,0,0,0,0.