[layer]
type=Tile Layer 1
data=
0,1,0,21,1,1,1,1,1,
0,1,21,1,1,1,1,1,1,
0,1,1,21,0,1,1,1,1,
0,1,0,21,1,1,1,1,1,
21,1,1,1,1,1,1,1,1,
0,0,0,0,0,21,1,1,1,
0,0,1,1,21,0,1,1,1,
0,0,1,0,1,21,0,0,0,
0,0,0,0,21,1,1,1,1,
1,1,1,21,1,1,1,1,1,
0,21,1,0,1,0,0,0,0,
1,1,1,21,1,1,1,0,1,
0,0,0,0,1,1,1,21,1,
1,1,1,21,1,1,1,1,1,
0,21,1,0,1,1,1,0,0,
1,1,1,21,1,1,1,0,1,
1,1,1,0,21,0,0,0,1,
1,1,1,1,1,1,1,21,1,
1,21,1,0,1,1,1,0,1,
0,0,1,0,1,0,0,21,1,
1,1,1,21,1,0,1,0,1,
0,0,21,0,1,0,1,0,1,
1,1,1,21,1,1,1,0,1,
0,0,1,0,0,0,21,0,1,
1,21,1,1,1,1,1,0,1,
1,0,0,21,1,0,0,0,1,
1,1,1,21,1,1,1,1,1,
1,1,1,21,1,1,1,1,1,
0,0,1,21,1,0,1,0,0,
1,21,1,1,1,0,1,1,1,
1,0,0,0,21,0,1,1,1,
1,1,1,1,1,21,1,1,1,
0,0,0,0,1,21,0,0,0,
0,0,0,0,0,0,0,0,0,
0,0,0,0,0,0,0,0,0,
0,0,0,0,0,0,0,0,0.
[layer]
type=Tile Layer 2
data=
0,171,0,0,171,171,171,171,171,
0,170,0,170,170,170,170,170,170,
0,168,168,0,0,168,168,168,168,
0,147,0,0,147,147,147,147,147,
0,129,129,129,129,129,129,129,129,
0,0,0,0,0,0,124,124,124,
0,0,113,113,0,0,113,113,113,
0,0,141,0,141,0,0,0,0,
0,0,0,0,0,130,130,130,130,
114,114,114,0,114,114,114,114,114,
0,0,109,0,109,0,0,0,0,
135,135,135,0,135,135,135,0,135,
0,0,0,0,125,125,125,0,125,
109,109,109,0,109,109,109,109,109,
0,0,104,0,104,104,104,0,0,
130,130,130,0,130,130,130,0,130,
120,120,120,0,0,0,0,0,120,
105,105,105,105,105,105,105,0,105,
100,0,100,0,100,100,100,0,100,
0,0,124,0,124,0,0,0,124,
114,114,114,0,114,0,114,0,114,
0,0,0,0,105,0,105,0,105,
96,96,96,0,96,96,96,0,96,
0,0,95,0,0,0,0,0,95,
86,0,86,86,86,86,86,0,86,
85,0,0,0,85,0,0,0,85,
80,80,80,0,80,80,80,80,80,
71,71,71,0,71,71,71,71,71,
0,0,74,0,74,0,74,0,0,
73,0,73,73,73,0,73,73,73,
72,0,0,0,0,0,72,72,72,
68,68,68,68,68,0,68,68,68,
0,0,0,0,70,0,0,0,0,
0,0,0,0,0,0,0,0,0,
0,0,0,0,0,0,0,0,0,
0,0,0,0,0,0,0,0,0.