[layer]
type=Tile Layer 1
data=
1,0,4,1,21,0,0,5,1,
1,0,0,21,1,6,0,1,1,
1,1,1,21,1,1,4,0,0,
1,4,1,0,6,21,1,1,0,
3,1,21,0,1,1,0,1,0,
1,1,0,6,1,1,21,1,0,
1,1,6,0,21,1,0,1,0,
1,21,0,0,0,1,0,4,0,
0,0,1,0,0,21,0,0,1,
0,1,1,1,21,1,0,3,1,
0,0,0,1,0,1,0,0,21,
1,1,21,4,1,6,1,1,4,
0,1,0,5,21,0,0,0,0,
0,6,0,1,0,1,1,1,21,
0,1,0,1,21,1,0,0,0,
0,0,0,0,0,0,0,0,0,
0,0,0,0,0,0,0,0,0,
0,0,0,0,0,0,0,0,0.
[layer]
type=Tile Layer 2
data=
123,0,123,123,0,0,0,123,123,
121,0,0,0,121,121,0,121,121,
119,119,119,0,119,119,119,0,0,
89,89,89,0,89,0,89,89,0,
81,81,0,0,81,81,0,81,0,
80,80,0,80,80,80,0,80,0,
72,72,72,0,0,72,0,72,0,
71,0,0,0,0,71,0,71,0,
0,0,70,0,0,0,0,0,70,
0,62,62,62,0,62,0,62,62,
0,0,0,61,0,61,0,0,0,
54,54,0,54,54,54,54,54,54,
0,59,0,59,0,0,0,0,0,
0,58,0,58,0,58,58,58,0,
0,57,0,57,0,57,0,0,0,
0,0,0,0,0,0,0,0,0,
0,0,0,0,0,0,0,0,0,
0,0,0,0,0,0,0,0,0.