[layer]
type=Tile Layer 1
data=
0,0,5,1,1,1,6,21,0,
0,1,3,5,0,1,1,1,21,
0,1,1,3,21,1,1,1,0,
1,1,0,1,21,1,0,6,0,
1,1,0,5,21,1,0,4,1,
1,0,21,0,0,0,0,1,1,
0,0,0,0,0,0,0,0,0,
0,0,0,0,0,0,0,0,0,
0,0,0,0,0,0,0,0,0.
[layer]
type=Tile Layer 2
data=
0,0,41,41,41,41,41,0,0,
0,40,40,40,0,40,40,40,0,
0,39,39,39,0,39,39,39,0,
39,39,0,39,0,39,0,39,0,
38,38,0,38,0,38,0,38,38,
37,0,0,0,0,0,0,37,37,
0,0,0,0,0,0,0,0,0,
0,0,0,0,0,0,0,0,0,
0,0,0,0,0,0,0,0,0.