[layer]
type=Tile Layer 1
data=
1,0,1,0,1,0,1,21,0,
1,21,1,1,1,0,1,0,1,
0,0,0,0,0,0,1,21,1,
1,1,1,1,1,21,1,1,1,
1,1,1,1,1,21,1,0,1,
1,1,1,1,1,1,1,21,1,
1,0,0,0,0,0,0,21,0,
1,21,1,0,1,1,1,1,1,
1,0,1,0,1,1,1,21,0,
1,1,1,21,1,1,1,1,1,
1,1,21,0,1,1,1,1,1,
1,1,21,0,0,0,0,0,0,
1,1,1,1,1,1,1,21,0,
1,0,0,0,21,0,0,0,1,
0,21,1,1,1,1,1,1,1,
21,1,1,1,1,1,1,1,1,
0,0,21,0,0,0,0,1,1,
1,1,1,1,1,1,21,1,1,
1,1,21,1,0,1,1,1,0,
1,1,21,1,0,0,0,0,0,
1,1,21,1,0,1,1,1,1,
1,1,0,1,0,21,0,1,1,
1,1,21,1,1,1,0,1,1,
0,1,0,0,0,1,21,0,0,
0,0,0,0,0,0,0,0,0,
0,0,0,0,0,0,0,0,0,
0,0,0,0,0,0,0,0,0.
[layer]
type=Tile Layer 2
data=
138,0,138,0,138,0,138,0,0,
136,0,136,136,136,0,136,0,136,
0,0,0,0,0,0,135,0,135,
98,98,98,98,98,0,98,98,98,
95,95,95,95,95,0,95,0,95,
82,82,82,82,82,82,82,0,82,
113,0,0,0,0,0,0,0,0,
99,0,99,0,99,99,99,99,99,
95,0,95,0,95,95,95,0,0,
78,78,78,0,78,78,78,78,78,
102,102,0,0,102,102,102,102,102,
98,98,0,0,0,0,0,0,0,
86,86,86,86,86,86,86,0,0,
82,0,0,0,0,0,0,0,82,
0,0,77,77,77,77,77,77,77,
0,66,66,66,66,66,66,66,66,
0,0,0,0,0,0,0,72,72,
64,64,64,64,64,64,0,64,64,
63,63,0,63,0,63,63,63,0,
62,62,0,62,0,0,0,0,0,
58,58,0,58,0,58,58,58,58,
60,60,0,60,0,0,0,60,60,
57,57,0,57,57,57,0,57,57,
0,58,0,0,0,58,0,0,0,
0,0,0,0,0,0,0,0,0,
0,0,0,0,0,0,0,0,0,
0,0,0,0,0,0,0,0,0.