[layer]
type=Tile Layer 1
data=
1,0,1,21,1,0,1,0,1,
2,7,2,21,2,0,1,2,2,
21,1,1,1,1,1,1,1,0,
0,0,1,2,2,2,8,21,0,
0,0,2,2,10,2,2,21,0,
0,2,9,2,2,2,2,2,0,
1,2,2,2,21,2,2,7,1,
0,0,21,1,1,1,0,0,1,
1,1,1,1,1,1,1,7,1,
0,0,0,0,0,0,0,0,0,
0,0,0,0,0,0,0,0,0,
0,0,0,0,0,0,0,0,0.
[layer]
type=Tile Layer 2
data=
72,0,72,0,72,0,72,0,72,
46,46,46,0,46,0,46,46,46,
0,43,43,43,43,43,43,43,0,
0,0,44,44,44,44,44,0,0,
0,0,43,43,43,43,43,0,0,
0,43,43,43,43,43,43,43,0,
41,41,41,41,0,41,41,41,41,
0,0,0,42,42,42,0,0,42,
37,37,37,37,37,37,37,37,37,
0,0,0,0,0,0,0,0,0,
0,0,0,0,0,0,0,0,0,
0,0,0,0,0,0,0,0,0.