[layer]
type=Tile Layer 1
data=
1,0,1,1,0,1,0,21,0,
1,1,0,1,21,3,1,4,0,
0,1,0,0,0,2,2,21,0,
0,2,2,2,2,8,2,7,21,
0,0,0,21,2,2,2,1,0,
2,2,3,1,4,2,21,1,1,
10,2,2,2,21,0,0,0,0,
2,2,8,2,4,6,1,1,21,
1,0,2,2,1,0,21,0,0,
0,0,1,0,0,21,1,1,1,
1,0,6,0,1,21,0,1,4,
0,0,1,0,1,21,1,5,6,
0,0,0,0,0,0,0,0,0,
0,0,0,0,0,0,0,0,0,
0,0,0,0,0,0,0,0,0.
[layer]
type=Tile Layer 2
data=
88,0,88,88,0,88,0,0,0,
63,63,0,63,0,63,63,63,0,
0,62,0,0,0,62,62,0,0,
0,61,61,61,61,61,61,61,0,
0,0,0,0,54,54,54,54,0,
48,48,48,48,48,48,0,48,48,
52,52,52,52,0,0,0,0,0,
49,49,49,49,49,49,49,49,0,
50,0,50,50,50,0,0,0,0,
0,0,49,0,0,0,49,49,49,
48,0,48,0,48,0,0,48,48,
0,0,47,0,47,0,47,47,47,
0,0,0,0,0,0,0,0,0,
0,0,0,0,0,0,0,0,0,
0,0,0,0,0,0,0,0,0.