[layer]
type=Tile Layer 1
data=
1,1,21,0,0,1,1,1,1,
1,1,0,21,0,0,1,1,1,
1,1,1,1,2,21,2,1,1,
2,2,2,0,21,20,2,0,0,
2,2,2,2,2,21,2,20,2,
0,0,21,0,0,0,2,0,20,
1,1,1,1,1,1,1,21,2,
0,0,0,21,1,0,1,0,1,
1,1,1,21,1,0,1,0,1,
1,1,1,21,1,0,1,0,1,
1,1,1,21,1,0,1,0,1,
1,1,1,0,1,0,1,21,0,
1,0,0,21,0,1,1,1,1,
1,1,0,1,21,0,1,1,1,
2,2,21,2,2,18,2,2,2,
1,1,0,1,2,21,0,1,1,
1,21,2,2,2,24,0,1,1,
2,0,21,20,0,0,2,2,2,
0,1,21,2,2,0,1,1,1,
0,1,21,1,0,0,1,1,1,
0,21,0,18,2,2,2,2,2,
1,1,1,1,0,21,0,0,19,
1,1,1,1,1,1,1,21,2,
1,1,1,1,21,0,0,1,1,
0,0,2,2,1,21,1,1,1,
0,2,19,0,0,21,1,1,1,
0,0,21,0,0,1,1,1,1,
1,1,1,1,0,21,0,0,0,
1,1,1,1,1,1,1,21,1,
1,1,1,1,21,0,0,1,1,
0,1,0,1,21,1,1,1,0,
0,0,0,1,21,0,0,2,0,
2,2,21,2,2,2,2,2,20,
1,1,21,1,1,1,1,2,2,
0,0,0,0,21,0,0,0,1,
1,1,1,1,1,1,1,21,1,
0,0,1,21,1,1,1,0,1,
2,21,2,18,2,2,2,0,2,
1,0,1,0,21,0,0,0,0,
1,1,1,21,0,0,1,1,0,
2,2,2,21,18,2,2,0,0,
1,1,1,1,21,1,1,0,1,
2,2,2,2,0,2,21,18,2,
1,1,1,1,21,1,0,1,1,
1,1,1,1,1,1,21,0,1,
0,0,0,0,0,0,0,0,0,
0,0,0,0,0,0,0,0,0,
0,0,0,0,0,0,0,0,0.
[layer]
type=Tile Layer 2
data=
208,208,0,0,0,208,208,208,208,
206,206,0,0,0,0,206,206,206,
194,194,194,194,194,0,194,194,194,
178,178,178,0,0,0,178,0,0,
165,165,165,165,165,0,165,0,165,
0,0,0,0,0,0,152,0,0,
132,132,132,132,132,132,132,0,132,
0,0,0,0,173,0,173,0,173,
160,160,160,0,160,0,160,0,160,
147,147,147,0,147,0,147,0,147,
134,134,134,0,134,0,134,0,134,
167,167,167,0,167,0,167,0,0,
154,0,0,0,0,154,154,154,154,
142,142,0,142,0,0,142,142,142,
130,130,0,130,130,0,130,130,130,
162,162,0,162,162,0,0,162,162,
149,0,149,149,149,0,0,149,149,
137,0,0,0,0,0,137,137,137,
0,125,0,125,125,0,125,125,125,
0,156,0,156,0,0,156,156,156,
0,0,0,0,144,144,144,144,144,
132,132,132,132,0,0,0,0,0,
115,115,115,115,115,115,115,0,115,
150,150,150,150,0,0,0,150,150,
0,0,139,139,139,0,139,139,139,
0,128,0,0,0,0,128,128,128,
0,0,0,0,0,116,116,116,116,
145,145,145,145,0,0,0,0,0,
127,127,127,127,127,127,127,0,127,
123,123,123,123,0,0,0,123,123,
0,112,0,112,0,112,112,112,0,
0,0,0,139,0,0,0,139,0,
128,128,0,128,128,128,128,128,0,
112,112,0,112,112,112,112,112,112,
0,0,0,0,0,0,0,0,108,
102,102,102,102,102,102,102,0,102,
0,0,97,0,97,97,97,0,97,
96,0,96,0,96,96,96,0,96,
95,0,95,0,0,0,0,0,0,
85,85,85,0,0,0,85,85,0,
84,84,84,0,0,84,84,0,0,
83,83,83,83,0,83,83,0,83,
82,82,82,82,0,82,0,0,82,
81,81,81,81,0,81,0,81,81,
80,80,80,80,80,80,0,0,80,
0,0,0,0,0,0,0,0,0,
0,0,0,0,0,0,0,0,0,
0,0,0,0,0,0,0,0,0.