[layer]
type=Tile Layer 1
data=
0,0,1,1,0,0,0,0,21,
0,0,21,1,1,1,6,1,0,
1,1,21,0,1,5,1,3,0,
1,0,5,21,0,0,0,0,0,
1,21,1,1,3,6,1,1,1,
1,0,0,21,0,0,1,0,0,
1,1,1,4,1,21,5,3,4,
0,0,0,0,1,21,0,0,0,
21,1,1,1,1,1,1,1,1,
21,3,1,1,1,1,3,1,5,
0,6,21,0,0,1,1,6,1,
0,1,1,1,21,1,1,1,1,
0,0,1,0,1,0,0,21,5,
1,0,1,21,4,0,1,1,1,
1,0,0,21,1,0,3,0,0,
1,1,6,5,1,21,1,0,1,
0,0,1,0,1,21,0,0,1,
1,21,6,0,4,1,1,1,1,
0,0,1,0,0,21,1,0,0,
1,1,5,21,1,0,1,0,3,
1,0,1,21,1,0,0,0,6,
1,5,1,21,1,1,1,0,1,
1,21,0,0,3,1,1,0,1,
6,1,1,1,5,1,3,21,1,
6,21,0,0,0,0,0,0,0,
1,1,1,1,1,1,1,21,1,
0,21,5,1,1,0,4,0,0,
0,0,0,0,0,0,0,0,0,
0,0,0,0,0,0,0,0,0,
0,0,0,0,0,0,0,0,0.
[layer]
type=Tile Layer 2
data=
0,0,160,160,0,0,0,0,0,
0,0,0,158,158,158,158,158,0,
157,157,0,0,157,157,157,157,0,
117,0,117,0,0,0,0,0,0,
102,0,102,102,102,102,102,102,102,
133,0,0,0,0,0,133,0,0,
117,117,117,117,117,0,117,117,117,
0,0,0,0,113,0,0,0,0,
0,98,98,98,98,98,98,98,98,
0,122,122,122,122,122,122,122,122,
0,118,0,0,0,118,118,118,118,
0,108,108,108,0,108,108,108,108,
0,0,98,0,98,0,0,0,98,
122,0,122,0,122,0,122,122,122,
112,0,0,0,112,0,112,0,0,
103,103,103,103,103,0,103,0,103,
0,0,94,0,94,0,0,0,94,
93,0,93,0,93,93,93,93,93,
0,0,84,0,0,0,84,0,0,
83,83,83,0,83,0,83,0,83,
82,0,82,0,82,0,0,0,82,
73,73,73,0,73,73,73,0,73,
72,0,0,0,72,72,72,0,72,
68,68,68,68,68,68,68,0,68,
70,0,0,0,0,0,0,0,0,
66,66,66,66,66,66,66,0,66,
0,0,68,68,68,0,68,0,0,
0,0,0,0,0,0,0,0,0,
0,0,0,0,0,0,0,0,0,
0,0,0,0,0,0,0,0,0.