[layer]
type=Tile Layer 1
data=
0,1,1,3,0,1,21,0,0,
0,5,1,1,21,1,1,6,1,
0,0,0,1,21,0,0,0,0,
1,1,1,4,21,1,1,1,1,
6,1,1,6,21,4,1,3,0,
3,1,1,1,21,1,1,1,0,
0,0,0,1,0,1,1,1,21,
0,5,5,1,21,1,1,1,4,
0,6,1,1,21,0,0,0,0,
1,6,0,21,1,1,1,1,0,
3,1,1,0,21,6,1,1,0,
1,1,1,1,21,3,4,1,0,
1,21,0,0,0,6,1,0,0,
0,0,1,5,1,0,0,21,0,
0,0,1,1,1,0,21,1,4,
0,0,1,1,1,1,21,3,1,
0,1,5,1,1,1,21,1,1,
0,1,1,1,6,6,21,1,3,
0,0,1,0,0,21,1,0,1,
5,3,1,21,1,1,1,0,1,
5,1,1,21,1,4,1,0,1,
1,1,1,1,3,1,1,21,5,
1,1,1,0,0,21,0,0,1,
1,1,3,21,1,5,4,0,1,
0,0,21,0,5,0,1,0,1,
1,0,1,1,4,21,1,0,1,
1,0,1,1,6,21,6,0,0,
5,21,0,1,1,3,0,1,3,
1,1,0,1,1,1,21,0,0,
6,1,0,1,1,1,21,1,0,
1,1,0,0,5,1,0,21,0,
6,6,1,0,0,21,1,1,0,
1,1,1,0,1,21,4,1,0,
0,0,0,0,0,0,0,0,0,
0,0,0,0,0,0,0,0,0,
0,0,0,0,0,0,0,0,0.
[layer]
type=Tile Layer 2
data=
0,171,171,171,0,171,0,0,0,
0,170,170,170,0,170,170,170,170,
0,0,0,168,0,0,0,0,0,
140,140,140,140,0,140,140,140,140,
135,135,135,135,0,135,135,135,0,
124,124,124,124,0,124,124,124,0,
0,0,0,113,0,113,113,113,0,
0,141,141,141,0,141,141,141,141,
0,130,130,130,0,0,0,0,0,
119,119,0,0,119,119,119,119,0,
109,109,109,0,0,109,109,109,0,
135,135,135,135,0,135,135,135,0,
125,0,0,0,0,125,125,0,0,
0,0,115,115,115,0,0,0,0,
0,0,104,104,104,0,0,104,104,
0,0,130,130,130,130,0,130,130,
0,120,120,120,120,120,0,120,120,
0,110,110,110,110,110,0,110,110,
0,0,100,0,0,0,100,0,100,
124,124,124,0,124,124,124,0,124,
114,114,114,0,114,114,114,0,114,
100,100,100,100,100,100,100,0,100,
96,96,96,0,0,0,0,0,96,
95,95,95,0,95,95,95,0,95,
0,0,0,0,86,0,86,0,86,
85,0,85,85,85,0,85,0,85,
84,0,84,84,84,0,84,0,0,
75,0,0,75,75,75,0,75,75,
74,74,0,74,74,74,0,0,0,
73,73,0,73,73,73,0,73,0,
72,72,0,0,72,72,0,0,0,
71,71,71,0,0,0,71,71,0,
70,70,70,0,70,0,70,70,0,
0,0,0,0,0,0,0,0,0,
0,0,0,0,0,0,0,0,0,
0,0,0,0,0,0,0,0,0.