[layer]
type=Tile Layer 1
data=
1,1,6,5,1,5,6,21,0,
6,0,21,0,0,0,0,0,0,
4,21,4,5,5,4,1,2,2,
6,21,1,0,3,1,6,2,8,
6,0,3,21,0,0,1,2,0,
2,21,4,4,6,0,3,1,4,
8,0,1,3,6,21,0,0,0,
2,21,2,2,5,1,3,5,1,
6,2,10,1,1,1,21,1,0,
5,21,2,2,5,3,1,1,4,
0,21,3,4,3,1,5,4,5,
4,2,2,1,1,21,3,3,5,
1,8,21,1,5,5,1,4,0,
2,2,21,2,2,2,7,2,0,
4,3,21,3,3,5,4,4,1,
5,0,5,21,5,1,1,0,4,
0,2,7,2,21,2,2,2,2,
0,4,6,4,0,1,21,6,0,
6,1,1,6,21,1,0,3,0,
0,3,5,5,0,3,21,6,0,
0,2,2,2,21,2,2,7,2,
10,2,1,0,5,21,0,0,1,
2,2,1,21,5,4,6,5,6,
1,4,5,21,4,6,4,4,6,
1,6,6,21,6,4,5,1,5,
0,0,21,0,5,1,5,6,4,
1,21,1,4,6,6,4,5,4,
0,0,0,0,21,0,3,0,1,
3,21,5,4,2,2,2,0,3,
5,21,1,4,2,8,2,0,4,
3,1,5,1,2,2,21,5,0,
0,0,21,6,6,3,0,3,0,
6,1,3,5,6,1,21,5,0,
2,2,2,2,2,7,21,2,0,
2,2,2,9,2,2,21,2,0,
4,6,21,2,0,0,0,0,0,
3,4,21,5,3,1,4,4,5,
0,0,0,3,3,2,21,0,5,
4,1,21,1,1,2,8,2,5,
0,21,0,0,0,2,2,2,2,
5,1,2,2,21,0,0,2,8,
4,6,2,8,21,0,0,0,2,
5,1,2,2,21,6,5,5,3,
5,6,3,21,0,1,5,6,1,
3,6,6,21,1,3,6,1,3,
2,2,6,21,1,1,1,1,6,
8,2,3,1,1,1,21,0,3,
2,2,5,21,5,1,6,3,1,
4,6,4,6,1,0,1,21,0,
4,3,3,4,21,0,3,6,0,
3,1,1,3,0,4,6,21,0,
1,6,3,3,0,0,0,21,0,
6,1,4,4,0,0,0,21,0,
4,1,6,4,21,0,0,0,3,
0,0,0,0,0,0,0,0,0,
0,0,0,0,0,0,0,0,0,
0,0,0,0,0,0,0,0,0.
[layer]
type=Tile Layer 2
data=
239,239,239,239,239,239,239,0,0,
237,0,0,0,0,0,0,0,0,
224,0,224,224,224,224,224,224,224,
164,0,164,0,164,164,164,164,164,
205,0,205,0,0,0,205,205,0,
189,0,189,189,151,0,189,189,189,
174,0,174,139,139,0,0,0,0,
159,0,127,127,127,7,127,159,159,
199,159,159,9,9,9,0,9,0,
140,0,140,140,140,140,140,140,140,
0,0,135,135,135,8,135,135,169,
147,147,147,147,147,0,147,147,147,
193,193,0,193,193,193,193,193,0,
179,179,0,179,179,179,179,179,0,
157,157,0,157,157,157,157,157,157,
150,0,150,0,150,150,150,0,150,
0,188,188,188,0,188,188,188,188,
0,174,174,174,0,174,0,174,0,
160,160,160,160,0,160,0,160,0,
0,146,146,146,0,146,0,146,0,
0,182,182,182,0,182,182,182,182,
168,168,168,0,168,0,0,0,168,
148,148,148,0,148,148,148,148,148,
135,135,135,0,135,135,135,135,135,
168,168,168,0,168,168,168,168,168,
0,0,0,0,163,163,163,163,163,
143,0,143,143,143,143,143,143,143,
0,0,0,0,0,0,137,0,137,
171,0,171,171,171,171,171,0,171,
158,0,158,158,158,158,158,0,158,
145,145,145,145,145,145,0,145,0,
0,0,0,133,133,133,0,133,0,
165,165,165,165,165,165,0,165,0,
153,153,153,153,153,153,0,153,0,
141,141,141,141,141,141,0,141,0,
128,128,0,128,0,0,0,0,0,
152,152,0,152,152,152,152,152,152,
0,0,0,148,148,148,0,0,148,
136,136,0,136,136,136,136,136,136,
0,0,0,0,0,124,124,124,124,
154,154,154,154,0,0,0,154,154,
142,142,142,142,0,0,0,0,142,
125,125,125,125,0,125,125,125,125,
120,96,96,0,0,96,96,96,120,
113,90,90,0,113,90,90,90,113,
108,86,86,0,5,5,5,5,108,
107,107,107,5,5,5,0,0,107,
101,80,80,0,80,80,80,80,101,
95,95,95,95,95,0,95,0,0,
94,94,94,94,0,0,94,94,0,
93,93,93,93,0,93,93,0,0,
92,92,92,92,0,0,0,0,0,
91,91,91,91,0,0,0,0,0,
90,90,90,90,0,0,0,0,90,
0,0,0,0,0,0,0,0,0,
0,0,0,0,0,0,0,0,0,
0,0,0,0,0,0,0,0,0.