[layer]
type=Tile Layer 1
data=
0,0,1,0,0,0,0,21,1,
1,1,1,1,1,1,1,21,1,
1,1,1,21,1,1,1,0,0,
1,1,1,21,1,1,1,0,1,
0,0,0,0,1,1,1,21,1,
1,21,1,0,1,1,1,0,1,
1,1,1,1,1,21,0,0,1,
1,1,1,1,1,1,1,21,1,
0,1,1,21,0,0,0,0,1,
1,21,1,1,1,1,1,0,1,
1,21,1,1,1,1,1,0,1,
1,21,1,1,1,1,1,0,1,
1,0,1,21,0,0,0,0,1,
1,0,1,1,1,21,1,0,1,
1,0,1,1,1,21,1,0,1,
1,0,0,21,1,0,1,0,0,
1,0,1,1,1,21,1,0,1,
0,0,1,0,21,0,1,0,0,
1,1,1,21,1,0,1,1,1,
1,0,0,0,1,21,0,0,1,
1,1,1,21,1,0,1,1,1,
0,0,21,0,1,0,1,0,0,
1,1,1,21,1,1,1,0,1,
1,21,0,0,1,0,0,0,1,
0,21,0,0,1,1,1,1,1,
1,21,1,0,0,1,1,1,1,
1,0,0,1,0,0,0,21,0,
1,1,21,0,1,0,0,0,0,
1,1,1,21,1,0,1,1,1,
1,1,1,1,1,21,1,0,0,
1,1,1,1,1,0,21,1,0,
1,1,1,1,1,1,21,1,0,
1,1,1,1,1,1,21,1,0,
1,1,1,1,21,0,0,1,1,
1,1,1,0,21,1,0,0,0,
1,1,1,0,0,21,1,1,0,
1,1,1,1,1,0,1,21,0,
1,1,1,1,1,21,1,1,0,
1,1,0,21,0,0,0,0,0,
0,0,0,0,0,0,0,0,0,
0,0,0,0,0,0,0,0,0,
0,0,0,0,0,0,0,0,0.
[layer]
type=Tile Layer 2
data=
0,0,197,0,0,0,0,0,197,
186,186,186,186,186,186,186,0,186,
194,194,194,0,194,194,194,0,0,
146,146,146,0,146,146,146,0,146,
0,0,0,0,133,133,133,0,133,
166,0,166,0,166,166,166,0,166,
153,153,153,153,153,0,0,0,153,
134,134,134,134,134,134,134,0,134,
0,129,129,0,0,0,0,0,129,
161,0,161,161,161,161,161,0,161,
148,0,148,148,148,148,148,0,148,
136,0,136,136,136,136,136,0,136,
124,0,124,0,0,0,0,0,124,
155,0,155,155,155,0,155,0,155,
143,0,143,143,143,0,143,0,143,
131,0,0,0,131,0,131,0,0,
120,0,120,120,120,0,120,0,120,
0,0,149,0,0,0,149,0,0,
138,138,138,0,138,0,138,138,138,
127,0,0,0,127,0,0,0,127,
115,115,115,0,115,0,115,115,115,
0,0,0,0,144,0,144,0,0,
133,133,133,0,133,133,133,0,133,
122,0,0,0,122,0,0,0,122,
0,0,0,0,111,111,111,111,111,
138,0,138,0,0,138,138,138,138,
127,0,0,127,0,0,0,0,0,
117,117,0,0,117,0,0,0,0,
107,107,107,0,107,0,107,107,107,
106,106,106,106,106,0,106,0,0,
96,96,96,96,96,0,0,96,0,
95,95,95,95,95,95,0,95,0,
94,94,94,94,94,94,0,94,0,
84,84,84,84,0,0,0,84,84,
83,83,83,0,0,83,0,0,0,
82,82,82,0,0,0,82,82,0,
81,81,81,81,81,0,81,0,0,
80,80,80,80,80,0,80,80,0,
79,79,0,0,0,0,0,0,0,
0,0,0,0,0,0,0,0,0,
0,0,0,0,0,0,0,0,0,
0,0,0,0,0,0,0,0,0.