[layer]
type=Tile Layer 1
data=
0,0,1,21,1,0,1,0,0,
0,0,21,1,1,1,0,0,0,
0,21,1,0,1,0,1,0,0,
0,1,1,1,1,1,1,1,21,
0,1,0,0,1,0,0,1,21,
0,0,0,1,1,21,0,0,0,
0,0,0,0,0,0,0,0,0,
0,0,0,0,0,0,0,0,0,
0,0,0,0,0,0,0,0,0.
[layer]
type=Tile Layer 2
data=
0,0,32,0,32,0,32,0,0,
0,0,0,32,32,32,0,0,0,
0,0,31,0,31,0,31,0,0,
0,27,27,27,27,27,27,27,0,
0,30,0,0,30,0,0,30,0,
0,0,0,29,29,0,0,0,0,
0,0,0,0,0,0,0,0,0,
0,0,0,0,0,0,0,0,0,
0,0,0,0,0,0,0,0,0.