[layer]
type=Tile Layer 1
data=
1,1,1,1,21,3,1,5,1,
1,1,1,21,0,4,1,3,1,
1,5,1,21,1,1,1,1,4,
1,6,1,21,6,1,1,1,1,
0,0,4,21,1,1,1,1,1,
1,21,1,0,4,1,1,1,5,
1,0,1,21,0,0,0,0,0,
1,21,1,1,4,6,1,1,3,
1,0,21,0,0,0,0,0,0,
1,1,4,3,1,1,1,21,1,
0,21,4,1,1,1,1,0,6,
1,21,6,1,1,3,1,1,1,
1,6,21,1,1,5,1,1,0,
1,1,21,4,4,1,1,1,0,
1,1,21,1,1,1,6,1,5,
5,0,1,21,1,3,6,0,6,
0,1,1,1,21,1,1,1,1,
0,1,1,1,0,1,21,1,0,
1,5,1,1,0,4,21,4,0,
0,1,1,6,0,1,21,1,0,
0,1,1,1,0,1,0,1,21,
1,3,1,21,1,0,0,0,1,
4,1,1,21,1,6,1,1,1,
1,6,1,21,1,1,1,1,3,
1,1,1,21,1,1,3,1,1,
0,21,0,0,1,1,1,6,1,
1,21,4,4,6,1,1,1,1,
0,0,0,0,0,0,1,21,1,
1,21,1,3,1,1,5,0,5,
4,21,1,1,1,1,1,0,1,
1,1,5,21,1,1,1,1,1,
1,1,4,0,1,21,0,0,1,
1,1,1,1,1,21,4,6,5,
0,0,21,0,0,0,3,0,1,
1,3,1,5,4,1,1,21,1,
1,1,1,1,1,21,0,0,1,
1,1,1,1,1,21,1,0,1,
4,0,0,21,0,0,1,0,3,
6,21,1,1,1,1,3,0,1,
1,1,1,1,1,0,21,1,0,
6,1,1,1,1,4,21,3,0,
1,6,1,1,0,1,21,0,0,
1,1,1,1,0,21,1,5,0,
1,6,1,21,5,0,1,0,0,
1,1,1,21,3,1,0,0,1,
3,4,1,21,1,1,0,1,1,
4,5,1,0,0,1,21,0,1,
1,1,1,1,21,0,1,0,1,
1,3,1,1,1,1,21,0,6,
0,0,0,0,21,0,0,0,1,
0,0,21,1,3,1,5,1,1,
1,21,0,1,1,1,1,6,1,
1,0,21,0,0,4,6,1,1,
1,3,0,21,0,1,1,1,1,
0,0,0,0,0,0,0,0,0,
0,0,0,0,0,0,0,0,0,
0,0,0,0,0,0,0,0,0.
[layer]
type=Tile Layer 2
data=
227,227,227,227,0,227,227,227,227,
237,237,237,0,0,237,237,237,237,
224,224,224,0,224,224,224,224,224,
156,156,156,0,156,156,156,156,156,
0,0,205,0,205,205,205,205,205,
189,0,189,0,189,189,189,189,189,
174,0,174,0,0,0,0,0,0,
152,0,152,152,152,152,152,152,152,
199,0,0,0,0,0,0,0,0,
175,175,175,175,175,175,175,0,175,
0,0,169,169,169,169,169,0,169,
147,0,147,147,147,147,147,147,147,
193,193,0,193,193,193,193,193,0,
179,179,0,179,179,179,179,179,0,
157,157,0,157,157,157,157,157,157,
150,0,150,0,150,150,150,0,150,
0,188,188,188,0,188,188,188,188,
0,174,174,174,0,174,0,174,0,
160,160,160,160,0,160,0,160,0,
0,146,146,146,0,146,0,146,0,
0,182,182,182,0,182,0,182,0,
168,168,168,0,168,0,0,0,168,
148,148,148,0,148,148,148,148,148,
135,135,135,0,135,135,135,135,135,
168,168,168,0,168,168,168,168,168,
0,0,0,0,163,163,163,163,163,
143,0,143,143,143,143,143,143,143,
0,0,0,0,0,0,137,0,137,
171,0,171,171,171,171,171,0,171,
158,0,158,158,158,158,158,0,158,
138,138,138,0,138,138,138,138,138,
133,133,133,0,133,0,0,0,133,
157,157,157,157,157,0,157,157,157,
0,0,0,0,0,0,153,0,153,
134,134,134,134,134,134,134,0,134,
128,128,128,128,128,0,0,0,128,
160,160,160,160,160,0,160,0,160,
148,0,0,0,0,0,148,0,148,
136,0,136,136,136,136,136,0,136,
124,124,124,124,124,0,0,124,0,
154,154,154,154,154,154,0,154,0,
142,142,142,142,0,142,0,0,0,
131,131,131,131,0,0,131,131,0,
120,120,120,0,120,0,120,0,0,
119,119,119,0,119,119,0,0,119,
108,108,108,0,108,108,0,108,108,
107,107,107,0,0,107,0,0,107,
106,106,106,106,0,0,106,0,106,
95,95,95,95,95,95,0,0,95,
0,0,0,0,0,0,0,0,94,
0,0,0,93,93,93,93,93,93,
92,0,0,92,92,92,92,92,92,
91,0,0,0,0,91,91,91,91,
90,90,0,0,0,90,90,90,90,
0,0,0,0,0,0,0,0,0,
0,0,0,0,0,0,0,0,0,
0,0,0,0,0,0,0,0,0.