[layer]
type=Tile Layer 1
data=
0,0,0,0,0,21,6,1,1,
1,21,1,1,1,0,6,1,4,
1,21,3,0,0,0,2,1,1,
2,21,2,2,2,20,2,2,2,
5,21,1,3,2,0,0,0,1,
1,21,1,6,1,1,1,1,1,
0,0,0,0,0,0,1,21,0,
1,4,1,1,1,21,2,0,6,
1,1,1,1,1,21,2,24,3,
0,0,21,0,0,1,1,1,4,
18,2,21,2,2,2,2,2,2,
0,2,21,6,1,1,1,1,1,
24,2,21,5,1,3,1,1,1,
0,1,0,21,0,0,1,1,1,
0,6,1,2,2,21,0,0,0,
1,1,1,21,24,2,3,1,1,
0,21,0,5,1,0,1,1,1,
0,0,21,0,0,0,6,1,6,
1,0,2,21,19,0,1,1,3,
1,21,19,2,2,0,1,5,1,
0,0,2,0,1,0,1,21,0,
1,1,4,21,1,1,3,1,1,
1,1,5,0,1,0,21,0,0,
1,3,1,21,1,1,4,1,1,
1,1,1,0,2,0,21,0,0,
1,1,6,21,2,19,2,0,1,
0,21,0,0,2,2,2,0,4,
1,1,0,21,1,1,0,0,5,
1,1,21,0,1,6,0,0,1,
2,2,18,2,2,21,0,2,2,
1,1,0,0,21,24,0,6,4,
1,1,1,0,1,1,0,21,0,
1,1,3,21,1,1,1,6,0,
0,0,0,0,0,0,0,0,0,
0,0,0,0,0,0,0,0,0,
0,0,0,0,0,0,0,0,0.
[layer]
type=Tile Layer 2
data=
0,0,0,0,0,0,170,170,170,
169,0,169,169,169,0,169,169,169,
167,0,167,0,0,0,167,167,167,
146,0,146,146,146,0,146,146,146,
134,0,134,134,134,0,0,0,134,
117,0,117,117,117,117,117,117,117,
0,0,0,0,0,0,112,0,0,
140,140,140,140,140,0,140,0,140,
129,129,129,129,129,0,129,0,129,
0,0,0,0,0,118,118,118,118,
0,108,0,108,108,108,108,108,108,
0,134,0,134,134,134,134,134,134,
0,124,0,124,124,124,124,124,124,
0,114,0,0,0,0,114,114,114,
0,103,103,103,103,0,0,0,0,
129,129,129,0,0,129,129,129,129,
0,0,0,119,119,0,119,119,119,
0,0,0,0,0,0,109,109,109,
99,0,99,0,0,0,99,99,99,
123,0,0,123,123,0,123,123,123,
0,0,113,0,113,0,113,0,0,
99,99,99,0,99,99,99,99,99,
95,95,95,0,95,0,0,0,0,
89,89,89,0,89,89,89,89,89,
85,85,85,0,85,0,0,0,0,
84,84,84,0,84,0,84,0,84,
0,0,0,0,83,83,83,0,83,
74,74,0,0,74,74,0,0,74,
73,73,0,0,73,73,0,0,73,
72,72,0,72,72,0,0,72,72,
71,71,0,0,0,0,0,71,71,
70,70,70,0,70,70,0,0,0,
69,69,69,0,69,69,69,69,0,
0,0,0,0,0,0,0,0,0,
0,0,0,0,0,0,0,0,0,
0,0,0,0,0,0,0,0,0.