[layer]
type=Tile Layer 1
data=
1,1,1,1,1,21,1,1,0,
1,1,1,1,1,21,1,0,0,
1,1,1,1,1,21,1,0,1,
1,1,1,1,1,1,1,1,21,
1,1,1,0,0,21,0,0,0,
1,1,1,21,1,1,1,1,1,
0,0,0,21,1,1,1,1,1,
1,1,1,21,1,1,1,1,1,
1,0,1,0,0,21,0,0,1,
1,21,1,1,1,0,1,1,1,
0,0,0,0,1,21,1,0,1,
1,1,1,1,1,21,1,0,1,
1,1,21,1,1,1,0,1,1,
1,0,0,21,0,0,0,0,0,
1,21,1,1,1,1,1,1,1,
1,21,1,0,0,0,0,0,1,
1,0,1,1,1,21,1,0,1,
1,0,1,21,0,0,1,0,1,
1,21,1,0,1,0,1,1,1,
0,0,0,0,1,21,1,0,0,
1,1,1,1,1,1,1,21,1,
1,0,0,0,0,21,0,0,1,
1,21,1,1,1,1,1,0,1,
0,0,1,1,1,1,1,21,0,
1,21,1,1,1,1,1,0,1,
1,21,1,0,0,0,0,0,0,
1,21,1,1,1,1,1,1,1,
0,0,0,0,0,0,0,0,0,
0,0,0,0,0,0,0,0,0,
0,0,0,0,0,0,0,0,0.
[layer]
type=Tile Layer 2
data=
160,160,160,160,160,0,160,160,0,
158,158,158,158,158,0,158,0,0,
157,157,157,157,157,0,157,0,157,
112,112,112,112,112,112,112,112,0,
107,107,107,0,0,0,0,0,0,
127,127,127,0,127,127,127,127,127,
0,0,0,0,123,123,123,123,123,
107,107,107,0,107,107,107,107,107,
102,0,102,0,0,0,0,0,102,
128,0,128,128,128,0,128,128,128,
0,0,0,0,118,0,118,0,118,
108,108,108,108,108,0,108,0,108,
98,98,0,98,98,98,0,98,98,
122,0,0,0,0,0,0,0,0,
107,0,107,107,107,107,107,107,107,
103,0,103,0,0,0,0,0,103,
94,0,94,94,94,0,94,0,94,
93,0,93,0,0,0,93,0,93,
84,0,84,0,84,0,84,84,84,
0,0,0,0,83,0,83,0,0,
78,78,78,78,78,78,78,0,78,
73,0,0,0,0,0,0,0,73,
72,0,72,72,72,72,72,0,72,
0,0,71,71,71,71,71,0,0,
70,0,70,70,70,70,70,0,70,
69,0,69,0,0,0,0,0,0,
65,0,65,65,65,65,65,65,65,
0,0,0,0,0,0,0,0,0,
0,0,0,0,0,0,0,0,0,
0,0,0,0,0,0,0,0,0.