[layer]
type=Tile Layer 1
data=
1,21,1,1,1,1,1,0,1,
1,21,1,1,1,1,1,0,0,
2,21,1,1,1,1,1,0,1,
10,0,0,0,2,0,21,0,1,
2,2,1,2,19,2,2,21,1,
0,21,1,2,2,10,2,0,1,
1,21,1,1,2,2,2,1,1,
1,21,1,1,2,2,2,0,1,
2,21,2,2,2,9,2,24,2,
1,1,1,21,2,2,0,0,1,
2,2,2,0,21,2,2,2,18,
1,1,1,1,21,1,0,1,0,
2,2,2,2,2,7,21,2,0,
0,0,19,21,1,0,0,0,0,
0,2,2,2,0,0,1,21,1,
1,0,0,0,1,1,1,21,0,
1,1,0,1,1,0,1,21,0,
0,18,0,0,0,0,21,0,2,
0,7,2,2,2,2,2,21,2,
2,2,2,2,2,2,9,21,2,
9,2,2,2,2,2,21,2,0,
10,2,1,1,1,21,1,1,1,
2,0,0,0,0,0,21,0,1,
2,21,1,2,2,2,2,24,1,
19,21,1,2,8,2,1,0,0,
2,21,1,2,2,2,2,2,1,
0,2,21,2,2,2,9,2,2,
0,21,1,1,0,2,2,0,1,
1,1,1,1,1,1,1,21,1,
0,1,2,2,2,1,21,0,0,
1,1,2,19,2,1,21,1,1,
0,1,2,2,2,1,21,1,1,
0,1,1,1,1,1,21,2,1,
0,0,21,0,0,0,0,10,1,
18,2,2,2,7,2,21,2,2,
20,2,2,0,21,2,0,2,0,
2,8,2,2,2,0,0,21,0,
0,2,2,9,2,2,21,2,2,
0,1,2,0,21,1,1,1,1,
0,0,0,0,21,0,1,1,1,
1,1,0,1,1,0,21,0,0,
2,2,2,21,2,7,2,2,0,
1,1,1,0,1,0,21,0,0,
1,1,1,21,0,1,1,1,0,
2,2,2,2,21,7,2,2,0,
1,21,1,1,1,2,19,2,1,
0,0,21,0,0,0,2,0,0,
2,2,1,1,1,2,2,21,1,
19,2,2,2,2,21,20,0,2,
2,2,1,1,1,2,2,21,1,
1,1,1,1,1,0,1,21,0,
0,0,0,0,0,0,0,0,0,
0,0,0,0,0,0,0,0,0,
0,0,0,0,0,0,0,0,0.
[layer]
type=Tile Layer 2
data=
234,0,234,234,234,234,234,0,234,
233,0,233,233,233,233,233,0,0,
231,0,231,231,231,231,231,0,231,
174,0,0,0,174,0,0,0,174,
159,159,159,159,0,159,159,0,159,
0,0,199,199,199,199,199,0,199,
175,0,175,175,175,175,175,175,175,
169,0,169,169,169,169,169,0,169,
155,0,155,155,155,155,155,0,155,
193,193,193,0,193,193,0,0,193,
179,179,179,0,0,179,179,179,0,
165,165,165,165,0,165,0,165,0,
150,150,150,150,150,150,0,150,0,
0,0,0,0,188,0,0,0,0,
0,174,174,174,0,0,174,0,174,
160,0,0,0,160,160,160,0,0,
146,146,0,146,146,0,146,0,0,
0,0,0,0,0,0,0,0,182,
0,168,168,168,168,168,168,0,168,
155,155,155,155,155,155,155,0,155,
142,142,142,142,142,142,0,142,0,
177,177,177,177,177,0,177,177,177,
163,0,0,0,0,0,0,0,163,
150,0,150,150,150,150,150,0,150,
0,0,137,137,137,137,137,0,0,
163,0,163,163,163,163,163,163,163,
0,158,0,158,158,158,158,158,158,
0,0,145,145,0,145,145,0,145,
127,127,127,127,127,127,127,0,127,
0,165,165,165,165,165,0,0,0,
153,153,153,0,153,153,0,153,153,
0,141,141,141,141,141,0,141,141,
0,128,128,128,128,128,0,128,128,
0,0,0,0,0,0,0,160,160,
0,148,148,148,148,148,0,148,148,
0,136,136,0,0,136,0,136,0,
124,124,124,124,124,0,0,0,0,
0,154,154,154,154,154,0,154,154,
0,142,142,0,0,142,142,142,142,
0,0,0,0,0,0,131,131,131,
120,120,0,120,120,0,0,0,0,
119,119,119,0,119,119,119,119,0,
108,108,108,0,108,0,0,0,0,
107,107,107,0,0,107,107,107,0,
106,106,106,106,0,106,106,106,0,
95,0,95,95,95,95,0,95,95,
0,0,0,0,0,0,94,0,0,
89,89,89,89,89,89,89,0,89,
0,92,92,92,92,0,0,0,92,
87,87,87,87,87,87,87,0,87,
90,90,90,90,90,0,90,0,0,
0,0,0,0,0,0,0,0,0,
0,0,0,0,0,0,0,0,0,
0,0,0,0,0,0,0,0,0.