[layer]
type=Tile Layer 1
data=
1,5,0,1,0,1,0,21,1,
1,3,1,6,0,1,21,1,1,
0,1,0,0,0,1,1,1,21,
0,1,1,1,3,5,0,3,21,
0,0,0,1,21,0,0,1,1,
1,1,4,6,21,4,1,1,0,
0,21,0,4,1,1,1,1,0,
1,1,0,21,0,6,0,0,0,
1,1,21,0,1,1,1,0,0,
0,21,4,6,0,1,1,1,0,
1,1,21,0,1,5,0,1,1,
1,21,0,5,1,0,0,1,1,
0,0,0,0,0,0,0,0,0,
0,0,0,0,0,0,0,0,0,
0,0,0,0,0,0,0,0,0.
[layer]
type=Tile Layer 2
data=
88,88,0,88,0,88,0,0,88,
59,59,59,59,0,59,0,59,59,
0,62,0,0,0,62,62,62,0,
0,61,61,61,61,61,0,61,0,
0,0,0,54,0,0,0,54,54,
50,50,50,50,0,50,50,50,0,
0,0,0,52,52,52,52,52,0,
51,51,0,0,0,51,0,0,0,
50,50,0,0,50,50,50,0,0,
0,0,49,49,0,49,49,49,0,
48,48,0,0,48,48,0,48,48,
47,0,0,47,47,0,0,47,47,
0,0,0,0,0,0,0,0,0,
0,0,0,0,0,0,0,0,0,
0,0,0,0,0,0,0,0,0.