[layer]
type=Tile Layer 1
data=
1,1,1,21,0,0,5,1,0,
5,1,6,1,1,3,21,0,1,
21,0,0,5,1,1,0,0,5,
1,1,3,0,5,1,1,3,21,
1,1,1,21,0,0,1,1,0,
21,0,0,1,6,4,0,0,0,
0,0,0,0,0,0,0,0,0,
0,0,0,0,0,0,0,0,0,
0,0,0,0,0,0,0,0,0.
[layer]
type=Tile Layer 2
data=
40,40,40,0,0,0,40,40,0,
35,35,35,35,35,35,0,0,35,
0,0,0,38,38,38,0,0,38,
34,34,34,0,34,34,34,34,0,
37,37,37,0,0,0,37,37,0,
0,0,0,36,36,36,0,0,0,
0,0,0,0,0,0,0,0,0,
0,0,0,0,0,0,0,0,0,
0,0,0,0,0,0,0,0,0.