[layer]
type=Tile Layer 1
data=
0,1,1,1,0,1,0,21,0,
0,1,1,1,0,1,21,1,1,
0,0,0,1,21,1,0,1,0,
0,1,1,1,1,1,21,1,1,
0,1,1,1,1,1,21,0,0,
0,1,1,1,1,1,21,1,1,
1,1,1,1,1,21,0,0,0,
1,1,1,1,1,21,1,1,0,
1,1,1,1,1,1,1,1,21,
1,1,1,1,1,0,21,0,0,
1,1,1,1,21,0,0,1,1,
1,1,1,1,0,1,21,0,0,
0,0,0,21,0,1,1,0,0,
0,1,21,0,0,0,0,0,1,
0,21,1,1,1,1,1,1,1,
0,1,1,1,21,1,1,1,1,
0,21,0,1,0,0,0,1,0,
1,1,21,1,1,1,0,1,0,
0,1,21,0,0,1,0,0,0,
0,1,1,1,21,1,0,1,1,
0,0,0,0,0,1,21,1,0,
0,0,0,0,0,0,0,0,0,
0,0,0,0,0,0,0,0,0,
0,0,0,0,0,0,0,0,0.
[layer]
type=Tile Layer 2
data=
0,133,133,133,0,133,0,0,0,
0,132,132,132,0,132,0,132,132,
0,0,0,130,0,130,0,130,0,
0,107,107,107,107,107,0,107,107,
0,104,104,104,104,104,0,0,0,
0,90,90,90,90,90,0,90,90,
86,86,86,86,86,0,0,0,0,
102,102,102,102,102,0,102,102,0,
89,89,89,89,89,89,89,89,0,
90,90,90,90,90,0,0,0,0,
82,82,82,82,0,0,0,82,82,
81,81,81,81,0,81,0,0,0,
0,0,0,0,0,73,73,0,0,
0,72,0,0,0,0,0,0,72,
0,0,67,67,67,67,67,67,67,
0,60,60,60,0,60,60,60,60,
0,0,0,62,0,0,0,62,0,
61,61,0,61,61,61,0,61,0,
0,60,0,0,0,60,0,0,0,
0,59,59,59,0,59,0,59,59,
0,0,0,0,0,58,0,58,0,
0,0,0,0,0,0,0,0,0,
0,0,0,0,0,0,0,0,0,
0,0,0,0,0,0,0,0,0.