[layer]
type=Tile Layer 1
data=
0,0,0,0,0,21,0,1,1,
0,1,1,1,4,6,21,5,1,
0,0,21,0,0,0,0,1,1,
3,1,1,1,1,21,0,0,1,
1,1,1,1,6,1,4,21,0,
1,1,1,4,1,0,0,21,0,
1,0,21,0,0,0,6,4,1,
1,21,1,1,1,6,5,1,1,
1,21,0,0,0,0,1,1,1,
4,1,1,1,1,21,0,0,0,
1,1,21,0,0,0,0,0,0,
1,5,21,6,1,1,1,1,4,
1,0,1,21,1,0,3,0,0,
1,0,1,21,1,0,1,5,1,
1,21,4,0,4,0,1,0,1,
1,0,1,21,1,0,4,0,6,
0,21,1,0,0,0,0,0,1,
5,4,1,1,1,1,21,1,1,
0,0,1,0,1,0,21,0,4,
1,0,1,0,3,21,1,0,1,
1,0,1,0,5,21,1,0,0,
0,0,0,21,0,1,0,1,5,
1,1,6,1,21,1,0,4,1,
1,1,1,1,21,1,0,1,4,
1,1,4,1,21,1,0,1,5,
6,1,1,1,0,4,21,1,0,
1,6,1,1,21,1,1,1,1,
0,0,0,21,0,1,0,0,0,
0,1,1,5,1,1,21,1,1,
0,21,0,0,0,0,0,1,4,
4,21,1,0,1,1,5,1,5,
3,0,1,0,0,0,1,21,0,
1,21,1,1,1,0,1,1,1,
1,0,1,4,1,0,0,21,0,
6,21,1,1,1,0,1,1,5,
1,0,1,21,0,0,0,0,0,
0,0,0,0,0,0,0,0,0,
0,0,0,0,0,0,0,0,0,
0,0,0,0,0,0,0,0,0.
[layer]
type=Tile Layer 2
data=
0,0,0,0,0,0,0,192,192,
0,191,191,191,191,191,0,191,191,
0,0,0,0,0,0,0,189,189,
153,153,153,153,153,0,0,0,153,
141,141,141,141,141,141,141,0,0,
129,129,129,129,129,0,0,0,0,
161,0,0,0,0,0,161,161,161,
141,0,141,141,141,141,141,141,141,
136,0,0,0,0,0,136,136,136,
124,124,124,124,124,0,0,0,0,
155,155,0,0,0,0,0,0,0,
136,136,0,136,136,136,136,136,136,
131,0,131,0,131,0,131,0,0,
120,0,120,0,120,0,120,120,120,
149,0,149,0,149,0,149,0,149,
138,0,138,0,138,0,138,0,138,
0,0,127,0,0,0,0,0,127,
110,110,110,110,110,110,0,110,110,
0,0,144,0,144,0,0,0,144,
133,0,133,0,133,0,133,0,133,
122,0,122,0,122,0,122,0,0,
0,0,0,0,0,111,0,111,111,
138,138,138,138,0,138,0,138,138,
127,127,127,127,0,127,0,127,127,
117,117,117,117,0,117,0,117,117,
107,107,107,107,0,107,0,107,0,
101,101,101,101,0,101,101,101,101,
0,0,0,0,0,96,0,0,0,
0,95,95,95,95,95,0,95,95,
0,0,0,0,0,0,0,94,94,
84,0,84,0,84,84,84,84,84,
83,0,83,0,0,0,83,0,0,
82,0,82,82,82,0,82,82,82,
81,0,81,81,81,0,0,0,0,
80,0,80,80,80,0,80,80,80,
79,0,79,0,0,0,0,0,0,
0,0,0,0,0,0,0,0,0,
0,0,0,0,0,0,0,0,0,
0,0,0,0,0,0,0,0,0.