[layer]
type=Tile Layer 1
data=
1,0,0,0,21,0,6,1,6,
3,3,3,5,3,21,6,6,1,
0,0,21,1,0,1,5,5,1,
0,1,21,0,0,0,3,6,1,
3,3,4,1,21,1,1,6,3,
4,4,6,0,0,21,1,1,1,
1,3,6,6,3,1,21,0,5,
5,1,3,1,5,5,1,21,5,
3,3,6,1,6,6,3,21,5,
4,3,0,0,0,4,0,21,0,
6,4,21,1,1,1,0,1,3,
3,6,0,4,21,0,0,6,0,
5,4,0,5,21,3,4,3,0,
0,1,0,1,0,1,0,0,21,
0,5,1,3,0,4,21,5,0,
0,0,0,0,0,5,0,3,21,
5,4,21,5,3,5,4,3,1,
1,1,21,4,4,5,3,1,0,
4,1,1,5,1,0,21,0,3,
5,4,3,3,4,5,5,21,1,
3,1,3,3,5,4,4,21,0,
6,0,0,0,0,0,21,0,0,
0,21,4,5,6,5,1,1,6,
0,0,0,21,0,4,4,1,5,
4,1,5,21,0,6,4,1,4,
5,1,6,0,0,21,0,5,5,
1,6,4,1,5,6,21,6,4,
5,4,3,3,4,1,5,21,0,
1,3,4,4,0,0,0,21,0,
5,1,5,1,21,5,3,4,1,
4,3,3,4,21,6,4,1,1,
1,4,4,6,21,0,0,1,6,
3,3,0,0,21,0,0,6,3,
4,21,0,6,5,1,4,1,4,
1,0,21,1,0,1,0,0,0,
5,4,1,6,5,5,6,6,21,
1,6,21,5,0,1,1,6,1,
0,6,1,1,0,21,1,3,0,
3,6,21,3,5,5,3,5,1,
4,4,21,5,0,0,0,1,0,
6,5,0,4,21,5,6,1,0,
0,1,0,6,0,21,0,0,0,
5,1,21,5,6,4,4,4,6,
0,0,0,0,21,0,0,5,6,
6,4,6,1,5,1,21,1,4,
4,1,1,1,6,21,0,0,5,
4,1,5,5,4,21,0,0,0,
5,6,6,4,6,21,6,4,0,
3,3,21,0,0,0,4,1,0,
1,21,1,1,4,3,0,4,5,
3,21,0,5,5,3,0,4,5,
0,0,0,0,0,0,0,0,0,
0,0,0,0,0,0,0,0,0,
0,0,0,0,0,0,0,0,0.
[layer]
type=Tile Layer 2
data=
234,0,0,0,0,0,234,234,234,
221,221,221,221,221,0,221,221,221,
0,0,0,11,0,11,185,231,231,
0,8,0,0,0,0,139,139,174,
127,127,127,7,0,7,127,127,127,
159,199,159,0,0,0,9,199,159,
184,184,147,147,147,147,0,0,184,
129,161,129,161,161,161,129,0,129,
147,147,147,147,147,147,147,0,147,
193,193,0,0,0,193,0,0,0,
179,179,0,179,179,179,0,179,179,
165,165,0,165,0,0,0,165,0,
150,150,0,150,0,150,150,150,0,
0,188,0,188,0,188,0,0,0,
0,174,174,174,0,174,0,174,0,
0,0,0,0,0,160,0,160,0,
139,139,0,139,139,139,139,139,139,
182,182,0,182,182,182,182,182,0,
168,168,168,168,168,0,0,0,168,
148,148,148,148,148,148,148,0,148,
142,142,142,142,142,142,142,0,0,
177,0,0,0,0,0,0,0,0,
0,0,163,163,163,163,163,163,163,
0,0,0,0,0,150,150,150,150,
137,137,137,0,0,137,137,137,137,
171,171,171,0,0,0,0,171,171,
151,151,151,151,151,151,0,151,151,
145,145,145,145,145,145,145,0,0,
133,133,133,133,0,0,0,0,0,
157,157,157,157,0,157,157,157,157,
146,146,146,146,0,146,146,146,146,
141,141,141,141,0,0,0,141,141,
128,128,0,0,0,0,0,128,128,
160,0,0,128,160,128,160,160,160,
148,0,0,7,0,7,0,0,0,
129,129,103,103,103,103,103,129,0,
6,99,0,99,0,99,99,99,99,
0,154,7,154,0,0,7,154,0,
114,114,0,114,142,114,114,114,7,
131,131,0,131,0,0,0,131,0,
120,120,0,120,0,120,120,120,0,
0,119,0,119,0,0,0,0,0,
103,103,0,103,103,103,103,103,103,
0,0,0,0,0,0,0,107,107,
101,101,101,101,101,101,0,101,101,
95,95,95,95,95,0,0,0,95,
94,94,94,94,94,0,0,0,0,
93,93,93,93,93,0,93,93,0,
92,92,0,0,0,0,92,92,0,
91,0,91,91,91,91,0,91,91,
90,0,0,90,90,90,0,90,90,
0,0,0,0,0,0,0,0,0,
0,0,0,0,0,0,0,0,0,
0,0,0,0,0,0,0,0,0.