[layer]
type=Tile Layer 1
data=
0,1,0,1,0,1,21,1,1,
0,1,0,21,0,1,0,1,0,
0,1,1,1,1,1,0,1,21,
0,1,0,0,21,1,0,1,0,
0,1,0,1,21,1,1,1,0,
0,0,0,1,0,1,0,21,0,
1,1,1,1,21,1,0,1,1,
0,21,0,1,0,0,0,1,0,
1,1,21,1,1,1,1,1,0,
0,1,1,0,21,0,1,1,0,
1,21,0,1,1,1,0,0,1,
1,21,1,0,0,0,1,0,1,
1,0,0,0,1,21,0,0,1,
0,0,1,1,1,1,1,0,21,
1,1,21,1,1,1,0,1,1,
0,0,0,0,0,0,0,0,0,
0,0,0,0,0,0,0,0,0,
0,0,0,0,0,0,0,0,0.
[layer]
type=Tile Layer 2
data=
0,123,0,123,0,123,0,123,123,
0,121,0,0,0,121,0,121,0,
0,119,119,119,119,119,0,119,0,
0,89,0,0,0,89,0,89,0,
0,81,0,81,0,81,81,81,0,
0,0,0,80,0,80,0,0,0,
68,68,68,68,0,68,0,68,68,
0,0,0,71,0,0,0,71,0,
66,66,0,66,66,66,66,66,0,
0,62,62,0,0,0,62,62,0,
61,0,0,61,61,61,0,0,61,
60,0,60,0,0,0,60,0,60,
59,0,0,0,59,0,0,0,59,
0,0,58,58,58,58,58,0,0,
55,55,0,55,55,55,0,55,55,
0,0,0,0,0,0,0,0,0,
0,0,0,0,0,0,0,0,0,
0,0,0,0,0,0,0,0,0.