[layer]
type=Tile Layer 1
data=
0,21,0,0,1,0,1,0,1,
1,0,1,1,1,21,1,0,1,
1,0,0,21,1,0,1,0,1,
1,1,1,1,0,1,1,21,0,
1,1,0,21,0,1,1,1,0,
1,1,21,0,1,1,1,1,0,
1,21,1,0,1,1,1,1,0,
1,0,21,0,1,1,1,0,0,
1,1,1,21,1,1,1,0,1,
1,1,1,0,21,0,0,1,1,
1,1,21,0,1,1,0,0,0,
1,1,0,1,1,0,0,21,0,
0,1,21,0,0,1,0,1,1,
1,1,21,1,1,1,0,1,1,
0,1,0,1,0,21,0,1,1,
1,1,21,1,0,1,1,1,1,
0,1,0,1,21,0,0,0,0,
0,1,21,1,1,1,1,1,1,
0,0,0,0,0,0,0,0,0,
0,0,0,0,0,0,0,0,0,
0,0,0,0,0,0,0,0,0.
[layer]
type=Tile Layer 2
data=
0,0,0,0,128,0,128,0,128,
127,0,127,127,127,0,127,0,127,
125,0,0,0,125,0,125,0,125,
86,86,86,86,0,86,86,0,0,
107,107,0,0,0,107,107,107,0,
98,98,0,0,98,98,98,98,0,
90,0,90,0,90,90,90,90,0,
82,0,0,0,82,82,82,0,0,
77,77,77,0,77,77,77,0,77,
73,73,73,0,0,0,0,73,73,
72,72,0,0,72,72,0,0,0,
71,71,0,71,71,0,0,0,0,
0,63,0,0,0,63,0,63,63,
59,59,0,59,59,59,0,59,59,
0,61,0,61,0,0,0,61,61,
57,57,0,57,0,57,57,57,57,
0,59,0,59,0,0,0,0,0,
0,56,0,56,56,56,56,56,56,
0,0,0,0,0,0,0,0,0,
0,0,0,0,0,0,0,0,0,
0,0,0,0,0,0,0,0,0.