[layer]
type=Tile Layer 1
data=
5,5,6,21,3,1,1,0,1,
0,0,0,21,5,0,0,0,0,
3,5,1,6,6,6,3,21,3,
3,1,4,0,21,0,0,0,1,
4,6,3,1,4,6,4,21,1,
3,4,3,21,6,1,3,0,6,
6,21,4,1,6,1,3,3,1,
4,21,6,1,4,6,1,1,1,
1,1,3,21,0,1,1,1,1,
3,21,1,1,1,0,6,3,5,
5,21,1,1,6,1,1,1,3,
3,6,6,21,6,5,5,5,3,
1,5,1,21,0,0,0,0,5,
5,3,6,1,3,21,6,3,1,
0,0,0,21,5,0,6,0,3,
6,21,0,0,1,0,5,0,0,
6,21,1,1,3,0,6,3,3,
5,0,0,0,0,21,5,0,5,
4,3,3,6,4,21,1,0,1,
6,0,0,21,0,0,0,0,6,
3,6,1,4,21,3,6,4,1,
1,0,0,0,0,0,21,0,4,
1,21,4,3,1,3,5,0,3,
5,0,0,21,0,0,4,0,5,
5,0,0,21,0,1,3,4,5,
1,5,0,0,21,0,0,0,0,
4,1,21,3,4,1,4,3,0,
3,6,6,21,0,0,0,0,0,
3,3,4,21,1,0,1,6,3,
4,21,0,4,1,6,1,4,6,
0,4,5,3,5,21,4,4,3,
0,5,3,1,1,21,4,5,1,
0,21,0,0,0,3,1,5,4,
0,21,5,1,1,5,6,1,0,
0,4,21,0,5,4,1,4,6,
0,21,4,6,0,0,0,5,6,
6,5,21,6,4,4,0,1,1,
4,6,0,0,0,0,21,0,5,
6,5,5,0,1,1,4,21,0,
0,0,0,0,0,0,0,0,0,
0,0,0,0,0,0,0,0,0,
0,0,0,0,0,0,0,0,0.
[layer]
type=Tile Layer 2
data=
197,197,197,0,197,197,197,0,197,
0,0,0,0,195,0,0,0,0,
184,184,184,184,184,184,184,0,184,
146,146,146,0,0,0,0,0,146,
127,127,127,127,127,127,127,0,127,
166,166,166,0,166,133,166,0,166,
153,0,153,7,153,7,153,153,153,
141,0,113,7,113,113,113,141,141,
6,6,103,0,0,6,6,6,6,
161,0,128,161,161,0,128,161,161,
118,0,7,7,148,7,118,118,118,
130,130,130,0,130,130,130,130,130,
124,124,124,0,0,0,0,0,124,
147,147,147,147,147,0,147,147,147,
0,0,0,0,143,0,143,0,143,
131,0,0,0,131,0,131,0,0,
120,0,120,120,120,0,120,120,120,
149,0,0,0,0,0,149,0,149,
138,138,138,138,138,0,138,0,138,
127,0,0,0,0,0,0,0,127,
110,110,110,110,0,110,110,110,110,
144,0,0,0,0,0,0,0,144,
133,0,133,133,133,133,133,0,133,
122,0,0,0,0,0,122,0,122,
111,0,0,0,0,111,111,111,111,
138,138,0,0,0,0,0,0,0,
127,127,0,127,127,127,127,127,0,
117,117,117,0,0,0,0,0,0,
107,107,107,0,107,0,107,107,107,
106,0,0,106,106,106,106,106,106,
0,96,96,96,96,0,96,96,96,
0,95,95,95,95,0,95,95,95,
0,0,0,0,0,94,94,94,94,
0,0,84,84,84,84,84,84,0,
0,83,0,0,83,83,83,83,83,
0,0,82,82,0,0,0,82,82,
81,81,0,81,81,81,0,81,81,
80,80,0,0,0,0,0,0,80,
79,79,79,0,79,79,79,0,0,
0,0,0,0,0,0,0,0,0,
0,0,0,0,0,0,0,0,0,
0,0,0,0,0,0,0,0,0.