[layer]
type=Tile Layer 1
data=
0,0,21,0,1,1,1,1,1,
0,1,1,21,0,1,1,1,1,
0,1,1,1,0,21,1,1,1,
0,0,1,1,0,21,1,1,1,
0,21,1,1,0,1,1,1,1,
0,1,1,1,0,0,0,21,1,
0,1,1,1,1,1,0,21,1,
0,0,1,1,1,1,0,21,0,
1,0,21,1,1,1,1,1,0,
1,0,21,0,1,0,1,1,1,
1,1,1,1,1,21,1,1,1,
0,21,0,0,0,0,0,0,1,
1,1,1,1,1,21,1,1,1,
1,1,1,1,1,21,1,1,1,
1,1,1,1,1,21,1,1,1,
0,0,0,0,21,0,1,0,0,
1,1,1,1,1,21,1,1,1,
1,0,21,0,1,0,1,0,0,
0,0,1,21,0,0,1,0,0,
1,1,1,0,1,21,1,0,1,
1,21,0,0,1,0,0,0,1,
1,21,1,1,1,1,1,1,1,
0,0,1,0,21,0,1,0,0,
1,1,1,21,1,1,1,0,1,
0,21,1,0,0,0,1,0,1,
1,21,1,0,1,0,1,0,1,
1,0,1,0,1,0,21,0,1,
0,1,21,1,1,1,0,1,1,
0,1,0,1,0,0,21,0,0,
0,1,21,1,1,1,1,1,1,
0,1,0,1,21,1,1,1,1,
0,1,21,1,1,1,1,1,1,
0,1,0,1,0,0,0,0,21,
0,0,0,0,0,0,0,0,0,
0,0,0,0,0,0,0,0,0,
0,0,0,0,0,0,0,0,0.
[layer]
type=Tile Layer 2
data=
0,0,0,0,170,170,170,170,170,
0,169,169,0,0,169,169,169,169,
0,167,167,167,0,0,167,167,167,
0,0,146,146,0,0,146,146,146,
0,0,134,134,0,134,134,134,134,
0,123,123,123,0,0,0,0,123,
0,112,112,112,112,112,0,0,112,
0,0,140,140,140,140,0,0,0,
129,0,0,129,129,129,129,129,0,
118,0,0,0,118,0,118,118,118,
103,103,103,103,103,0,103,103,103,
0,0,0,0,0,0,0,0,134,
118,118,118,118,118,0,118,118,118,
108,108,108,108,108,0,108,108,108,
99,99,99,99,99,0,99,99,99,
0,0,0,0,0,0,129,0,0,
113,113,113,113,113,0,113,113,113,
109,0,0,0,109,0,109,0,0,
0,0,99,0,0,0,99,0,0,
123,123,123,0,123,0,123,0,123,
113,0,0,0,113,0,0,0,113,
99,0,99,99,99,99,99,99,99,
0,0,95,0,0,0,95,0,0,
94,94,94,0,94,94,94,0,94,
0,0,85,0,0,0,85,0,85,
84,0,84,0,84,0,84,0,84,
83,0,83,0,83,0,0,0,83,
0,74,0,74,74,74,0,74,74,
0,73,0,73,0,0,0,0,0,
0,72,0,72,72,72,72,72,72,
0,71,0,71,0,71,71,71,71,
0,70,0,70,70,70,70,70,70,
0,69,0,69,0,0,0,0,0,
0,0,0,0,0,0,0,0,0,
0,0,0,0,0,0,0,0,0,
0,0,0,0,0,0,0,0,0.