[layer]
type=Tile Layer 1
data=
1,21,0,1,1,1,0,0,0,
1,1,21,1,1,1,1,1,0,
0,0,21,1,1,1,1,1,1,
0,21,0,1,1,1,1,1,1,
1,1,1,1,21,1,1,0,1,
0,21,0,0,0,0,0,1,1,
0,1,1,1,1,1,21,1,1,
1,0,1,1,1,1,1,21,0,
1,0,0,0,0,0,0,21,0,
1,1,1,1,1,0,21,0,1,
1,1,1,1,1,21,1,0,1,
1,1,1,1,1,0,1,21,0,
1,1,1,1,21,0,0,0,0,
0,0,21,0,0,1,0,0,1,
0,0,1,1,1,1,1,21,1,
1,0,0,21,1,1,1,0,1,
1,0,1,21,1,1,1,0,1,
1,21,0,1,1,1,1,0,1,
1,1,1,1,1,21,1,1,1,
1,0,0,0,0,0,1,21,0,
1,1,1,21,1,1,1,0,1,
0,21,0,0,1,0,0,0,1,
1,21,1,1,1,0,1,1,1,
1,0,0,21,1,0,0,0,0,
1,1,1,21,1,1,1,1,1,
0,0,0,0,1,0,1,21,0,
1,1,1,1,1,21,1,0,1,
1,1,1,1,21,1,0,0,0,
1,1,1,1,0,1,21,1,0,
1,1,1,1,21,1,0,1,0,
1,1,1,1,21,1,1,1,1,
0,1,0,0,0,0,21,0,0,
21,1,1,1,1,1,1,1,1,
0,1,1,1,21,1,1,1,1,
0,1,1,1,21,1,1,1,1,
0,0,21,0,0,1,0,0,0,
1,1,1,1,1,21,1,1,1,
0,0,1,0,1,21,1,1,1,
1,1,1,21,1,0,1,1,1,
1,0,21,0,1,0,1,0,0,
1,21,1,1,1,1,1,1,1,
1,21,1,1,1,0,1,1,1,
0,0,0,0,0,0,0,0,0,
0,0,0,0,0,0,0,0,0,
0,0,0,0,0,0,0,0,0.
[layer]
type=Tile Layer 2
data=
203,0,0,203,203,203,0,0,0,
201,201,0,201,201,201,201,201,0,
0,0,0,200,200,200,200,200,200,
0,0,0,138,138,138,138,138,138,
173,173,173,173,0,173,173,0,173,
0,0,0,0,0,0,0,160,160,
0,147,147,147,147,147,0,147,147,
134,0,134,134,134,134,134,0,0,
167,0,0,0,0,0,0,0,0,
154,154,154,154,154,0,0,0,154,
142,142,142,142,142,0,142,0,142,
130,130,130,130,130,0,130,0,0,
162,162,162,162,0,0,0,0,0,
0,0,0,0,0,149,0,0,149,
0,0,137,137,137,137,137,0,137,
125,0,0,0,125,125,125,0,125,
156,0,156,0,156,156,156,0,156,
144,0,0,144,144,144,144,0,144,
126,126,126,126,126,0,126,126,126,
121,0,0,0,0,0,121,0,0,
150,150,150,0,150,150,150,0,150,
0,0,0,0,139,0,0,0,139,
128,0,128,128,128,0,128,128,128,
116,0,0,0,116,0,0,0,0,
138,138,138,0,138,138,138,138,138,
0,0,0,0,134,0,134,0,0,
123,123,123,123,123,0,123,0,123,
112,112,112,112,0,112,0,0,0,
139,139,139,139,0,139,0,139,0,
128,128,128,128,0,128,0,128,0,
112,112,112,112,0,112,112,112,112,
0,108,0,0,0,0,0,0,0,
0,102,102,102,102,102,102,102,102,
0,97,97,97,0,97,97,97,97,
0,96,96,96,0,96,96,96,96,
0,0,0,0,0,95,0,0,0,
81,81,81,81,81,0,81,81,81,
0,0,84,0,84,0,84,84,84,
83,83,83,0,83,0,83,83,83,
82,0,0,0,82,0,82,0,0,
78,0,78,78,78,78,78,78,78,
80,0,80,80,80,0,80,80,80,
0,0,0,0,0,0,0,0,0,
0,0,0,0,0,0,0,0,0,
0,0,0,0,0,0,0,0,0.