[layer]
type=Tile Layer 1
data=
0,1,1,1,1,1,21,1,1,
0,1,1,1,1,1,21,0,1,
0,5,1,1,6,0,0,21,1,
1,0,0,0,21,1,1,0,1,
1,1,1,1,0,0,21,0,1,
1,1,1,1,1,1,3,21,5,
0,1,0,1,1,1,21,1,0,
0,1,0,0,1,0,1,0,21,
1,1,1,1,1,1,0,21,1,
0,0,0,21,1,0,0,0,1,
0,1,1,1,1,1,1,21,0,
1,0,21,1,1,1,0,1,0,
0,0,0,0,0,0,0,0,0,
0,0,0,0,0,0,0,0,0,
0,0,0,0,0,0,0,0,0.
[layer]
type=Tile Layer 2
data=
0,84,84,84,84,84,0,84,84,
0,63,63,63,63,63,0,0,63,
0,62,62,62,62,0,0,0,62,
61,0,0,0,0,61,61,0,61,
54,54,54,54,0,0,0,0,54,
48,48,48,48,48,48,48,0,48,
0,52,0,52,52,52,0,52,0,
0,51,0,0,51,0,51,0,0,
48,48,48,48,48,48,0,0,48,
0,0,0,0,49,0,0,0,49,
0,48,48,48,48,48,48,0,0,
47,0,0,47,47,47,0,47,0,
0,0,0,0,0,0,0,0,0,
0,0,0,0,0,0,0,0,0,
0,0,0,0,0,0,0,0,0.