[layer]
type=Tile Layer 1
data=
0,2,2,2,1,1,21,1,1,
1,2,24,2,0,21,0,0,0,
1,7,0,2,2,2,2,2,21,
0,2,21,2,0,0,0,1,1,
0,1,20,1,21,2,0,2,1,
0,2,0,0,0,2,20,2,21,
0,1,1,21,0,0,0,24,1,
2,2,2,2,2,21,0,7,2,
1,1,2,10,21,0,1,2,1,
0,1,2,2,0,0,0,21,1,
1,0,0,2,2,1,0,0,21,
1,21,2,10,2,1,1,0,1,
0,0,0,0,0,0,0,0,0,
0,0,0,0,0,0,0,0,0,
0,0,0,0,0,0,0,0,0.
[layer]
type=Tile Layer 2
data=
0,84,84,84,84,84,0,84,84,
63,63,0,63,0,0,0,0,0,
62,62,0,62,62,62,62,62,0,
0,61,0,61,0,0,0,61,61,
0,54,0,54,0,54,0,54,54,
0,53,0,0,0,53,0,53,0,
0,52,52,0,0,0,0,0,52,
51,51,51,51,51,0,0,51,51,
50,50,50,50,0,0,50,50,50,
0,49,49,49,0,0,0,0,49,
48,0,0,48,48,48,0,0,0,
47,0,47,47,47,47,47,0,47,
0,0,0,0,0,0,0,0,0,
0,0,0,0,0,0,0,0,0,
0,0,0,0,0,0,0,0,0.