[layer]
type=Tile Layer 1
data=
6,0,0,1,0,21,0,1,1,
4,0,5,0,21,1,0,1,1,
1,21,1,1,0,1,4,1,1,
0,21,3,1,0,4,1,6,1,
0,21,0,0,0,0,1,1,0,
1,1,1,21,0,0,0,0,0,
1,1,1,1,1,1,21,1,0,
0,21,0,1,5,5,0,1,0,
1,1,3,1,1,4,21,1,0,
3,4,21,1,1,6,0,1,0,
1,6,21,1,1,1,0,1,0,
1,1,0,0,0,0,21,0,0,
1,1,21,3,1,5,1,1,1,
0,21,0,1,3,1,0,0,1,
4,4,21,1,1,1,1,1,1,
21,1,1,1,5,1,1,1,1,
0,0,0,0,0,1,0,21,0,
1,1,3,4,21,1,0,1,4,
0,4,0,21,0,1,0,0,0,
0,1,0,1,5,1,0,1,21,
0,21,0,1,0,0,0,1,0,
21,3,1,4,1,1,6,1,1,
0,0,0,1,21,0,1,0,0,
1,0,1,1,1,21,3,1,0,
1,3,5,21,6,1,1,1,1,
1,1,1,0,0,0,0,21,0,
1,1,5,1,1,21,3,1,1,
0,0,0,0,0,0,1,0,21,
1,0,4,1,1,21,1,0,6,
5,0,1,1,1,21,1,0,1,
0,0,0,0,0,0,0,0,0,
0,0,0,0,0,0,0,0,0,
0,0,0,0,0,0,0,0,0.
[layer]
type=Tile Layer 2
data=
166,0,0,166,0,0,0,166,166,
164,0,164,0,0,164,0,164,164,
162,0,162,162,0,162,162,162,162,
0,0,112,112,0,112,112,112,112,
0,0,0,0,0,0,140,140,0,
129,129,129,0,0,0,0,0,0,
118,118,118,118,118,118,0,118,0,
0,0,0,108,108,108,0,108,0,
134,134,134,134,134,134,0,134,0,
124,124,0,124,124,124,0,124,0,
114,114,0,114,114,114,0,114,0,
103,103,0,0,0,0,0,0,0,
123,123,0,123,123,123,123,123,123,
0,0,0,119,119,119,0,0,119,
104,104,0,104,104,104,104,104,104,
0,94,94,94,94,94,94,94,94,
0,0,0,0,0,123,0,0,0,
113,113,113,113,0,113,0,113,113,
0,104,0,0,0,104,0,0,0,
0,95,0,95,95,95,0,95,0,
0,0,0,94,0,0,0,94,0,
0,81,81,81,81,81,81,81,81,
0,0,0,84,0,0,84,0,0,
83,0,83,83,83,0,83,83,0,
70,70,70,0,70,70,70,70,70,
73,73,73,0,0,0,0,0,0,
69,69,69,69,69,0,69,69,69,
0,0,0,0,0,0,71,0,0,
70,0,70,70,70,0,70,0,70,
69,0,69,69,69,0,69,0,69,
0,0,0,0,0,0,0,0,0,
0,0,0,0,0,0,0,0,0,
0,0,0,0,0,0,0,0,0.