[layer]
type=Tile Layer 1
data=
0,1,0,21,5,4,1,6,1,
0,21,0,0,0,0,1,1,1,
0,1,1,0,0,21,4,1,1,
1,1,1,5,21,3,0,1,1,
1,1,1,1,21,1,0,1,4,
1,1,3,1,21,1,0,1,5,
6,0,0,0,0,0,21,0,1,
4,21,1,6,1,1,1,0,1,
1,21,1,1,1,1,1,0,5,
1,21,0,0,1,1,0,6,1,
5,3,1,0,1,1,0,21,0,
1,1,1,0,0,21,0,0,0,
1,21,1,1,1,0,5,0,1,
3,0,0,21,0,0,4,0,1,
1,21,1,3,1,1,1,0,1,
1,0,1,0,0,0,21,0,1,
1,1,1,21,5,6,1,1,1,
0,0,0,21,1,0,0,0,4,
1,1,1,3,6,21,1,0,1,
3,0,0,0,0,21,1,0,1,
4,1,1,21,1,1,1,0,1,
1,1,0,1,21,1,0,1,1,
1,1,21,1,0,5,0,1,4,
1,1,0,3,21,1,0,3,1,
0,1,0,1,0,1,0,0,21,
1,6,1,4,21,1,4,1,0,
1,1,1,1,0,1,21,3,0,
1,1,1,1,21,1,0,1,1,
1,1,1,1,0,6,21,0,0,
3,1,5,3,21,1,1,6,1,
0,0,4,0,0,0,0,0,21,
1,1,1,1,21,1,5,5,1,
0,1,1,1,0,1,6,1,21,
21,1,1,4,1,1,1,1,1,
0,0,21,0,0,1,0,0,0,
1,1,3,4,0,1,21,6,0,
0,0,0,0,0,0,0,0,0,
0,0,0,0,0,0,0,0,0,
0,0,0,0,0,0,0,0,0.
[layer]
type=Tile Layer 2
data=
0,176,0,0,176,176,176,176,176,
0,0,0,0,0,0,175,175,175,
0,173,173,0,0,0,173,173,173,
140,140,140,140,0,140,0,140,140,
129,129,129,129,0,129,0,129,129,
118,118,118,118,0,118,0,118,118,
147,0,0,0,0,0,0,0,147,
135,0,135,135,135,135,135,0,135,
124,0,124,124,124,124,124,0,124,
113,0,0,0,113,113,0,113,113,
141,141,141,0,141,141,0,0,0,
130,130,130,0,0,0,0,0,0,
119,0,119,119,119,0,119,0,119,
109,0,0,0,0,0,109,0,109,
135,0,135,135,135,135,135,0,135,
125,0,125,0,0,0,0,0,125,
109,109,109,0,109,109,109,109,109,
0,0,0,0,104,0,0,0,104,
130,130,130,130,130,0,130,0,130,
120,0,0,0,0,0,120,0,120,
110,110,110,0,110,110,110,0,110,
100,100,0,100,0,100,0,100,100,
124,124,0,124,0,124,0,124,124,
114,114,0,114,0,114,0,114,114,
0,105,0,105,0,105,0,0,0,
96,96,96,96,0,96,96,96,0,
95,95,95,95,0,95,0,95,0,
86,86,86,86,0,86,0,86,86,
85,85,85,85,0,85,0,0,0,
80,80,80,80,0,80,80,80,80,
0,0,75,0,0,0,0,0,0,
71,71,71,71,0,71,71,71,71,
0,73,73,73,0,73,73,73,0,
0,69,69,69,69,69,69,69,69,
0,0,0,0,0,71,0,0,0,
70,70,70,70,0,70,0,70,0,
0,0,0,0,0,0,0,0,0,
0,0,0,0,0,0,0,0,0,
0,0,0,0,0,0,0,0,0.