[layer]
type=Tile Layer 1
data=
0,21,1,1,1,4,1,1,1,
5,0,0,0,0,0,0,21,0,
1,1,3,1,1,1,3,1,21,
1,3,1,21,1,1,3,5,5,
1,1,1,0,1,0,21,0,0,
1,1,1,21,1,4,1,1,1,
0,0,21,0,0,0,0,0,1,
1,21,2,1,1,0,4,3,1,
2,20,2,2,2,0,2,21,0,
1,21,2,2,2,1,1,1,4,
0,0,0,19,2,5,0,0,21,
1,1,2,21,2,1,2,24,1,
0,1,1,1,1,2,2,2,21,
2,2,0,2,2,21,20,0,0,
0,1,1,4,3,2,2,2,21,
0,21,0,0,1,0,0,0,0,
18,2,2,2,2,2,2,2,21,
0,0,21,0,1,1,0,4,1,
0,0,0,0,0,0,0,0,0,
0,0,0,0,0,0,0,0,0,
0,0,0,0,0,0,0,0,0.
[layer]
type=Tile Layer 2
data=
0,0,122,122,122,122,122,122,122,
127,0,0,0,0,0,0,0,0,
113,113,113,113,113,113,113,113,0,
78,78,78,0,78,78,78,78,78,
107,107,107,0,107,0,0,0,0,
89,89,89,0,89,89,89,89,89,
0,0,0,0,0,0,0,0,90,
78,0,78,78,78,0,78,78,78,
81,0,81,81,81,0,81,0,0,
66,0,66,66,66,66,66,66,66,
0,0,0,0,72,72,0,0,0,
67,67,67,0,67,67,67,0,67,
0,60,60,60,60,60,60,60,0,
62,62,0,62,62,0,0,0,0,
0,58,58,58,58,58,58,58,0,
0,0,0,0,60,0,0,0,0,
0,57,57,57,57,57,57,57,0,
0,0,0,0,58,58,0,58,58,
0,0,0,0,0,0,0,0,0,
0,0,0,0,0,0,0,0,0,
0,0,0,0,0,0,0,0,0.