[layer]
type=Tile Layer 1
data=
1,1,1,1,1,1,1,1,21,
0,0,0,0,0,0,21,1,0,
1,1,1,1,21,1,0,1,0,
0,0,0,21,1,1,1,1,1,
1,0,1,21,0,1,1,1,1,
1,21,0,1,0,0,0,0,0,
1,1,0,0,1,21,0,0,0,
1,1,1,21,1,0,1,1,1,
1,1,1,1,1,0,1,21,0,
1,1,1,1,1,21,0,1,0,
1,1,1,1,1,1,21,1,0,
1,1,1,1,1,1,21,1,0,
1,1,1,1,21,1,1,1,1,
1,1,1,1,21,1,1,1,1,
0,1,0,21,0,0,0,1,0,
0,1,1,1,1,1,21,1,1,
0,1,1,1,1,1,0,0,21,
0,1,1,1,1,1,21,1,1,
0,0,0,21,0,1,0,0,0,
1,1,21,1,0,1,1,1,0,
1,1,21,1,0,1,1,1,0,
1,0,21,1,1,0,0,1,1,
1,21,1,0,0,1,1,1,1,
1,0,1,1,0,0,21,0,1,
1,0,0,21,0,0,0,0,1,
1,1,21,1,0,1,1,1,1,
1,1,21,1,0,1,1,1,1,
0,0,0,0,0,0,0,0,0,
0,0,0,0,0,0,0,0,0,
0,0,0,0,0,0,0,0,0.
[layer]
type=Tile Layer 2
data=
152,152,152,152,152,152,152,152,0,
0,0,0,0,0,0,0,158,0,
157,157,157,157,0,157,0,157,0,
0,0,0,0,117,117,117,117,117,
107,0,107,0,0,107,107,107,107,
133,0,0,133,0,0,0,0,0,
123,123,0,0,123,0,0,0,0,
113,113,113,0,113,0,113,113,113,
102,102,102,102,102,0,102,0,0,
128,128,128,128,128,0,0,128,0,
118,118,118,118,118,118,0,118,0,
108,108,108,108,108,108,0,108,0,
93,93,93,93,0,93,93,93,93,
116,116,116,116,0,116,116,116,116,
0,112,0,0,0,0,0,112,0,
0,103,103,103,103,103,0,103,103,
0,94,94,94,94,94,0,0,0,
0,93,93,93,93,93,0,93,93,
0,0,0,0,0,84,0,0,0,
83,83,0,83,0,83,83,83,0,
82,82,0,82,0,82,82,82,0,
73,0,0,73,73,0,0,73,73,
72,0,72,0,0,72,72,72,72,
71,0,71,71,0,0,0,0,71,
70,0,0,0,0,0,0,0,70,
69,69,0,69,0,69,69,69,69,
68,68,0,68,0,68,68,68,68,
0,0,0,0,0,0,0,0,0,
0,0,0,0,0,0,0,0,0,
0,0,0,0,0,0,0,0,0.