[layer]
type=Tile Layer 1
data=
1,1,1,1,1,0,21,0,1,
1,1,1,1,1,1,1,21,1,
0,1,1,0,0,0,0,21,1,
1,21,1,1,1,1,1,0,1,
1,21,1,1,1,1,1,0,1,
1,21,1,1,1,1,1,0,1,
1,0,1,21,0,0,0,0,1,
1,0,1,1,1,21,1,0,1,
1,21,1,1,1,0,1,0,1,
1,1,0,0,21,0,1,0,0,
1,1,1,1,1,0,0,21,0,
1,1,1,1,1,1,1,1,21,
1,1,1,1,1,1,21,0,0,
1,1,1,0,21,0,0,1,1,
1,1,1,21,1,1,1,1,1,
1,1,1,0,0,21,0,0,1,
1,1,0,0,1,1,1,21,0,
1,1,21,0,0,0,0,0,0,
0,1,1,1,1,1,21,0,0,
0,1,1,1,1,1,21,1,1,
0,0,0,1,0,0,21,0,0,
1,1,0,1,21,1,1,1,0,
1,1,0,1,21,1,1,1,0,
1,1,21,1,1,1,1,1,0,
1,1,21,1,0,1,1,1,0,
1,1,0,1,21,1,1,1,0,
0,1,0,0,21,0,0,1,0,
1,1,1,1,1,0,21,0,0,
1,1,1,1,1,21,1,1,0,
1,1,1,1,1,0,0,21,0,
1,1,1,1,1,21,1,1,0,
1,1,1,1,0,0,0,21,0,
1,1,0,21,0,0,0,1,1,
0,0,0,0,0,0,0,0,0,
0,0,0,0,0,0,0,0,0,
0,0,0,0,0,0,0,0,0.
[layer]
type=Tile Layer 2
data=
171,171,171,171,171,0,0,0,171,
162,162,162,162,162,162,162,0,162,
0,168,168,0,0,0,0,0,168,
147,0,147,147,147,147,147,0,147,
135,0,135,135,135,135,135,0,135,
124,0,124,124,124,124,124,0,124,
113,0,113,0,0,0,0,0,113,
141,0,141,141,141,0,141,0,141,
130,0,130,130,130,0,130,0,130,
119,119,0,0,0,0,119,0,0,
109,109,109,109,109,0,0,0,0,
129,129,129,129,129,129,129,129,0,
125,125,125,125,125,125,0,0,0,
115,115,115,0,0,0,0,115,115,
100,100,100,0,100,100,100,100,100,
130,130,130,0,0,0,0,0,130,
120,120,0,0,120,120,120,0,0,
110,110,0,0,0,0,0,0,0,
0,100,100,100,100,100,0,0,0,
0,124,124,124,124,124,0,124,124,
0,0,0,114,0,0,0,0,0,
105,105,0,105,0,105,105,105,0,
96,96,0,96,0,96,96,96,0,
95,95,0,95,95,95,95,95,0,
86,86,0,86,0,86,86,86,0,
85,85,0,85,0,85,85,85,0,
0,84,0,0,0,0,0,84,0,
75,75,75,75,75,0,0,0,0,
74,74,74,74,74,0,74,74,0,
73,73,73,73,73,0,0,0,0,
72,72,72,72,72,0,72,72,0,
71,71,71,71,0,0,0,0,0,
70,70,0,0,0,0,0,70,70,
0,0,0,0,0,0,0,0,0,
0,0,0,0,0,0,0,0,0,
0,0,0,0,0,0,0,0,0.