[layer]
type=Tile Layer 1
data=
0,1,1,1,0,1,1,1,21,
0,1,21,0,0,1,1,1,0,
0,1,1,1,21,1,1,1,1,
0,1,1,1,1,1,1,1,21,
0,0,21,1,1,1,1,1,0,
1,1,0,1,1,21,0,0,0,
1,1,21,0,0,0,1,1,1,
0,21,0,0,0,0,0,1,1,
0,0,1,1,1,1,21,1,1,
1,21,1,1,1,1,0,1,1,
1,0,21,1,1,1,0,1,1,
1,1,21,1,1,1,0,1,1,
0,21,0,0,0,1,0,1,1,
0,1,1,1,0,1,21,1,1,
0,1,1,1,0,1,0,0,21,
1,1,1,1,21,1,1,1,1,
0,1,1,1,0,1,0,0,21,
0,1,1,1,21,1,0,1,0,
0,0,0,0,0,0,0,0,0,
0,0,0,0,0,0,0,0,0,
0,0,0,0,0,0,0,0,0.
[layer]
type=Tile Layer 2
data=
0,128,128,128,0,128,128,128,0,
0,127,0,0,0,127,127,127,0,
0,119,119,119,0,119,119,119,119,
0,82,82,82,82,82,82,82,0,
0,0,0,107,107,107,107,107,0,
98,98,0,98,98,0,0,0,0,
90,90,0,0,0,0,90,90,90,
0,0,0,0,0,0,0,82,82,
0,0,81,81,81,81,0,81,81,
69,0,69,69,69,69,0,69,69,
72,0,0,72,72,72,0,72,72,
67,67,0,67,67,67,0,67,67,
0,0,0,0,0,63,0,63,63,
0,62,62,62,0,62,0,62,62,
0,61,61,61,0,61,0,0,0,
55,55,55,55,0,55,55,55,55,
0,59,59,59,0,59,0,0,0,
0,58,58,58,0,58,0,58,0,
0,0,0,0,0,0,0,0,0,
0,0,0,0,0,0,0,0,0,
0,0,0,0,0,0,0,0,0.