[layer]
type=Tile Layer 1
data=
5,21,1,1,1,1,1,6,1,
2,0,21,18,2,2,2,2,2,
2,2,2,21,2,2,2,9,2,
0,0,0,5,21,2,2,2,1,
2,2,1,1,21,2,8,2,1,
20,0,0,0,0,2,21,0,0,
18,2,2,2,2,2,2,7,21,
1,2,8,2,0,0,0,1,21,
0,10,2,2,0,3,21,1,0,
0,2,2,1,0,1,21,1,0,
0,1,4,3,21,1,1,1,0,
0,21,0,1,0,0,0,0,0,
1,1,3,1,0,1,21,0,0,
5,1,1,2,2,21,0,0,1,
2,2,1,2,8,0,21,0,2,
9,2,2,2,2,21,2,0,20,
2,2,1,6,2,24,21,2,0,
5,1,1,1,1,1,21,0,2,
1,1,6,0,0,0,0,21,19,
5,1,1,0,0,0,21,0,0,
2,2,2,2,2,2,20,21,0,
2,2,2,2,21,2,9,2,2,
1,1,6,1,1,21,0,2,1,
0,0,0,0,0,21,0,19,5,
0,2,0,21,2,1,2,2,6,
9,2,21,24,2,2,2,2,2,
2,10,0,0,21,0,2,2,1,
2,2,18,0,21,2,9,2,2,
1,2,2,0,0,21,2,2,1,
2,9,2,2,2,2,21,2,2,
1,0,2,1,1,0,21,0,1,
1,21,1,1,1,0,1,1,4,
0,21,3,0,0,0,6,0,0,
1,1,5,21,4,1,1,0,1,
0,0,0,0,0,0,2,21,1,
2,21,2,2,2,2,2,20,2,
1,21,1,1,4,0,2,0,0,
1,21,2,2,1,0,5,1,1,
0,21,8,2,1,0,1,6,1,
2,20,2,2,2,21,0,0,2,
6,21,2,5,1,0,1,1,1,
0,2,2,2,7,2,2,2,21,
0,1,1,1,1,1,1,2,21,
0,0,21,0,2,1,1,2,24,
6,3,2,24,0,0,0,21,0,
0,0,0,0,0,0,0,0,0,
0,0,0,0,0,0,0,0,0,
0,0,0,0,0,0,0,0,0.
[layer]
type=Tile Layer 2
data=
198,0,198,198,198,198,198,198,198,
206,0,0,0,206,206,206,206,206,
204,204,204,0,204,204,204,204,204,
0,0,0,178,0,178,178,178,178,
165,165,165,165,0,165,165,165,165,
0,0,0,0,0,152,0,0,0,
0,138,138,138,138,138,138,138,0,
173,173,173,173,0,0,0,173,0,
0,160,160,160,0,160,0,160,0,
0,147,147,147,0,147,0,147,0,
0,134,134,134,0,134,134,134,0,
0,0,0,167,0,0,0,0,0,
154,154,154,154,0,154,0,0,0,
142,142,142,142,142,0,0,0,142,
130,130,130,130,130,0,0,0,130,
162,162,162,162,162,0,162,0,0,
149,149,149,149,149,0,0,149,0,
137,137,137,137,137,137,0,0,137,
125,125,125,0,0,0,0,0,0,
156,156,156,0,0,0,0,0,0,
144,144,144,144,144,144,0,0,0,
132,132,132,132,0,132,132,132,132,
121,121,121,121,121,0,0,121,121,
0,0,0,0,0,0,0,0,150,
0,139,0,0,139,139,139,139,139,
128,128,0,0,128,128,128,128,128,
116,116,0,0,0,0,116,116,116,
145,145,0,0,0,145,145,145,145,
134,134,134,0,0,0,134,134,134,
123,123,123,123,123,123,0,123,123,
112,0,112,112,112,0,0,0,112,
139,0,139,139,139,0,139,139,139,
0,0,128,0,0,0,128,0,0,
118,118,118,0,118,118,118,0,118,
0,0,0,0,0,0,108,0,108,
107,0,107,107,107,107,107,0,107,
97,0,97,97,97,0,97,0,0,
96,0,96,96,96,0,96,96,96,
0,0,95,95,95,0,95,95,95,
85,0,85,85,85,0,0,0,85,
84,0,84,84,84,0,84,84,84,
0,83,83,83,83,83,83,83,0,
0,82,82,82,82,82,82,82,0,
0,0,0,0,81,81,81,81,0,
80,80,80,0,0,0,0,0,0,
0,0,0,0,0,0,0,0,0,
0,0,0,0,0,0,0,0,0,
0,0,0,0,0,0,0,0,0.