[layer]
type=Tile Layer 1
data=
0,1,21,1,1,1,0,1,0,
3,0,1,0,1,0,1,21,4,
1,0,1,1,1,1,21,0,1,
6,21,1,0,1,1,1,0,5,
0,1,0,21,1,1,1,1,0,
0,0,0,0,0,0,0,0,0,
0,0,0,0,0,0,0,0,0,
0,0,0,0,0,0,0,0,0,
0,0,0,0,0,0,0,0,0.
[layer]
type=Tile Layer 2
data=
0,39,0,39,39,39,0,39,0,
38,0,38,0,38,0,38,0,38,
36,0,36,36,36,36,0,0,36,
35,0,35,0,35,35,35,0,35,
0,36,0,0,36,36,36,36,0,
0,0,0,0,0,0,0,0,0,
0,0,0,0,0,0,0,0,0,
0,0,0,0,0,0,0,0,0,
0,0,0,0,0,0,0,0,0.