[layer]
type=Tile Layer 1
data=
0,1,1,1,1,1,1,1,0,
0,1,1,1,1,1,1,1,0,
1,1,1,1,1,1,1,1,1,
1,1,1,1,1,1,1,1,1,
1,1,1,1,1,1,1,1,0,
0,1,1,1,1,1,1,0,0,
0,0,0,1,0,1,0,0,0,
0,0,1,1,0,1,1,0,0,
0,1,0,0,0,0,0,1,0,
1,0,0,1,1,1,0,0,1,
1,0,1,0,0,0,1,0,1,
0,0,0,0,0,0,0,0,0,
0,0,0,0,0,0,0,0,0,
0,0,0,0,0,0,0,0,0,
0,0,0,0,0,0,0,0,0.
[layer]
type=Tile Layer 2
data=
0,68,68,68,68,68,68,68,0,
0,49,49,49,49,49,49,49,0,
52,2,2,2,2,2,2,2,52,
47,2,47,47,47,47,47,47,47,
47,2,2,2,2,2,2,2,0,
0,47,47,47,47,47,47,0,0,
0,0,0,2,0,2,0,0,0,
0,0,2,2,0,2,2,0,0,
0,2,0,0,0,0,0,2,0,
2,0,0,47,47,47,0,0,2,
2,0,37,0,0,0,37,0,47,
0,0,0,0,0,0,0,0,0,
0,0,0,0,0,0,0,0,0,
0,0,0,0,0,0,0,0,0,
0,0,0,0,0,0,0,0,0.