[layer]
type=Tile Layer 1
data=
0,1,1,1,1,1,21,1,1,
21,1,1,1,1,1,1,1,1,
0,21,1,0,0,1,0,1,0,
21,1,1,1,1,1,1,1,1,
0,1,1,1,0,0,21,0,0,
0,1,1,1,21,1,1,1,1,
0,0,21,1,0,0,0,1,0,
1,1,21,1,1,1,1,1,0,
0,1,0,1,1,1,1,1,21,
0,0,1,1,1,1,1,21,0,
0,21,1,1,1,1,1,0,0,
1,21,0,0,1,1,1,0,0,
0,0,0,21,1,1,1,1,0,
0,1,1,1,1,1,1,1,21,
0,1,1,1,1,1,1,1,21,
0,0,1,1,1,1,1,0,21,
1,0,0,21,1,0,0,0,0,
1,1,1,21,0,0,1,1,1,
0,1,0,1,1,1,1,1,21,
0,1,0,1,1,1,1,1,21,
0,1,21,1,1,1,1,1,0,
0,1,0,0,21,1,0,1,0,
0,1,1,1,1,1,21,1,0,
0,1,0,0,0,0,0,1,21,
1,1,1,1,1,1,1,1,21,
1,1,1,1,0,0,0,21,0,
1,1,1,1,1,1,1,1,21,
1,1,0,1,21,0,0,1,1,
1,1,0,1,21,1,0,1,1,
1,1,21,1,0,1,1,1,1,
1,1,0,1,21,0,0,0,0,
1,1,1,21,0,1,1,0,0,
1,1,1,0,21,1,0,0,1,
0,0,0,0,0,0,0,0,0,
0,0,0,0,0,0,0,0,0,
0,0,0,0,0,0,0,0,0.
[layer]
type=Tile Layer 2
data=
0,171,171,171,171,171,0,171,171,
0,162,162,162,162,162,162,162,162,
0,0,168,0,0,168,0,168,0,
0,140,140,140,140,140,140,140,140,
0,135,135,135,0,0,0,0,0,
0,124,124,124,0,124,124,124,124,
0,0,0,113,0,0,0,113,0,
141,141,0,141,141,141,141,141,0,
0,130,0,130,130,130,130,130,0,
0,0,119,119,119,119,119,0,0,
0,0,109,109,109,109,109,0,0,
135,0,0,0,135,135,135,0,0,
0,0,0,0,125,125,125,125,0,
0,115,115,115,115,115,115,115,0,
0,104,104,104,104,104,104,104,0,
0,0,130,130,130,130,130,0,0,
120,0,0,0,120,0,0,0,0,
110,110,110,0,0,0,110,110,110,
0,100,0,100,100,100,100,100,0,
0,124,0,124,124,124,124,124,0,
0,114,0,114,114,114,114,114,0,
0,105,0,0,0,105,0,105,0,
0,96,96,96,96,96,0,96,0,
0,95,0,0,0,0,0,95,0,
82,82,82,82,82,82,82,82,0,
85,85,85,85,0,0,0,0,0,
80,80,80,80,80,80,80,80,0,
75,75,0,75,0,0,0,75,75,
74,74,0,74,0,74,0,74,74,
73,73,0,73,0,73,73,73,73,
72,72,0,72,0,0,0,0,0,
71,71,71,0,0,71,71,0,0,
70,70,70,0,0,70,0,0,70,
0,0,0,0,0,0,0,0,0,
0,0,0,0,0,0,0,0,0,
0,0,0,0,0,0,0,0,0.