[layer]
type=Tile Layer 1
data=
0,21,0,0,0,1,1,3,1,
3,1,4,1,21,1,1,1,6,
0,0,21,1,0,1,1,1,1,
3,1,21,1,0,1,1,1,4,
0,1,0,5,21,0,0,0,0,
0,1,21,1,0,4,1,1,1,
0,0,0,0,1,1,1,21,0,
0,5,1,1,1,6,5,0,21,
0,1,1,1,1,1,3,21,0,
0,0,0,0,1,3,21,0,1,
1,1,21,1,1,1,1,0,0,
4,1,0,6,1,6,1,21,0,
5,1,0,21,1,1,1,1,0,
0,0,0,21,1,1,1,1,0,
0,6,1,1,1,4,6,1,21,
1,3,1,21,1,0,1,0,1,
5,1,1,0,0,21,1,0,0,
1,6,1,21,6,1,1,1,1,
0,0,0,21,0,0,0,0,1,
1,1,1,21,1,3,1,1,6,
1,5,1,21,1,1,1,0,6,
1,5,5,1,3,1,1,21,1,
4,0,0,0,0,21,1,0,1,
1,21,1,1,1,1,1,4,1,
1,1,1,1,21,1,1,0,6,
5,4,1,5,0,21,0,0,1,
1,0,0,21,0,1,1,0,0,
1,21,1,1,1,1,1,3,0,
4,0,21,6,1,1,1,0,0,
1,21,0,6,1,1,1,0,1,
0,0,0,0,0,0,0,0,0,
0,0,0,0,0,0,0,0,0,
0,0,0,0,0,0,0,0,0.
[layer]
type=Tile Layer 2
data=
0,0,0,0,0,166,166,166,166,
156,156,156,156,0,156,156,156,156,
0,0,0,162,0,162,162,162,162,
112,112,0,112,0,112,112,112,112,
0,140,0,140,0,0,0,0,0,
0,129,0,129,0,129,129,129,129,
0,0,0,0,118,118,118,0,0,
0,108,108,108,108,108,108,0,0,
0,134,134,134,134,134,134,0,0,
0,0,0,0,124,124,0,0,124,
114,114,0,114,114,114,114,0,0,
103,103,0,103,103,103,103,0,0,
129,129,0,0,129,129,129,129,0,
0,0,0,0,119,119,119,119,0,
0,109,109,109,109,109,109,109,0,
99,99,99,0,99,0,99,0,99,
123,123,123,0,0,0,123,0,0,
108,108,108,0,108,108,108,108,108,
0,0,0,0,0,0,0,0,104,
90,90,90,0,90,90,90,90,90,
94,94,94,0,94,94,94,0,94,
81,81,81,81,81,81,81,0,81,
84,0,0,0,0,0,84,0,84,
79,0,79,79,79,79,79,79,79,
74,74,74,74,0,74,74,0,74,
73,73,73,73,0,0,0,0,73,
72,0,0,0,0,72,72,0,0,
71,0,71,71,71,71,71,71,0,
70,0,0,70,70,70,70,0,0,
69,0,0,69,69,69,69,0,69,
0,0,0,0,0,0,0,0,0,
0,0,0,0,0,0,0,0,0,
0,0,0,0,0,0,0,0,0.