[layer]
type=Tile Layer 1
data=
1,1,1,1,1,21,1,0,0,
1,21,0,2,2,0,1,1,0,
0,21,2,9,2,2,2,2,2,
0,1,21,2,2,0,0,0,0,
1,1,21,1,1,1,1,1,0,
0,2,2,2,2,2,7,2,21,
1,1,1,1,1,1,1,1,21,
0,0,0,0,21,0,0,1,0,
1,1,21,1,0,1,1,1,0,
1,1,21,1,0,2,2,2,0,
2,2,2,2,2,2,9,2,21,
2,7,2,2,21,2,2,2,0,
1,21,1,1,1,1,1,0,1,
1,0,1,21,0,0,1,0,1,
1,0,1,0,1,21,1,0,1,
0,0,0,0,1,21,0,0,1,
1,1,1,1,1,1,1,21,1,
1,0,21,0,0,0,1,0,1,
1,21,1,2,2,2,1,1,1,
1,21,1,2,8,0,0,0,1,
1,0,1,21,2,2,2,0,1,
1,21,1,0,2,8,2,1,1,
2,21,2,0,7,2,2,2,2,
1,0,1,0,1,21,0,0,0,
1,21,1,1,1,0,1,1,1,
2,21,0,0,0,0,0,0,1,
8,21,1,1,1,1,1,1,1,
0,0,0,0,0,0,0,0,0,
0,0,0,0,0,0,0,0,0,
0,0,0,0,0,0,0,0,0.
[layer]
type=Tile Layer 2
data=
160,160,160,160,160,0,160,0,0,
158,0,0,158,158,0,158,158,0,
0,0,157,157,157,157,157,157,157,
0,117,0,117,117,0,0,0,0,
107,107,0,107,107,107,107,107,0,
0,133,133,133,133,133,133,133,0,
117,117,117,117,117,117,117,117,0,
0,0,0,0,0,0,0,113,0,
102,102,0,102,0,102,102,102,0,
128,128,0,128,0,128,128,128,0,
118,118,118,118,118,118,118,118,0,
108,108,108,108,0,108,108,108,0,
98,0,98,98,98,98,98,0,98,
122,0,122,0,0,0,122,0,122,
112,0,112,0,112,0,112,0,112,
0,0,0,0,103,0,0,0,103,
89,89,89,89,89,89,89,0,89,
93,0,0,0,0,0,93,0,93,
80,0,80,80,80,80,80,80,80,
83,0,83,83,83,0,0,0,83,
82,0,82,0,82,82,82,0,82,
73,0,73,0,73,73,73,73,73,
72,0,72,0,72,72,72,72,72,
71,0,71,0,71,0,0,0,0,
70,0,70,70,70,0,70,70,70,
69,0,0,0,0,0,0,0,69,
68,0,68,68,68,68,68,68,68,
0,0,0,0,0,0,0,0,0,
0,0,0,0,0,0,0,0,0,
0,0,0,0,0,0,0,0,0.