[layer]
type=Tile Layer 1
data=
1,1,0,21,0,0,0,1,1,
5,1,1,3,1,1,0,21,24,
1,1,1,4,1,1,21,3,0,
1,1,3,1,1,1,21,1,0,
5,1,1,1,4,2,21,2,0,
1,3,1,1,1,2,24,21,0,
1,2,2,2,1,1,1,1,21,
0,0,24,2,1,6,5,1,21,
1,1,21,1,1,1,4,4,0,
0,2,0,0,21,2,18,2,0,
0,2,18,2,2,2,0,2,21,
0,5,21,1,0,1,0,1,0,
0,2,2,2,0,5,0,1,21,
0,0,19,21,0,2,0,2,0,
0,2,21,2,1,2,24,2,1,
3,1,1,1,4,0,21,0,0,
1,1,1,1,4,0,0,21,0,
1,1,6,1,1,1,0,21,0,
1,6,1,1,1,3,0,21,0,
1,1,1,1,4,21,0,0,0,
1,0,0,0,21,0,1,4,1,
1,0,0,21,0,2,2,2,1,
3,1,1,1,0,21,24,2,1,
1,6,1,5,5,1,21,1,1,
4,6,1,1,5,1,1,21,0,
2,2,2,2,2,2,2,21,18,
1,1,1,1,1,21,0,0,0,
2,2,1,0,21,0,1,1,4,
20,0,21,0,2,2,2,2,2,
0,0,21,1,1,1,1,5,1,
1,21,0,2,2,2,4,1,3,
1,21,0,0,19,0,0,0,0,
1,1,1,2,2,2,1,1,21,
0,0,0,21,0,0,0,6,0,
0,1,1,1,1,5,21,1,0,
0,2,0,0,0,1,0,0,21,
24,2,21,1,1,6,1,1,1,
0,1,0,0,0,0,0,21,0,
1,4,21,1,1,1,4,1,5,
0,0,0,1,0,21,0,3,1,
21,1,1,1,1,4,2,2,5,
0,1,1,4,0,1,21,19,1,
1,1,1,1,4,1,0,21,0,
1,6,1,1,21,0,0,6,0,
1,1,5,2,21,2,1,0,0,
1,5,3,2,24,21,0,0,1,
1,1,0,0,0,0,0,21,0,
6,1,0,1,1,1,1,21,0,
0,0,0,0,0,0,0,0,0,
0,0,0,0,0,0,0,0,0,
0,0,0,0,0,0,0,0,0.
[layer]
type=Tile Layer 2
data=
228,228,0,0,0,0,0,228,228,
227,227,227,227,227,227,0,0,0,
225,225,225,225,225,225,0,225,0,
183,183,183,183,183,183,0,183,0,
168,168,168,168,168,168,0,168,0,
154,154,154,154,154,154,0,0,0,
183,183,183,183,183,183,183,183,0,
0,0,0,178,178,178,178,178,0,
164,164,0,164,164,164,164,164,0,
0,149,0,0,0,149,0,149,0,
0,187,0,187,187,187,0,187,0,
0,173,0,173,0,173,0,173,0,
0,159,159,159,0,159,0,159,0,
0,0,0,0,0,145,0,145,0,
0,181,0,181,181,181,0,181,181,
167,167,167,167,167,0,0,0,0,
154,154,154,154,154,0,0,0,0,
141,141,141,141,141,141,0,0,0,
176,176,176,176,176,176,0,0,0,
162,162,162,162,162,0,0,0,0,
149,0,0,0,0,0,149,149,149,
136,0,0,0,0,136,136,136,136,
170,170,170,170,0,0,0,170,170,
150,150,150,150,150,150,0,150,150,
144,144,144,144,144,144,144,0,0,
132,132,132,132,132,132,132,0,0,
164,164,164,164,164,0,0,0,0,
152,152,152,0,0,0,152,152,152,
0,0,0,0,140,140,140,140,140,
0,0,0,127,127,127,127,127,127,
159,0,0,159,159,159,159,159,159,
147,0,0,0,0,0,0,0,0,
128,128,128,128,128,128,128,128,0,
0,0,0,0,0,0,0,123,0,
0,153,153,153,153,153,0,153,0,
0,141,0,0,0,141,0,0,0,
0,130,0,130,130,130,130,130,130,
0,119,0,0,0,0,0,0,0,
112,112,0,112,112,112,112,112,112,
0,0,0,107,0,0,0,107,107,
0,101,101,101,101,101,101,101,101,
0,105,105,105,0,105,0,0,105,
94,94,94,94,94,94,0,0,0,
93,93,93,93,0,0,0,93,0,
92,92,92,92,0,92,92,0,0,
91,91,91,91,0,0,0,0,91,
90,90,0,0,0,0,0,0,0,
89,89,0,89,89,89,89,0,0,
0,0,0,0,0,0,0,0,0,
0,0,0,0,0,0,0,0,0,
0,0,0,0,0,0,0,0,0.