[layer]
type=Tile Layer 1
data=
1,1,21,1,1,4,1,6,0,
1,1,21,1,1,1,1,6,0,
4,3,21,1,1,1,1,1,0,
1,21,1,0,1,1,1,1,1,
3,21,1,0,1,6,1,1,1,
6,21,4,0,1,1,1,4,1,
0,0,21,0,0,1,0,0,0,
3,1,21,1,1,1,1,1,5,
6,0,0,0,21,0,1,1,1,
6,21,5,1,1,0,1,1,1,
1,0,1,21,4,0,0,0,0,
1,1,1,21,1,0,4,1,1,
1,21,1,0,1,1,1,6,1,
0,0,1,0,1,0,0,0,21,
1,1,1,21,1,0,3,4,6,
1,21,0,0,1,0,3,0,1,
1,0,1,1,1,21,1,0,1,
5,0,1,0,0,21,6,0,0,
1,21,3,0,1,1,1,0,6,
1,0,1,0,1,21,5,0,0,
1,0,1,21,6,0,1,1,1,
0,1,0,1,0,1,0,1,21,
1,4,21,1,0,1,0,6,0,
0,0,0,1,0,0,0,3,21,
0,3,6,1,1,4,0,1,21,
0,1,0,1,1,6,21,1,0,
1,1,21,1,1,1,0,1,1,
0,0,0,0,0,0,0,0,0,
0,0,0,0,0,0,0,0,0,
0,0,0,0,0,0,0,0,0.
[layer]
type=Tile Layer 2
data=
160,160,0,160,160,160,160,160,0,
158,158,0,158,158,158,158,158,0,
157,157,0,157,157,157,157,157,0,
117,0,117,0,117,117,117,117,117,
107,0,107,0,107,107,107,107,107,
133,0,133,0,133,133,133,133,133,
0,0,0,0,0,123,0,0,0,
107,107,0,107,107,107,107,107,107,
102,0,0,0,0,0,102,102,102,
128,0,128,128,128,0,128,128,128,
118,0,118,0,118,0,0,0,0,
108,108,108,0,108,0,108,108,108,
98,0,98,0,98,98,98,98,98,
0,0,122,0,122,0,0,0,0,
112,112,112,0,112,0,112,112,112,
103,0,0,0,103,0,103,0,103,
94,0,94,94,94,0,94,0,94,
93,0,93,0,0,0,93,0,0,
84,0,84,0,84,84,84,0,84,
83,0,83,0,83,0,83,0,0,
82,0,82,0,82,0,82,82,82,
0,73,0,73,0,73,0,73,0,
72,72,0,72,0,72,0,72,0,
0,0,0,71,0,0,0,71,0,
0,70,70,70,70,70,0,70,0,
0,69,0,69,69,69,0,69,0,
68,68,0,68,68,68,0,68,68,
0,0,0,0,0,0,0,0,0,
0,0,0,0,0,0,0,0,0,
0,0,0,0,0,0,0,0,0.