[layer]
type=Tile Layer 1
data=
0,1,0,1,21,1,0,0,1,
0,1,21,1,0,3,1,1,0,
1,5,0,6,1,1,0,1,21,
1,3,21,1,0,1,3,1,1,
0,1,0,1,21,1,0,0,0,
0,1,4,1,0,5,1,1,21,
6,5,1,21,0,1,0,0,0,
3,0,1,1,0,21,1,1,1,
1,3,5,1,0,0,21,3,0,
1,1,3,5,5,1,21,0,0,
1,0,0,0,21,0,1,0,3,
1,21,1,0,4,1,3,0,1,
0,0,0,0,0,0,0,0,0,
0,0,0,0,0,0,0,0,0,
0,0,0,0,0,0,0,0,0.
[layer]
type=Tile Layer 2
data=
0,89,0,89,0,89,0,0,89,
0,64,0,64,0,64,64,64,0,
63,63,0,63,63,63,0,63,0,
59,59,0,59,0,59,59,59,59,
0,55,0,55,0,55,0,0,0,
0,54,54,54,0,54,54,54,0,
53,53,53,0,0,53,0,0,0,
52,0,52,52,0,0,52,52,52,
51,51,51,51,0,0,0,51,0,
50,50,50,50,50,50,0,0,0,
49,0,0,0,0,0,49,0,49,
48,0,48,0,48,48,48,0,48,
0,0,0,0,0,0,0,0,0,
0,0,0,0,0,0,0,0,0,
0,0,0,0,0,0,0,0,0.