[layer]
type=Tile Layer 1
data=
1,1,0,1,1,21,0,1,0,
1,1,21,1,0,1,0,1,1,
0,1,0,0,0,1,1,1,21,
0,1,1,1,1,1,1,1,21,
1,1,0,0,0,1,0,1,21,
0,1,21,1,0,1,0,1,0,
1,6,0,1,1,1,21,0,0,
0,21,4,1,1,1,1,0,0,
6,4,1,0,21,1,1,3,5,
0,0,1,1,0,1,1,21,0,
0,0,1,1,1,1,1,21,0,
0,1,1,21,0,0,1,1,0,
0,0,0,0,0,0,0,0,0,
0,0,0,0,0,0,0,0,0,
0,0,0,0,0,0,0,0,0.
[layer]
type=Tile Layer 2
data=
88,88,0,88,88,0,0,88,0,
63,63,0,63,0,63,0,63,63,
0,62,0,0,0,62,62,62,0,
0,58,58,58,58,58,58,58,0,
54,54,0,0,0,54,0,54,0,
0,53,0,53,0,53,0,53,0,
52,52,0,52,52,52,0,0,0,
0,0,51,51,51,51,51,0,0,
48,48,48,0,0,48,48,48,48,
0,0,49,49,0,49,49,0,0,
0,0,48,48,48,48,48,0,0,
0,47,47,0,0,0,47,47,0,
0,0,0,0,0,0,0,0,0,
0,0,0,0,0,0,0,0,0,
0,0,0,0,0,0,0,0,0.