[layer]
type=Tile Layer 1
data=
0,1,21,1,0,0,0,1,0,
0,2,2,2,20,2,21,2,7,
1,21,0,2,0,2,24,0,0,
1,21,1,1,1,1,2,1,1,
0,0,0,1,24,21,1,1,0,
0,24,21,1,2,1,1,1,1,
2,2,2,2,7,2,2,21,2,
0,21,0,0,0,1,1,1,1,
0,2,2,2,2,7,2,21,2,
0,0,0,0,0,0,0,0,0,
0,0,0,0,0,0,0,0,0,
0,0,0,0,0,0,0,0,0.
[layer]
type=Tile Layer 2
data=
0,79,0,79,0,0,0,79,0,
0,50,50,50,0,50,0,50,50,
49,0,0,49,0,49,0,0,0,
44,0,44,44,44,44,44,44,44,
0,0,0,48,0,0,48,48,0,
0,0,0,47,47,47,47,47,47,
44,44,44,44,44,44,44,0,44,
0,0,0,0,0,45,45,45,45,
0,44,44,44,44,44,44,0,44,
0,0,0,0,0,0,0,0,0,
0,0,0,0,0,0,0,0,0,
0,0,0,0,0,0,0,0,0.