[layer]
type=Tile Layer 1
data=
0,21,2,2,2,2,7,2,2,
1,1,1,1,1,21,0,1,1,
1,1,1,1,1,21,1,0,1,
1,1,1,1,1,0,0,21,0,
1,1,1,1,21,0,1,1,0,
2,7,2,2,2,2,21,2,0,
0,21,1,1,1,1,0,1,1,
0,21,2,1,1,1,0,1,1,
1,10,0,0,0,21,0,0,1,
2,7,2,2,2,2,2,2,21,
0,0,2,2,0,0,0,21,1,
1,2,8,2,1,1,1,21,1,
1,2,2,2,1,1,1,21,1,
0,21,1,0,1,0,0,0,1,
1,1,1,21,1,0,1,1,1,
1,1,1,0,1,0,1,21,0,
1,2,2,21,1,0,1,1,1,
1,10,2,0,1,21,0,0,1,
0,0,2,0,1,0,21,0,1,
1,21,1,0,1,1,1,1,1,
1,21,1,0,1,0,0,0,1,
1,0,1,0,1,21,1,0,1,
0,2,2,2,2,21,7,2,2,
1,1,1,1,1,21,1,1,1,
1,0,0,21,0,0,1,0,0,
1,1,1,1,1,1,1,21,2,
0,2,21,0,1,0,0,0,10,
10,21,1,0,1,1,2,2,2,
2,21,1,0,1,1,2,10,1,
1,0,0,0,21,0,2,0,1,
1,1,1,21,1,1,1,0,1,
1,1,1,0,1,21,1,0,0,
1,1,1,1,1,21,1,0,1,
0,0,0,0,0,0,0,0,0,
0,0,0,0,0,0,0,0,0,
0,0,0,0,0,0,0,0,0.
[layer]
type=Tile Layer 2
data=
0,0,171,171,171,171,171,171,171,
170,170,170,170,170,0,0,170,170,
168,168,168,168,168,0,168,0,168,
147,147,147,147,147,0,0,0,0,
135,135,135,135,0,0,135,135,0,
124,124,124,124,124,124,0,124,0,
0,0,113,113,113,113,0,113,113,
0,0,141,141,141,141,0,141,141,
130,130,0,0,0,0,0,0,130,
119,119,119,119,119,119,119,119,0,
0,0,109,109,0,0,0,0,109,
135,135,135,135,135,135,135,0,135,
119,119,119,119,119,119,119,0,119,
0,0,115,0,115,0,0,0,115,
104,104,104,0,104,0,104,104,104,
130,130,130,0,130,0,130,0,0,
120,120,120,0,120,0,120,120,120,
110,110,110,0,110,0,0,0,110,
0,0,100,0,100,0,0,0,100,
124,0,124,0,124,124,124,124,124,
114,0,114,0,114,0,0,0,114,
105,0,105,0,105,0,105,0,105,
0,96,96,96,96,0,96,96,96,
90,90,90,90,90,0,90,90,90,
86,0,0,0,0,0,86,0,0,
81,81,81,81,81,81,81,0,81,
0,84,0,0,84,0,0,0,84,
75,0,75,0,75,75,75,75,75,
74,0,74,0,74,74,74,74,74,
73,0,0,0,0,0,73,0,73,
72,72,72,0,72,72,72,0,72,
71,71,71,0,71,0,71,0,0,
70,70,70,70,70,0,70,0,70,
0,0,0,0,0,0,0,0,0,
0,0,0,0,0,0,0,0,0,
0,0,0,0,0,0,0,0,0.