[layer]
type=Tile Layer 1
data=
5,0,1,21,0,0,0,0,1,
1,21,1,4,6,1,1,0,1,
0,0,0,0,0,0,1,21,0,
1,3,1,1,1,21,1,1,1,
1,1,4,1,1,0,21,0,0,
4,1,1,3,1,21,1,0,5,
0,0,0,21,1,1,3,0,0,
0,1,4,1,4,1,1,21,0,
0,1,5,1,1,1,1,0,21,
0,0,21,0,1,1,0,0,3,
1,1,0,1,3,1,1,21,0,
1,1,0,4,1,1,6,21,0,
6,1,21,0,1,1,1,1,0,
0,21,0,0,1,5,1,5,0,
0,1,1,1,1,1,1,4,21,
0,1,1,1,21,1,1,6,6,
0,0,0,1,21,5,0,0,0,
1,1,0,1,1,1,21,3,0,
0,0,21,1,0,0,0,1,0,
0,1,6,1,0,1,3,1,21,
0,0,21,1,0,1,0,0,0,
0,0,0,0,0,0,0,0,0,
0,0,0,0,0,0,0,0,0,
0,0,0,0,0,0,0,0,0.
[layer]
type=Tile Layer 2
data=
133,0,133,0,0,0,0,0,133,
125,0,125,125,125,125,125,0,125,
0,0,0,0,0,0,130,0,0,
102,102,102,102,102,0,102,102,102,
104,104,104,104,104,0,0,0,0,
90,90,90,90,90,0,90,0,90,
0,0,0,0,86,86,86,0,0,
0,107,107,107,107,107,107,0,0,
0,98,98,98,98,98,98,0,0,
0,0,0,0,90,90,0,0,90,
82,82,0,82,82,82,82,0,0,
81,81,0,81,81,81,81,0,0,
73,73,0,0,73,73,73,73,0,
0,0,0,0,72,72,72,72,0,
0,67,67,67,67,67,67,67,0,
0,60,60,60,0,60,60,60,60,
0,0,0,62,0,62,0,0,0,
61,61,0,61,61,61,0,61,0,
0,0,0,60,0,0,0,60,0,
0,59,59,59,0,59,59,59,0,
0,0,0,58,0,58,0,0,0,
0,0,0,0,0,0,0,0,0,
0,0,0,0,0,0,0,0,0,
0,0,0,0,0,0,0,0,0.