[layer]
type=Tile Layer 1
data=
0,0,0,21,0,1,0,0,0,
21,1,1,1,1,1,1,1,1,
0,1,0,1,0,1,21,1,1,
0,1,21,1,0,1,0,1,1,
0,0,0,1,0,1,21,1,1,
1,1,1,1,21,1,0,1,1,
1,1,0,1,0,0,21,1,0,
1,1,0,1,21,1,1,1,0,
0,0,0,1,0,1,1,1,21,
1,1,1,0,0,21,0,1,1,
1,1,1,0,1,21,0,1,1,
1,1,1,21,1,0,1,1,1,
1,1,1,1,1,0,0,21,0,
1,1,1,0,21,1,1,1,0,
0,0,0,0,1,1,1,1,21,
0,1,1,1,1,1,21,0,0,
0,0,0,21,1,1,1,1,0,
1,1,1,0,0,0,21,0,0,
0,1,1,1,0,0,0,0,21,
21,1,1,1,1,1,1,1,1,
0,21,0,0,0,1,1,1,1,
1,1,1,1,21,1,1,1,1,
0,0,0,1,0,21,0,0,0,
1,1,21,1,1,1,1,1,1,
0,0,0,0,0,0,0,0,0,
0,0,0,0,0,0,0,0,0,
0,0,0,0,0,0,0,0,0.
[layer]
type=Tile Layer 2
data=
0,0,0,0,0,139,0,0,0,
0,124,124,124,124,124,124,124,124,
0,136,0,136,0,136,0,136,136,
0,110,0,110,0,110,0,110,110,
0,0,0,101,0,101,0,101,101,
87,87,87,87,0,87,0,87,87,
114,114,0,114,0,0,0,114,0,
105,105,0,105,0,105,105,105,0,
0,0,0,96,0,96,96,96,0,
87,87,87,0,0,0,0,87,87,
108,108,108,0,108,0,0,108,108,
95,95,95,0,95,0,95,95,95,
91,91,91,91,91,0,0,0,0,
83,83,83,0,0,83,83,83,0,
0,0,0,0,82,82,82,82,0,
0,74,74,74,74,74,0,0,0,
0,0,0,0,73,73,73,73,0,
72,72,72,0,0,0,0,0,0,
0,64,64,64,0,0,0,0,0,
0,57,57,57,57,57,57,57,57,
0,0,0,0,0,62,62,62,62,
56,56,56,56,0,56,56,56,56,
0,0,0,60,0,0,0,0,0,
54,54,0,54,54,54,54,54,54,
0,0,0,0,0,0,0,0,0,
0,0,0,0,0,0,0,0,0,
0,0,0,0,0,0,0,0,0.