[layer]
type=Tile Layer 1
data=
24,2,1,6,1,5,0,1,21,
20,2,2,2,2,2,21,2,2,
0,0,0,0,0,0,21,1,0,
1,1,1,1,21,1,1,1,0,
0,0,0,21,0,1,6,3,0,
21,5,1,1,1,6,1,1,1,
1,0,5,1,1,21,0,3,1,
0,0,1,6,1,21,2,2,1,
0,1,1,6,1,0,19,21,1,
0,1,6,1,1,2,2,0,21,
0,1,1,1,1,1,3,1,21,
0,5,1,0,0,0,0,21,0,
1,21,0,0,1,1,1,1,6,
1,0,5,21,0,2,1,1,1,
3,0,1,21,24,2,5,1,1,
0,1,0,3,2,2,0,1,21,
0,0,21,2,0,20,0,2,0,
18,2,2,2,21,2,2,2,2,
0,0,0,1,0,0,21,24,0,
5,1,21,1,1,3,1,1,0,
0,21,0,1,0,0,0,1,0,
0,0,0,0,0,0,0,0,0,
0,0,0,0,0,0,0,0,0,
0,0,0,0,0,0,0,0,0.
[layer]
type=Tile Layer 2
data=
0,133,133,133,133,133,0,133,0,
0,125,125,125,125,125,0,125,125,
0,0,0,0,0,0,0,130,0,
107,107,107,107,0,107,107,107,0,
0,0,0,0,0,104,104,104,0,
0,86,86,86,86,86,86,86,86,
86,0,86,86,86,0,0,86,86,
0,0,107,107,107,0,107,107,107,
0,98,98,98,98,0,0,0,98,
0,90,90,90,90,90,90,0,0,
0,78,78,78,78,78,78,78,0,
0,81,81,0,0,0,0,0,0,
73,0,0,0,73,73,73,73,73,
72,0,72,0,0,72,72,72,72,
71,0,71,0,0,71,71,71,71,
0,63,0,63,63,63,0,63,0,
0,0,0,62,0,0,0,62,0,
0,58,58,58,0,58,58,58,58,
0,0,0,60,0,0,0,0,0,
57,57,0,57,57,57,57,57,0,
0,0,0,58,0,0,0,58,0,
0,0,0,0,0,0,0,0,0,
0,0,0,0,0,0,0,0,0,
0,0,0,0,0,0,0,0,0.