[layer]
type=Tile Layer 1
data=
24,2,0,1,1,1,21,1,1,
0,1,21,0,0,0,0,1,0,
1,1,21,1,1,1,1,2,0,
0,1,21,1,1,1,1,2,24,
0,1,21,1,1,1,1,1,0,
0,1,0,0,0,1,0,21,0,
0,0,1,1,1,1,1,1,21,
0,2,2,2,2,2,2,21,18,
18,2,2,2,2,2,2,21,2,
0,1,1,1,1,0,24,21,1,
0,21,0,0,0,0,1,1,1,
1,1,1,21,1,0,1,1,1,
1,1,1,0,1,0,21,0,1,
1,2,2,21,0,1,1,0,1,
0,19,21,1,0,1,1,1,1,
0,21,0,2,0,18,0,2,0,
0,1,1,1,21,1,0,1,1,
0,1,21,0,0,1,0,1,0,
0,1,21,1,1,1,1,1,0,
0,1,0,1,0,0,21,0,0,
0,1,21,1,0,1,1,1,1,
0,0,0,0,0,0,0,0,0,
0,0,0,0,0,0,0,0,0,
0,0,0,0,0,0,0,0,0.
[layer]
type=Tile Layer 2
data=
0,133,0,133,133,133,0,133,133,
0,132,0,0,0,0,0,132,0,
124,124,0,124,124,124,124,124,0,
0,113,0,113,113,113,113,113,0,
0,104,0,104,104,104,104,104,0,
0,95,0,0,0,95,0,0,0,
0,0,86,86,86,86,86,86,0,
0,107,107,107,107,107,107,0,0,
0,94,94,94,94,94,94,0,94,
0,90,90,90,90,0,0,0,90,
0,0,0,0,0,0,82,82,82,
77,77,77,0,77,0,77,77,77,
73,73,73,0,73,0,0,0,73,
72,72,72,0,0,72,72,0,72,
0,0,0,71,0,71,71,71,71,
0,0,0,63,0,0,0,63,0,
0,62,62,62,0,62,0,62,62,
0,61,0,0,0,61,0,61,0,
0,60,0,60,60,60,60,60,0,
0,59,0,59,0,0,0,0,0,
0,58,0,58,0,58,58,58,58,
0,0,0,0,0,0,0,0,0,
0,0,0,0,0,0,0,0,0,
0,0,0,0,0,0,0,0,0.