[layer]
type=Tile Layer 1
data=
2,2,0,2,18,21,2,2,0,
2,2,21,2,10,2,2,2,18,
1,1,0,2,2,0,21,0,0,
2,2,21,2,2,2,7,2,0,
0,0,0,0,21,1,0,0,0,
6,2,2,1,1,4,21,1,1,
2,9,2,2,2,2,21,2,0,
1,2,21,1,2,2,2,5,1,
4,1,0,1,0,19,0,21,0,
1,5,21,1,2,2,2,1,0,
0,0,0,21,0,0,0,1,0,
1,2,2,2,1,1,21,1,4,
0,0,20,21,0,0,2,2,2,
1,2,2,21,0,1,6,1,1,
1,1,1,2,21,2,3,0,1,
2,21,2,2,20,2,2,2,7,
9,2,2,2,21,0,2,2,2,
8,2,1,21,0,0,0,0,0,
0,0,0,0,0,0,0,0,0,
0,0,0,0,0,0,0,0,0,
0,0,0,0,0,0,0,0,0.
[layer]
type=Tile Layer 2
data=
128,128,0,128,0,0,128,128,0,
127,127,0,127,127,127,127,127,0,
125,125,0,125,125,0,0,0,0,
86,86,0,86,86,86,86,86,0,
0,0,0,0,0,107,0,0,0,
89,89,89,89,89,89,0,89,89,
90,90,90,90,90,90,0,90,0,
74,74,0,74,74,74,74,74,74,
81,81,0,81,0,0,0,0,0,
69,69,0,69,69,69,69,69,0,
0,0,0,0,0,0,0,72,0,
64,64,64,64,64,64,0,64,64,
0,0,0,0,0,0,63,63,63,
59,59,59,0,0,59,59,59,59,
58,58,58,58,0,58,58,0,58,
60,0,60,60,0,60,60,60,60,
59,59,59,59,0,0,59,59,59,
58,58,58,0,0,0,0,0,0,
0,0,0,0,0,0,0,0,0,
0,0,0,0,0,0,0,0,0,
0,0,0,0,0,0,0,0,0.