[layer]
type=Tile Layer 1
data=
3,1,1,21,0,1,1,1,1,
4,1,3,21,0,0,1,1,1,
4,6,1,1,1,21,0,0,1,
1,1,1,1,6,1,3,21,0,
1,1,6,5,1,1,21,0,0,
1,1,1,5,1,1,21,0,1,
1,21,0,0,0,0,0,0,5,
1,0,21,0,0,1,1,1,1,
1,1,1,3,21,1,6,1,6,
0,1,21,5,4,1,1,6,0,
0,21,0,1,1,1,1,1,0,
1,5,21,1,1,4,1,1,1,
0,1,0,0,0,0,0,0,21,
0,1,21,6,5,1,1,1,1,
0,1,0,0,0,0,0,21,0,
21,1,1,4,1,1,1,1,1,
0,0,21,0,0,6,0,0,0,
1,1,6,3,1,1,1,21,1,
1,1,6,1,0,0,21,0,0,
1,1,5,1,1,1,0,21,0,
1,1,1,4,1,6,21,0,1,
5,0,0,0,0,21,0,0,1,
1,0,0,21,0,0,0,0,0,
1,1,1,1,1,4,0,21,0,
1,6,1,4,1,3,21,0,0,
6,1,1,1,1,1,1,4,21,
1,1,3,1,1,1,1,1,21,
1,21,0,5,1,1,1,1,1,
1,21,0,1,5,1,1,1,1,
4,1,0,21,0,0,3,1,4,
1,6,1,1,1,21,0,0,1,
4,3,1,0,21,0,0,0,1,
1,1,1,21,0,0,0,0,0,
3,1,3,6,1,1,21,0,0,
1,1,1,1,1,21,0,1,1,
5,1,1,1,1,21,1,6,1,
1,1,21,1,1,1,1,4,1,
0,0,0,1,21,0,0,0,0,
1,1,21,1,0,5,1,6,6,
0,21,0,3,0,1,1,1,5,
1,4,1,1,21,1,1,1,1,
0,0,0,1,21,5,0,0,0,
1,4,21,1,0,4,1,1,1,
1,1,0,1,21,0,0,0,0,
1,6,21,1,1,5,1,1,1,
1,1,1,0,0,1,0,21,0,
1,4,1,3,21,0,0,1,1,
1,1,1,5,1,5,1,21,0,
1,1,6,1,21,1,1,5,1,
3,5,1,1,0,1,0,21,0,
3,1,1,21,1,1,1,1,0,
0,0,0,0,0,0,0,0,0,
0,0,0,0,0,0,0,0,0,
0,0,0,0,0,0,0,0,0.
[layer]
type=Tile Layer 2
data=
234,234,234,0,0,234,234,234,234,
233,233,233,0,0,0,233,233,233,
231,231,231,231,231,0,0,0,231,
174,174,174,174,174,174,174,0,0,
159,159,159,159,159,159,0,0,0,
199,199,199,199,199,199,0,0,199,
184,0,0,0,0,0,0,0,184,
169,0,0,0,0,169,169,169,169,
147,147,147,147,0,147,147,147,147,
0,193,0,193,193,193,193,193,0,
0,0,0,179,179,179,179,179,0,
157,157,0,157,157,157,157,157,157,
0,150,0,0,0,0,0,0,0,
0,188,0,188,188,188,188,188,188,
0,174,0,0,0,0,0,0,0,
0,152,152,152,152,152,152,152,152,
0,0,0,0,0,146,0,0,0,
173,173,173,173,173,173,173,0,173,
168,168,168,168,0,0,0,0,0,
155,155,155,155,155,155,0,0,0,
142,142,142,142,142,142,0,0,142,
177,0,0,0,0,0,0,0,177,
163,0,0,0,0,0,0,0,0,
150,150,150,150,150,150,0,0,0,
137,137,137,137,137,137,0,0,0,
163,163,163,163,163,163,163,163,0,
151,151,151,151,151,151,151,151,0,
145,0,0,145,145,145,145,145,145,
133,0,0,133,133,133,133,133,133,
165,165,0,0,0,0,165,165,165,
153,153,153,153,153,0,0,0,153,
141,141,141,0,0,0,0,0,141,
128,128,128,0,0,0,0,0,0,
160,160,160,160,160,160,0,0,0,
148,148,148,148,148,0,0,148,148,
129,129,129,129,129,0,129,129,129,
118,118,0,118,118,118,118,118,118,
0,0,0,154,0,0,0,0,0,
142,142,0,142,0,142,142,142,142,
0,0,0,131,0,131,131,131,131,
114,114,114,114,0,114,114,114,114,
0,0,0,119,0,119,0,0,0,
108,108,0,108,0,108,108,108,108,
107,107,0,107,0,0,0,0,0,
101,101,0,101,101,101,101,101,101,
95,95,95,0,0,95,0,0,0,
94,94,94,94,0,0,0,94,94,
93,93,93,93,93,93,93,0,0,
88,88,88,88,0,88,88,88,88,
91,91,91,91,0,91,0,0,0,
90,90,90,0,90,90,90,90,0,
0,0,0,0,0,0,0,0,0,
0,0,0,0,0,0,0,0,0,
0,0,0,0,0,0,0,0,0.