[layer]
type=Tile Layer 1
data=
0,21,0,0,1,1,1,1,1,
0,1,21,1,1,1,1,1,1,
0,0,1,0,21,0,0,0,1,
1,21,1,0,1,1,1,1,1,
1,21,1,0,0,0,1,1,1,
1,21,1,1,1,1,0,0,1,
1,0,21,0,1,1,1,0,1,
1,1,1,1,0,1,1,21,0,
1,1,1,1,21,0,0,1,0,
0,1,1,1,1,1,1,1,21,
0,0,1,1,0,1,21,0,0,
0,0,0,0,1,0,21,0,0,
0,21,0,1,1,1,0,0,0,
0,1,1,21,1,0,1,1,0,
1,1,21,1,0,1,1,1,1,
0,0,0,0,0,0,0,0,0,
0,0,0,0,0,0,0,0,0,
0,0,0,0,0,0,0,0,0.
[layer]
type=Tile Layer 2
data=
0,0,0,0,123,123,123,123,123,
0,115,0,115,115,115,115,115,115,
0,0,119,0,0,0,0,0,119,
85,0,85,0,85,85,85,85,85,
81,0,81,0,0,0,81,81,81,
80,0,80,80,80,80,0,0,80,
72,0,0,0,72,72,72,0,72,
71,71,71,71,0,71,71,0,0,
70,70,70,70,0,0,0,70,0,
0,59,59,59,59,59,59,59,0,
0,0,61,61,0,61,0,0,0,
0,0,0,0,60,0,0,0,0,
0,0,0,59,59,59,0,0,0,
0,58,58,0,58,0,58,58,0,
55,55,0,55,0,55,55,55,55,
0,0,0,0,0,0,0,0,0,
0,0,0,0,0,0,0,0,0,
0,0,0,0,0,0,0,0,0.