[layer]
type=Tile Layer 1
data=
0,1,21,5,0,0,1,1,0,
21,1,1,4,1,1,1,1,1,
0,0,0,6,21,0,1,0,0,
3,1,21,1,0,1,1,1,1,
1,1,0,1,0,0,21,6,0,
0,5,21,1,0,1,0,1,3,
0,0,21,0,0,1,1,1,1,
1,1,6,1,0,5,21,4,0,
0,1,0,0,0,1,0,1,21,
5,3,0,1,21,0,0,1,1,
1,1,21,0,0,1,0,0,0,
1,1,21,6,1,1,1,0,0,
1,1,1,1,1,1,21,0,5,
4,1,0,0,21,0,6,0,0,
0,0,21,0,0,0,1,1,0,
0,0,0,0,0,0,0,0,0,
0,0,0,0,0,0,0,0,0,
0,0,0,0,0,0,0,0,0.
[layer]
type=Tile Layer 2
data=
0,94,0,94,0,0,94,94,0,
0,66,66,66,66,66,66,66,66,
0,0,0,72,0,0,72,0,0,
67,67,0,67,0,67,67,67,67,
64,64,0,64,0,0,0,64,0,
0,63,0,63,0,63,0,63,63,
0,0,0,0,0,62,62,62,62,
55,55,55,55,0,55,0,55,0,
0,54,0,0,0,54,0,54,0,
53,53,0,53,0,0,0,53,53,
52,52,0,0,0,52,0,0,0,
51,51,0,51,51,51,51,0,0,
48,48,48,48,48,48,0,0,48,
49,49,0,0,0,0,49,0,0,
0,0,0,0,0,0,48,48,0,
0,0,0,0,0,0,0,0,0,
0,0,0,0,0,0,0,0,0,
0,0,0,0,0,0,0,0,0.