[layer]
type=Tile Layer 1
data=
3,6,4,4,21,0,6,1,3,
0,1,21,0,0,1,1,3,3,
4,6,4,1,21,0,4,6,1,
0,0,5,1,6,0,0,0,21,
1,21,3,6,1,0,6,3,0,
0,5,1,6,3,5,0,1,21,
0,0,0,5,1,6,0,4,21,
4,4,0,6,1,1,0,21,0,
6,5,1,21,1,1,1,5,6,
1,1,1,5,1,3,1,21,1,
1,1,1,1,1,1,4,1,21,
0,1,0,4,0,5,0,3,21,
6,1,4,21,4,0,5,1,1,
0,4,0,6,0,6,21,5,0,
0,0,4,0,6,21,5,0,0,
0,0,0,0,0,0,0,0,0,
0,0,0,0,0,0,0,0,0,
0,0,0,0,0,0,0,0,0.
[layer]
type=Tile Layer 2
data=
89,89,89,89,0,0,89,89,89,
0,73,0,0,0,73,73,73,73,
68,68,68,68,0,0,68,68,68,
0,0,71,71,71,0,0,0,0,
64,0,64,64,64,0,64,64,0,
0,63,63,50,50,50,0,63,0,
0,0,0,49,49,49,0,62,0,
55,55,0,44,44,2,0,0,0,
43,43,2,0,2,2,43,43,43,
2,2,2,42,2,42,2,0,2,
2,2,42,2,2,2,42,2,0,
0,51,0,51,0,51,0,51,0,
48,48,48,0,48,0,48,48,48,
0,49,0,49,0,49,0,49,0,
0,0,48,0,48,0,48,0,0,
0,0,0,0,0,0,0,0,0,
0,0,0,0,0,0,0,0,0,
0,0,0,0,0,0,0,0,0.