[layer]
type=Tile Layer 1
data=
1,21,24,2,1,1,1,1,1,
1,1,21,1,3,1,5,1,1,
6,2,21,6,1,1,1,3,1,
2,9,2,2,21,2,0,2,2,
1,2,2,3,0,21,0,1,0,
1,4,1,1,21,1,1,1,0,
1,1,1,5,21,1,0,0,0,
2,2,1,4,0,1,21,1,0,
19,2,0,1,0,3,0,1,21,
2,2,21,1,1,1,0,1,1,
20,0,0,21,0,2,0,0,2,
2,2,5,4,21,2,24,2,8,
24,7,2,2,0,2,2,2,21,
0,2,2,2,24,9,2,2,21,
0,2,2,21,2,20,2,2,0,
1,1,2,2,2,2,2,6,21,
2,2,21,9,2,2,2,2,0,
1,1,21,2,2,1,1,5,0,
1,1,21,1,1,3,1,1,0,
5,3,21,1,1,1,1,4,0,
0,1,0,0,0,0,0,2,21,
1,1,6,21,3,1,2,10,1,
1,21,2,0,2,2,2,2,1,
1,21,2,24,2,2,19,2,1,
1,21,2,0,2,2,10,2,1,
5,21,2,24,2,2,10,2,1,
0,0,21,0,1,2,2,0,0,
1,5,1,21,4,1,1,1,3,
0,0,3,21,1,1,1,1,1,
1,5,1,21,1,1,4,1,1,
0,0,0,0,21,5,1,0,1,
1,1,3,5,1,1,1,21,1,
1,0,0,21,2,2,4,0,1,
1,21,1,2,10,0,3,1,1,
6,0,1,2,2,21,0,0,0,
1,21,2,2,2,2,2,2,1,
1,21,0,19,2,2,8,2,1,
1,21,2,2,2,0,2,2,1,
1,21,2,2,2,0,3,1,5,
0,21,2,8,2,1,4,1,1,
0,21,2,2,2,1,2,2,1,
0,21,0,0,0,1,2,10,6,
1,2,2,21,0,4,2,2,1,
2,9,2,18,2,21,2,0,2,
1,2,2,1,21,0,0,0,2,
1,1,1,21,0,1,6,2,10,
2,2,2,2,21,2,0,2,9,
1,5,1,1,2,2,21,2,2,
1,1,4,1,2,24,21,0,0,
1,1,1,3,1,21,1,2,0,
2,2,2,2,2,0,21,0,20,
1,1,2,2,2,0,0,21,0,
2,2,2,9,2,2,2,21,0,
1,1,2,2,21,0,3,0,0,
0,0,0,0,0,0,0,0,0,
0,0,0,0,0,0,0,0,0,
0,0,0,0,0,0,0,0,0.
[layer]
type=Tile Layer 2
data=
239,0,0,239,239,239,239,239,239,
226,226,0,226,226,226,226,226,226,
224,224,0,224,224,224,224,224,224,
164,164,164,164,0,164,0,164,164,
205,205,205,205,0,0,0,205,0,
189,189,189,189,0,189,189,189,0,
174,174,174,174,0,174,0,0,0,
159,159,159,159,0,159,0,159,0,
0,199,0,199,0,199,0,199,0,
184,184,0,184,184,184,0,184,184,
0,0,0,0,0,169,0,0,169,
155,155,155,155,0,155,0,155,155,
0,193,193,193,0,193,193,193,0,
0,179,179,179,0,179,179,179,0,
0,165,165,0,165,0,165,165,0,
143,143,143,143,143,143,143,143,0,
188,188,0,188,188,188,188,188,0,
174,174,0,174,174,174,174,174,0,
160,160,0,160,160,160,160,160,0,
146,146,0,146,146,146,146,146,0,
0,182,0,0,0,0,0,182,0,
168,168,168,0,168,168,168,168,168,
155,0,155,0,155,155,155,155,155,
142,0,142,0,142,142,0,142,142,
177,0,177,0,177,177,177,177,177,
163,0,163,0,163,163,163,163,163,
0,0,0,0,150,150,150,0,0,
131,131,131,0,131,131,131,131,131,
0,0,171,0,171,171,171,171,171,
151,151,151,0,151,151,151,151,151,
0,0,0,0,0,145,145,0,145,
127,127,127,127,127,127,127,0,127,
165,0,0,0,165,165,165,0,165,
153,0,153,153,153,0,153,153,153,
141,0,141,141,141,0,0,0,0,
122,0,122,122,122,122,122,122,122,
160,0,0,0,160,160,160,160,160,
148,0,148,148,148,0,148,148,148,
136,0,136,136,136,0,136,136,136,
0,0,124,124,124,124,124,124,124,
0,0,154,154,154,154,154,154,154,
0,0,0,0,0,142,142,142,142,
131,131,131,0,0,131,131,131,131,
120,120,120,0,120,0,120,0,120,
119,119,119,119,0,0,0,0,119,
108,108,108,0,0,108,108,108,108,
107,107,107,107,0,107,0,107,107,
101,101,101,101,101,101,0,101,101,
95,95,95,95,95,0,0,0,0,
94,94,94,94,94,0,94,94,0,
93,93,93,93,93,0,0,0,0,
92,92,92,92,92,0,0,0,0,
91,91,91,91,91,91,91,0,0,
90,90,90,90,0,0,90,0,0,
0,0,0,0,0,0,0,0,0,
0,0,0,0,0,0,0,0,0,
0,0,0,0,0,0,0,0,0.