[layer]
type=Tile Layer 1
data=
1,0,0,21,1,1,1,1,1,
1,0,21,0,0,1,1,1,1,
6,4,1,1,1,1,1,1,21,
0,21,1,0,1,1,0,1,0,
1,0,1,1,1,1,1,1,21,
1,1,1,1,0,0,1,1,21,
0,0,1,0,0,21,1,0,0,
0,21,0,1,1,1,0,0,1,
0,0,0,0,21,1,6,4,1,
0,0,0,0,0,0,0,0,0,
0,0,0,0,0,0,0,0,0,
0,0,0,0,0,0,0,0,0.
[layer]
type=Tile Layer 2
data=
79,0,0,0,79,79,79,79,79,
50,0,0,0,0,50,50,50,50,
44,44,44,44,44,44,44,44,0,
0,0,48,0,48,48,0,48,0,
45,0,45,45,45,45,45,45,0,
47,47,47,47,0,0,47,47,0,
0,0,46,0,0,0,46,0,0,
0,0,0,45,45,45,0,0,45,
0,0,0,0,0,44,44,44,44,
0,0,0,0,0,0,0,0,0,
0,0,0,0,0,0,0,0,0,
0,0,0,0,0,0,0,0,0.