[layer]
type=Tile Layer 1
data=
5,1,3,1,21,1,1,1,0,
0,0,0,0,21,1,0,0,0,
3,1,1,1,21,4,0,1,1,
0,1,3,1,0,1,0,1,21,
0,6,1,6,1,1,21,1,1,
0,1,4,1,0,0,0,21,0,
1,1,4,3,21,1,0,4,1,
0,0,0,0,0,1,21,1,1,
1,5,1,1,1,1,21,1,1,
0,0,0,21,0,0,0,1,1,
0,21,1,1,0,5,3,6,1,
0,0,1,1,21,1,1,3,1,
0,0,1,1,5,0,21,0,4,
3,21,0,0,0,1,1,0,1,
1,1,1,4,1,1,1,21,1,
0,0,1,1,1,0,21,0,5,
0,1,1,1,21,1,1,6,1,
0,0,0,1,0,21,1,5,3,
0,1,21,1,5,1,1,1,4,
0,1,21,0,0,0,0,0,0,
0,4,21,1,1,1,6,1,0,
0,3,0,0,0,0,0,6,21,
21,1,1,1,5,1,1,1,1,
0,1,21,6,1,1,0,0,1,
0,0,0,0,0,0,0,0,0,
0,0,0,0,0,0,0,0,0,
0,0,0,0,0,0,0,0,0.
[layer]
type=Tile Layer 2
data=
132,132,132,132,0,132,132,132,0,
0,0,0,0,0,137,0,0,0,
129,129,129,129,0,129,0,129,129,
0,110,110,110,0,110,0,110,0,
0,96,96,96,96,96,0,96,96,
0,91,91,91,0,0,0,0,0,
108,108,108,108,0,108,0,108,108,
0,0,0,0,0,105,0,105,105,
87,87,87,87,87,87,0,87,87,
0,0,0,0,0,0,0,87,87,
0,0,108,108,0,108,108,108,108,
0,0,99,99,0,99,99,99,99,
0,0,91,91,91,0,0,0,91,
83,0,0,0,0,83,83,0,83,
74,74,74,74,74,74,74,0,74,
0,0,74,74,74,0,0,0,74,
0,69,69,69,0,69,69,69,69,
0,0,0,72,0,0,72,72,72,
0,61,0,61,61,61,61,61,61,
0,63,0,0,0,0,0,0,0,
0,62,0,62,62,62,62,62,0,
0,61,0,0,0,0,0,61,0,
0,55,55,55,55,55,55,55,55,
0,59,0,59,59,59,0,0,59,
0,0,0,0,0,0,0,0,0,
0,0,0,0,0,0,0,0,0,
0,0,0,0,0,0,0,0,0.