[layer]
type=Tile Layer 1
data=
0,1,1,1,21,1,1,1,1,
0,0,0,21,0,0,0,10,24,
1,1,0,1,1,1,21,2,0,
2,7,21,2,2,2,0,2,2,
1,0,0,21,1,0,2,2,1,
2,2,2,21,2,2,20,2,2,
1,1,1,21,2,2,0,2,1,
2,0,21,2,10,20,2,2,2,
19,2,1,2,2,21,8,2,1,
0,2,2,2,2,0,21,2,1,
0,1,2,8,2,1,21,0,0,
0,0,0,2,2,0,0,21,19,
0,0,0,18,0,2,21,2,0,
0,1,1,1,1,1,21,1,1,
0,2,2,2,2,7,2,21,2,
1,1,1,1,21,1,0,1,1,
0,1,0,21,0,1,0,0,0,
0,1,21,1,1,1,1,1,1,
0,0,0,0,0,0,0,0,0,
0,0,0,0,0,0,0,0,0,
0,0,0,0,0,0,0,0,0.
[layer]
type=Tile Layer 2
data=
0,122,122,122,0,122,122,122,122,
0,0,0,0,0,0,0,127,0,
125,125,0,125,125,125,0,125,0,
86,86,0,86,86,86,0,86,86,
107,0,0,0,107,0,107,107,107,
94,94,94,0,94,94,0,94,94,
86,86,86,0,86,86,0,86,86,
82,0,0,82,82,0,82,82,82,
0,81,81,81,81,0,81,81,81,
0,73,73,73,73,0,0,73,73,
0,72,72,72,72,72,0,0,0,
0,0,0,71,71,0,0,0,0,
0,0,0,0,0,63,0,63,0,
0,59,59,59,59,59,0,59,59,
0,61,61,61,61,61,61,0,61,
57,57,57,57,0,57,0,57,57,
0,59,0,0,0,59,0,0,0,
0,56,0,56,56,56,56,56,56,
0,0,0,0,0,0,0,0,0,
0,0,0,0,0,0,0,0,0,
0,0,0,0,0,0,0,0,0.