[layer]
type=Tile Layer 1
data=
0,21,1,1,1,1,1,1,1,
0,21,2,2,2,2,9,2,2,
0,21,1,1,1,2,2,2,1,
0,1,0,1,0,1,1,1,21,
1,1,21,1,0,1,1,1,0,
0,0,0,1,0,0,21,0,0,
1,1,21,1,1,1,1,1,1,
1,1,0,1,0,0,21,0,0,
2,2,21,7,2,2,2,2,0,
1,1,0,21,2,1,0,0,0,
2,2,21,9,2,2,2,2,2,
0,0,21,2,2,1,1,1,1,
1,1,1,1,21,0,0,1,1,
2,2,1,1,1,1,21,0,1,
9,21,2,2,2,2,2,0,2,
2,21,0,0,0,1,1,1,1,
1,1,1,1,0,21,0,0,1,
1,1,1,1,1,1,21,0,1,
1,1,1,21,0,0,0,1,1,
1,1,2,21,0,1,1,1,1,
1,1,2,8,21,1,1,1,1,
7,2,2,2,2,2,2,21,0,
1,1,1,1,1,1,21,1,0,
1,1,1,1,1,1,0,21,0,
1,1,1,1,0,1,21,0,1,
1,1,1,1,0,0,21,0,0,
7,2,2,2,21,2,2,2,0,
1,21,0,0,1,1,0,0,1,
1,0,1,1,1,1,1,21,0,
1,1,21,1,1,1,1,1,0,
2,21,7,2,2,2,2,2,0,
1,21,8,2,1,0,1,1,1,
0,2,2,2,1,21,1,0,1,
1,2,10,21,1,0,1,0,1,
1,0,2,21,1,0,0,0,1,
2,2,2,21,2,0,2,2,7,
1,21,1,0,1,0,2,2,1,
1,21,1,0,1,0,2,8,1,
1,0,0,0,1,0,0,21,0,
0,1,21,0,1,1,1,1,1,
0,2,1,0,21,1,1,1,1,
8,2,21,1,0,0,1,1,1,
2,2,21,1,2,2,2,1,1,
1,1,21,1,2,10,0,0,1,
0,21,0,1,2,2,2,0,0,
0,0,0,0,0,0,0,0,0,
0,0,0,0,0,0,0,0,0,
0,0,0,0,0,0,0,0,0.
[layer]
type=Tile Layer 2
data=
0,0,208,208,208,208,208,208,208,
0,0,206,206,206,206,206,206,206,
0,0,204,204,204,204,204,204,204,
0,178,0,178,0,178,178,178,0,
165,165,0,165,0,165,165,165,0,
0,0,0,152,0,0,0,0,0,
132,132,0,132,132,132,132,132,132,
173,173,0,173,0,0,0,0,0,
160,160,0,160,160,160,160,160,0,
147,147,0,0,147,147,0,0,0,
134,134,0,134,134,134,134,134,134,
0,0,0,167,167,167,167,167,167,
154,154,154,154,0,0,0,154,154,
142,142,142,142,142,142,0,0,142,
130,0,130,130,130,130,130,0,130,
162,0,0,0,0,162,162,162,162,
149,149,149,149,0,0,0,0,149,
137,137,137,137,137,137,0,0,137,
125,125,125,0,0,0,0,125,125,
156,156,156,0,0,156,156,156,156,
144,144,144,144,0,144,144,144,144,
132,132,132,132,132,132,132,0,0,
121,121,121,121,121,121,0,121,0,
150,150,150,150,150,150,0,0,0,
139,139,139,139,0,139,0,0,139,
128,128,128,128,0,0,0,0,0,
116,116,116,116,0,116,116,116,0,
145,0,0,0,145,145,0,0,145,
134,0,134,134,134,134,134,0,0,
123,123,0,123,123,123,123,123,0,
112,0,112,112,112,112,112,112,0,
139,0,139,139,139,0,139,139,139,
0,128,128,128,128,0,128,0,128,
118,118,118,0,118,0,118,0,118,
108,0,108,0,108,0,0,0,108,
107,107,107,0,107,0,107,107,107,
97,0,97,0,97,0,97,97,97,
96,0,96,0,96,0,96,96,96,
95,0,0,0,95,0,0,0,0,
0,85,0,0,85,85,85,85,85,
0,84,84,0,0,84,84,84,84,
83,83,0,83,0,0,83,83,83,
78,78,0,78,78,78,78,78,78,
81,81,0,81,81,81,0,0,81,
0,0,0,80,80,80,80,0,0,
0,0,0,0,0,0,0,0,0,
0,0,0,0,0,0,0,0,0,
0,0,0,0,0,0,0,0,0.