[layer]
type=Tile Layer 1
data=
0,1,0,0,0,0,0,0,21,
0,6,21,1,1,1,1,1,1,
0,4,21,1,1,1,6,3,0,
0,21,0,0,1,1,3,1,1,
0,1,1,21,1,6,3,1,1,
0,1,0,21,0,4,1,1,1,
0,0,1,1,0,21,1,1,1,
5,21,3,1,1,0,0,1,1,
1,21,1,1,1,6,0,1,6,
1,5,6,0,21,0,0,1,1,
0,0,21,0,0,0,4,1,1,
0,0,21,0,1,1,1,1,1,
6,1,1,0,0,0,21,0,3,
1,1,1,21,1,1,1,5,1,
0,0,21,0,1,0,0,0,3,
1,1,1,21,1,5,6,1,1,
0,0,5,21,1,1,4,1,1,
1,21,1,6,4,1,1,1,1,
0,0,0,0,0,0,1,21,0,
4,1,1,6,5,21,5,0,1,
1,1,1,1,1,21,1,0,0,
1,21,1,1,1,5,1,1,0,
0,0,6,1,1,1,1,1,21,
0,0,1,1,4,5,4,1,21,
1,0,21,1,1,1,3,0,5,
0,0,21,1,1,0,0,0,1,
0,1,4,1,4,21,1,1,0,
0,0,0,0,0,0,0,0,0,
0,0,0,0,0,0,0,0,0,
0,0,0,0,0,0,0,0,0.
[layer]
type=Tile Layer 2
data=
0,160,0,0,0,0,0,0,0,
0,158,0,158,158,158,158,158,158,
0,157,0,157,157,157,157,157,0,
0,0,0,0,117,117,117,117,117,
0,107,107,0,107,107,107,107,107,
0,133,0,0,0,133,133,133,133,
0,0,123,123,0,0,123,123,123,
113,0,113,113,113,0,0,113,113,
102,0,102,102,102,102,0,102,102,
128,128,128,0,0,0,0,128,128,
0,0,0,0,0,0,118,118,118,
0,0,0,0,108,108,108,108,108,
98,98,98,0,0,0,0,0,98,
116,116,116,0,116,116,116,116,116,
0,0,0,0,112,0,0,0,112,
98,98,98,0,98,98,98,98,98,
0,0,94,0,94,94,94,94,94,
88,0,88,88,88,88,88,88,88,
0,0,0,0,0,0,84,0,0,
83,83,83,83,83,0,83,0,83,
82,82,82,82,82,0,82,0,0,
73,0,73,73,73,73,73,73,0,
0,0,72,72,72,72,72,72,0,
0,0,71,71,71,71,71,71,0,
70,0,0,70,70,70,70,0,70,
0,0,0,69,69,0,0,0,69,
0,68,68,68,68,0,68,68,0,
0,0,0,0,0,0,0,0,0,
0,0,0,0,0,0,0,0,0,
0,0,0,0,0,0,0,0,0.