[layer]
type=Tile Layer 1
data=
1,1,1,1,1,5,4,21,1,
0,0,4,6,1,0,5,21,1,
1,1,1,1,1,21,1,0,1,
1,0,0,21,0,0,3,0,0,
1,1,1,1,6,21,5,0,1,
1,21,0,0,1,0,1,0,0,
1,1,0,0,0,21,0,3,1,
1,3,0,0,0,1,0,21,0,
5,1,1,1,1,21,6,1,0,
1,1,1,1,5,21,6,1,0,
1,5,1,0,21,1,1,1,0,
0,21,0,0,1,4,0,1,0,
0,1,1,1,1,21,5,1,1,
0,1,1,5,1,21,1,1,4,
0,0,0,0,21,0,6,1,1,
0,6,6,1,1,1,0,1,21,
0,0,21,3,0,0,0,1,0,
1,1,4,1,1,1,1,1,21,
0,1,0,0,21,0,0,0,0,
0,1,21,1,6,1,1,1,5,
0,1,21,3,1,1,0,1,0,
0,0,0,0,0,0,0,0,0,
0,0,0,0,0,0,0,0,0,
0,0,0,0,0,0,0,0,0.
[layer]
type=Tile Layer 2
data=
120,120,120,120,120,120,120,0,120,
0,0,132,132,132,0,132,0,132,
124,124,124,124,124,0,124,0,124,
113,0,0,0,0,0,113,0,0,
99,99,99,99,99,0,99,0,99,
95,0,0,0,95,0,95,0,0,
86,86,0,0,0,0,0,86,86,
107,107,0,0,0,107,0,0,0,
94,94,94,94,94,0,94,94,0,
86,86,86,86,86,0,86,86,0,
82,82,82,0,0,82,82,82,0,
0,0,0,0,81,81,0,81,0,
0,69,69,69,69,0,69,69,69,
0,68,68,68,68,0,68,68,68,
0,0,0,0,0,0,71,71,71,
0,63,63,63,63,63,0,63,0,
0,0,0,62,0,0,0,62,0,
55,55,55,55,55,55,55,55,0,
0,60,0,0,0,0,0,0,0,
0,57,0,57,57,57,57,57,57,
0,58,0,58,58,58,0,58,0,
0,0,0,0,0,0,0,0,0,
0,0,0,0,0,0,0,0,0,
0,0,0,0,0,0,0,0,0.