[layer]
type=Tile Layer 1
data=
0,19,2,1,1,1,21,1,1,
0,2,2,1,1,1,21,1,1,
0,1,1,1,1,1,21,1,1,
0,1,1,1,1,1,21,1,1,
21,1,1,2,2,2,1,1,1,
0,0,1,0,19,2,0,1,21,
21,1,1,2,2,2,1,1,1,
0,1,1,1,21,0,0,0,0,
0,1,1,1,21,1,1,1,1,
0,0,0,1,21,0,0,1,0,
2,2,21,2,2,2,2,2,18,
0,1,0,1,1,1,1,1,21,
1,1,1,21,1,1,1,0,1,
1,0,21,0,1,0,0,0,1,
1,21,1,2,2,0,1,1,1,
1,0,0,0,24,21,1,0,0,
1,1,1,1,1,1,1,21,1,
0,0,0,0,0,0,0,21,1,
1,1,1,1,1,1,21,1,1,
0,0,1,0,0,0,0,21,0,
2,2,1,21,1,1,1,1,1,
19,0,0,0,0,0,1,21,0,
2,21,1,1,1,1,1,0,2,
1,21,1,1,1,1,1,0,24,
1,1,1,1,1,1,1,21,1,
0,0,0,21,1,0,0,0,1,
1,1,1,1,1,1,1,21,1,
0,0,0,0,0,0,0,0,0,
0,0,0,0,0,0,0,0,0,
0,0,0,0,0,0,0,0,0.
[layer]
type=Tile Layer 2
data=
0,0,160,160,160,160,0,160,160,
0,158,158,158,158,158,0,158,158,
0,157,157,157,157,157,0,157,157,
0,117,117,117,117,117,0,117,117,
0,102,102,102,102,102,102,102,102,
0,0,133,0,0,133,0,133,0,
0,117,117,117,117,117,117,117,117,
0,113,113,113,0,0,0,0,0,
0,102,102,102,0,102,102,102,102,
0,0,0,128,0,0,0,128,0,
118,118,0,118,118,118,118,118,0,
0,108,0,108,108,108,108,108,0,
98,98,98,0,98,98,98,0,98,
122,0,0,0,122,0,0,0,122,
112,0,112,112,112,0,112,112,112,
103,0,0,0,0,0,103,0,0,
89,89,89,89,89,89,89,0,89,
0,0,0,0,0,0,0,0,93,
80,80,80,80,80,80,0,80,80,
0,0,83,0,0,0,0,0,0,
78,78,78,0,78,78,78,78,78,
0,0,0,0,0,0,73,0,0,
72,0,72,72,72,72,72,0,72,
71,0,71,71,71,71,71,0,0,
67,67,67,67,67,67,67,0,67,
0,0,0,0,69,0,0,0,69,
65,65,65,65,65,65,65,0,65,
0,0,0,0,0,0,0,0,0,
0,0,0,0,0,0,0,0,0,
0,0,0,0,0,0,0,0,0.