[layer]
type=Tile Layer 1
data=
5,1,0,0,0,21,0,1,1,
3,6,1,1,1,21,0,1,1,
1,3,21,5,1,1,1,1,1,
1,1,21,1,5,0,2,2,1,
1,1,1,0,4,21,24,0,0,
1,6,1,4,1,21,1,1,0,
1,0,21,0,0,0,1,1,3,
0,0,1,5,21,1,1,6,1,
0,1,1,1,21,0,0,0,0,
2,0,2,0,21,0,2,0,20,
1,21,1,1,5,1,3,2,2,
2,0,18,0,0,0,0,21,0,
1,1,1,3,1,6,4,3,21,
0,0,1,1,1,1,6,21,0,
1,21,1,1,1,1,1,0,1,
1,21,4,1,6,1,1,0,1,
2,21,2,2,2,2,2,18,2,
1,0,1,21,0,0,0,0,19,
1,0,1,0,0,21,1,0,0,
1,21,1,1,2,2,2,1,3,
4,21,0,0,2,24,0,0,1,
1,1,1,0,1,21,1,0,5,
0,21,3,0,0,0,1,0,4,
4,1,1,21,1,1,1,0,1,
1,0,2,0,0,21,1,0,0,
1,21,19,2,6,0,1,4,5,
1,21,2,0,1,0,1,0,1,
2,2,2,0,2,0,21,18,0,
1,6,1,21,1,1,1,0,5,
2,0,0,18,0,21,2,0,2,
5,1,1,1,3,21,1,0,1,
1,1,1,1,4,21,5,0,1,
1,1,1,1,1,21,1,0,4,
0,0,0,0,0,0,0,0,0,
0,0,0,0,0,0,0,0,0,
0,0,0,0,0,0,0,0,0.
[layer]
type=Tile Layer 2
data=
171,171,0,0,0,0,0,171,171,
170,170,170,170,170,0,0,170,170,
160,160,0,160,160,160,160,160,160,
147,147,0,147,147,0,147,147,147,
135,135,135,0,135,0,0,0,0,
124,124,124,124,124,0,124,124,0,
113,0,0,0,0,0,113,113,113,
0,0,141,141,0,141,141,141,141,
0,130,130,130,0,0,0,0,0,
119,0,119,0,0,0,119,0,0,
104,0,104,104,104,104,104,104,104,
135,0,0,0,0,0,0,0,0,
119,119,119,119,119,119,119,119,0,
0,0,115,115,115,115,115,0,0,
104,0,104,104,104,104,104,0,104,
130,0,130,130,130,130,130,0,130,
120,0,120,120,120,120,120,0,120,
110,0,110,0,0,0,0,0,0,
100,0,100,0,0,0,100,0,0,
118,0,118,118,118,118,118,118,118,
114,0,0,0,114,0,0,0,114,
105,105,105,0,105,0,105,0,105,
0,0,96,0,0,0,96,0,96,
95,95,95,0,95,95,95,0,95,
86,0,86,0,0,0,86,0,0,
85,0,0,85,85,0,85,85,85,
84,0,84,0,84,0,84,0,84,
75,75,75,0,75,0,0,0,0,
74,74,74,0,74,74,74,0,74,
73,0,0,0,0,0,73,0,73,
72,72,72,72,72,0,72,0,72,
71,71,71,71,71,0,71,0,71,
70,70,70,70,70,0,70,0,70,
0,0,0,0,0,0,0,0,0,
0,0,0,0,0,0,0,0,0,
0,0,0,0,0,0,0,0,0.