[layer]
type=Tile Layer 1
data=
1,1,1,1,21,1,1,1,1,
0,0,21,1,0,1,1,1,1,
1,1,21,1,1,1,1,1,1,
1,1,0,1,0,0,21,0,0,
1,1,21,1,1,1,1,1,1,
0,1,0,1,21,1,1,1,1,
1,1,1,1,21,1,1,1,1,
0,1,0,21,1,1,1,0,1,
1,1,1,1,21,1,1,1,1,
0,0,1,1,0,21,1,1,1,
0,21,1,1,1,0,0,0,1,
0,0,1,1,0,0,1,1,21,
0,21,1,1,1,1,0,1,0,
0,21,0,1,1,1,1,0,0,
0,1,1,1,1,1,1,1,21,
0,0,0,0,1,1,1,1,21,
0,0,1,21,0,0,0,0,0,
1,21,0,0,0,0,0,0,0,
1,21,1,1,1,1,1,0,1,
1,21,1,1,1,1,1,0,1,
1,1,1,1,1,1,1,21,1,
0,0,1,1,1,1,1,21,1,
1,1,1,1,1,1,1,21,1,
0,0,0,0,0,0,21,0,1,
1,1,1,21,1,1,1,0,1,
1,1,1,0,1,0,0,21,0,
1,1,1,21,1,1,1,1,1,
1,21,1,1,1,0,1,1,1,
0,0,1,0,1,0,1,1,21,
1,1,1,21,1,0,1,1,1,
1,1,1,0,1,0,1,21,0,
1,1,1,21,1,0,1,1,1,
1,1,1,0,1,0,21,0,1,
1,1,1,21,1,1,1,1,1,
1,0,21,0,1,1,1,1,1,
1,1,1,21,1,1,1,1,1,
1,1,1,1,1,1,21,0,0,
1,1,1,1,0,0,0,21,0,
0,0,0,21,0,1,1,1,0,
1,1,0,0,1,1,21,0,0,
1,1,1,21,1,1,1,1,0,
1,1,1,21,0,0,0,0,0,
0,0,21,0,1,1,1,1,1,
0,1,1,1,21,1,1,0,0,
1,1,1,1,1,21,0,0,0,
1,1,1,1,1,1,1,21,1,
0,21,1,1,1,1,1,0,1,
1,21,1,1,1,1,1,0,1,
0,21,1,0,0,0,0,0,0,
1,1,1,21,1,0,1,1,1,
1,1,1,21,1,0,1,1,1,
0,0,0,0,0,0,0,0,0,
0,0,0,0,0,0,0,0,0,
0,0,0,0,0,0,0,0,0.
[layer]
type=Tile Layer 2
data=
223,223,223,223,0,223,223,223,223,
0,0,0,233,0,233,233,233,233,
220,220,0,220,220,220,220,220,220,
174,174,0,174,0,0,0,0,0,
152,152,0,152,152,152,152,152,152,
0,199,0,199,0,199,199,199,199,
175,175,175,175,0,175,175,175,175,
0,169,0,0,169,169,169,0,169,
147,147,147,147,0,147,147,147,147,
0,0,193,193,0,0,193,193,193,
0,0,179,179,179,0,0,0,179,
0,0,165,165,0,0,165,165,0,
0,0,150,150,150,150,0,150,0,
0,0,0,188,188,188,188,0,0,
0,174,174,174,174,174,174,174,0,
0,0,0,0,160,160,160,160,0,
0,0,146,0,0,0,0,0,0,
182,0,0,0,0,0,0,0,0,
168,0,168,168,168,168,168,0,168,
155,0,155,155,155,155,155,0,155,
135,135,135,135,135,135,135,0,135,
0,0,177,177,177,177,177,0,177,
155,155,155,155,155,155,155,0,155,
0,0,0,0,0,0,0,0,150,
137,137,137,0,137,137,137,0,137,
171,171,171,0,171,0,0,0,0,
151,151,151,0,151,151,151,151,151,
145,0,145,145,145,0,145,145,145,
0,0,133,0,133,0,133,133,0,
165,165,165,0,165,0,165,165,165,
153,153,153,0,153,0,153,0,0,
141,141,141,0,141,0,141,141,141,
128,128,128,0,128,0,0,0,128,
152,152,152,0,152,152,152,152,152,
148,0,0,0,148,148,148,148,148,
129,129,129,0,129,129,129,129,129,
124,124,124,124,124,124,0,0,0,
154,154,154,154,0,0,0,0,0,
0,0,0,0,0,142,142,142,0,
131,131,0,0,131,131,0,0,0,
120,120,120,0,120,120,120,120,0,
119,119,119,0,0,0,0,0,0,
0,0,0,0,108,108,108,108,108,
0,107,107,107,0,107,107,0,0,
106,106,106,106,106,0,0,0,0,
91,91,91,91,91,91,91,0,91,
0,0,94,94,94,94,94,0,94,
93,0,93,93,93,93,93,0,93,
0,0,92,0,0,0,0,0,0,
91,91,91,0,91,0,91,91,91,
90,90,90,0,90,0,90,90,90,
0,0,0,0,0,0,0,0,0,
0,0,0,0,0,0,0,0,0,
0,0,0,0,0,0,0,0,0.