[layer]
type=Tile Layer 1
data=
2,2,2,2,2,7,2,2,21,
0,0,21,4,3,4,3,3,0,
5,5,21,1,5,1,4,1,5,
6,6,0,0,0,4,0,21,0,
5,1,21,6,4,1,2,2,0,
5,1,0,4,0,21,0,8,0,
6,5,1,1,1,5,21,2,0,
1,4,1,6,0,2,2,1,21,
0,6,5,4,2,10,2,1,21,
1,4,1,4,2,21,2,1,1,
0,6,5,5,21,5,1,4,6,
0,21,0,1,0,5,1,6,0,
0,5,1,6,21,5,5,1,0,
0,5,3,6,21,1,6,6,0,
0,2,2,2,0,1,3,3,21,
0,2,8,2,21,0,0,6,0,
2,7,2,2,21,2,2,2,0,
0,21,0,3,0,0,0,0,0,
5,21,0,0,5,0,6,0,4,
4,1,6,21,4,6,6,0,1,
0,0,5,0,0,0,0,21,1,
4,21,5,3,4,1,3,3,4,
1,0,0,21,0,0,3,0,2,
4,5,1,5,1,21,5,2,8,
0,21,1,0,4,0,6,2,2,
8,2,5,0,6,21,2,2,5,
2,2,4,21,1,2,10,2,0,
1,5,21,0,0,2,2,0,5,
0,0,0,0,21,0,0,0,6,
0,0,6,4,5,6,21,4,1,
4,21,2,2,2,6,0,5,1,
2,21,2,9,2,2,2,0,2,
0,0,2,2,2,1,6,21,0,
0,1,21,4,3,5,5,1,0,
1,3,21,4,4,4,3,1,1,
5,3,1,1,1,4,5,21,0,
1,6,0,21,0,2,2,5,5,
6,1,21,3,2,10,2,0,0,
3,0,21,2,2,2,2,5,0,
0,0,2,10,2,3,6,4,21,
0,2,2,9,2,2,2,21,2,
3,6,21,2,2,1,0,1,0,
0,0,0,0,0,0,0,0,0,
0,0,0,0,0,0,0,0,0,
0,0,0,0,0,0,0,0,0.
[layer]
type=Tile Layer 2
data=
203,203,203,203,203,203,203,203,0,
0,0,0,201,201,201,201,201,0,
190,190,0,190,190,190,190,190,190,
138,138,0,0,0,138,0,0,0,
173,173,0,138,173,138,173,173,0,
160,160,0,128,0,0,0,160,0,
147,147,7,117,7,117,0,147,0,
6,107,6,107,0,107,107,107,0,
0,167,134,167,167,167,134,167,0,
7,123,7,123,154,0,123,7,7,
0,142,142,142,0,142,142,142,142,
0,0,0,130,0,130,130,130,0,
0,162,162,162,0,162,162,162,0,
0,149,149,149,0,149,149,149,0,
0,137,137,137,0,137,137,137,0,
0,125,125,125,0,0,0,125,0,
156,156,156,156,0,156,156,156,0,
0,0,0,144,0,0,0,0,0,
132,0,0,0,132,0,132,0,132,
121,121,121,0,121,121,121,0,121,
0,0,150,0,0,0,0,0,150,
132,0,132,132,132,132,132,132,132,
128,0,0,0,0,0,128,0,128,
116,116,116,116,116,0,116,116,116,
0,0,145,0,145,0,145,145,145,
134,134,134,0,134,0,134,134,134,
123,123,123,0,123,123,123,123,0,
112,112,0,0,0,112,112,0,112,
0,0,0,0,0,0,0,0,139,
0,0,128,128,128,128,0,128,128,
118,0,118,118,94,118,0,118,118,
108,0,108,86,86,86,108,0,108,
0,0,85,85,85,85,85,0,0,
0,4,0,77,77,77,77,4,0,
76,76,0,76,76,76,76,4,76,
95,76,4,76,76,76,76,0,0,
85,85,0,0,0,85,85,85,85,
84,84,0,84,84,84,84,0,0,
83,0,0,83,83,83,83,83,0,
0,0,82,82,82,82,82,82,0,
0,81,81,81,81,81,81,0,81,
80,80,0,80,80,80,0,80,0,
0,0,0,0,0,0,0,0,0,
0,0,0,0,0,0,0,0,0,
0,0,0,0,0,0,0,0,0.