[layer]
type=Tile Layer 1
data=
1,1,21,0,1,1,1,1,1,
1,1,21,0,0,1,1,1,1,
1,1,1,1,21,1,1,1,1,
0,0,0,0,21,1,1,1,1,
0,0,1,1,21,1,1,1,1,
1,1,1,1,1,21,0,0,0,
1,21,1,1,1,1,1,1,0,
1,0,21,0,1,1,1,1,0,
1,1,1,1,1,1,1,1,21,
0,0,21,0,1,1,1,0,1,
0,1,1,1,0,0,21,0,1,
0,0,21,0,1,1,1,1,1,
0,21,1,1,1,1,1,1,1,
0,0,0,21,1,1,1,1,1,
1,1,1,21,1,1,1,1,1,
1,1,1,0,0,0,21,0,1,
1,1,1,1,21,0,0,0,1,
1,21,0,0,0,1,1,1,1,
1,21,0,1,1,1,1,1,1,
1,1,21,0,0,1,1,1,1,
1,1,1,1,21,1,1,1,1,
1,1,21,0,0,0,1,1,1,
1,1,1,1,1,21,0,0,0,
1,1,1,1,1,1,0,21,0,
1,1,1,1,1,1,21,0,1,
1,1,1,0,0,21,0,0,1,
1,1,1,21,0,1,1,1,1,
1,1,1,1,21,0,1,1,1,
1,1,1,1,1,21,0,0,0,
1,1,1,1,1,1,1,1,21,
1,0,1,0,21,0,0,1,1,
0,1,1,1,1,1,0,21,1,
0,0,0,0,0,1,1,21,1,
1,1,1,1,0,0,21,0,0,
1,1,1,1,1,1,21,1,0,
1,1,1,1,21,1,0,1,1,
1,1,1,1,0,1,0,21,0,
1,1,1,21,1,1,1,0,0,
1,1,1,0,0,0,21,0,1,
1,1,1,1,1,21,1,1,1,
1,1,1,21,0,0,1,1,1,
1,1,1,21,1,0,1,1,1,
1,21,0,0,1,0,1,0,1,
1,1,1,21,1,1,1,0,1,
1,1,1,21,0,0,1,0,0,
1,1,1,21,1,1,1,1,1,
1,1,1,21,1,1,1,1,1,
1,1,1,21,1,1,1,1,1,
0,0,0,0,21,0,0,0,1,
1,21,1,1,1,1,1,0,1,
1,0,1,1,1,1,1,21,0,
1,21,1,1,1,1,1,0,1,
1,0,1,0,0,21,1,0,0,
1,21,1,0,1,1,1,1,1,
0,0,0,0,0,0,0,0,0,
0,0,0,0,0,0,0,0,0,
0,0,0,0,0,0,0,0,0.
[layer]
type=Tile Layer 2
data=
239,239,0,0,239,239,239,239,239,
237,237,0,0,0,237,237,237,237,
224,224,224,224,0,224,224,224,224,
0,0,0,0,0,164,164,164,164,
0,0,205,205,0,205,205,205,205,
189,189,189,189,189,0,0,0,0,
174,0,174,174,174,174,174,174,0,
159,0,0,0,159,159,159,159,0,
189,189,189,189,189,189,189,189,0,
0,0,0,0,184,184,184,0,184,
0,169,169,169,0,0,0,0,169,
0,0,0,0,155,155,155,155,155,
0,0,193,193,193,193,193,193,193,
0,0,0,0,179,179,179,179,179,
157,157,157,0,157,157,157,157,157,
150,150,150,0,0,0,0,0,150,
188,188,188,188,0,0,0,0,188,
174,0,0,0,0,174,174,174,174,
160,0,0,160,160,160,160,160,160,
146,146,0,0,0,146,146,146,146,
173,173,173,173,0,173,173,173,173,
168,168,0,0,0,0,168,168,168,
155,155,155,155,155,0,0,0,0,
142,142,142,142,142,142,0,0,0,
177,177,177,177,177,177,0,0,177,
163,163,163,0,0,0,0,0,163,
150,150,150,0,0,150,150,150,150,
137,137,137,137,0,0,137,137,137,
171,171,171,171,171,0,0,0,0,
151,151,151,151,151,151,151,151,0,
145,0,145,0,0,0,0,145,145,
0,133,133,133,133,133,0,0,133,
0,0,0,0,0,165,165,0,165,
153,153,153,153,0,0,0,0,0,
141,141,141,141,141,141,0,141,0,
128,128,128,128,0,128,0,128,128,
160,160,160,160,0,160,0,0,0,
148,148,148,0,148,148,148,0,0,
136,136,136,0,0,0,0,0,136,
118,118,118,118,118,0,118,118,118,
154,154,154,0,0,0,154,154,154,
142,142,142,0,142,0,142,142,142,
131,0,0,0,131,0,131,0,131,
120,120,120,0,120,120,120,0,120,
119,119,119,0,0,0,119,0,0,
103,103,103,0,103,103,103,103,103,
102,102,102,0,102,102,102,102,102,
101,101,101,0,101,101,101,101,101,
0,0,0,0,0,0,0,0,95,
94,0,94,94,94,94,94,0,94,
93,0,93,93,93,93,93,0,0,
92,0,92,92,92,92,92,0,92,
91,0,91,0,0,0,91,0,0,
90,0,90,0,90,90,90,90,90,
0,0,0,0,0,0,0,0,0,
0,0,0,0,0,0,0,0,0,
0,0,0,0,0,0,0,0,0.