[layer]
type=Tile Layer 1
data=
2,2,9,2,2,21,2,2,0,
1,21,2,2,1,6,3,1,0,
1,0,0,0,0,0,21,0,0,
1,1,1,2,2,2,1,21,5,
0,21,1,2,8,2,3,0,1,
6,21,1,2,2,2,1,1,1,
1,1,6,21,1,1,1,1,1,
1,3,1,21,5,0,0,0,1,
2,2,2,2,2,21,2,7,2,
0,21,0,0,0,0,2,2,1,
1,1,1,1,1,2,10,21,1,
4,1,5,1,1,21,2,2,6,
1,3,1,1,4,21,8,2,1,
1,0,21,0,0,2,10,2,1,
1,21,1,1,1,2,2,1,5,
1,1,6,21,5,1,4,1,1,
1,1,6,1,21,1,1,1,1,
1,1,1,21,1,1,2,2,1,
0,21,2,2,2,2,9,2,2,
1,21,1,5,1,2,2,2,1,
0,21,2,2,2,2,9,2,2,
2,2,9,21,2,2,2,2,2,
1,2,2,0,21,0,0,0,1,
1,21,4,0,1,5,1,0,1,
0,21,0,0,1,1,1,6,1,
0,5,1,21,0,1,4,5,1,
0,1,1,1,21,0,1,1,1,
0,0,6,1,0,21,1,1,1,
0,21,5,1,0,1,6,1,1,
0,1,1,1,21,2,2,0,4,
0,1,1,1,2,10,21,0,6,
0,21,3,1,2,2,0,0,0,
2,2,21,2,2,2,2,7,0,
4,0,1,1,5,21,0,1,3,
0,0,1,1,21,0,1,1,1,
0,2,2,21,2,2,2,2,7,
0,1,6,1,1,0,0,21,1,
1,0,21,0,1,6,4,0,1,
1,1,3,1,21,1,1,0,1,
0,0,0,0,0,0,0,0,0,
0,0,0,0,0,0,0,0,0,
0,0,0,0,0,0,0,0,0.
[layer]
type=Tile Layer 2
data=
197,197,197,197,197,0,197,197,0,
195,0,195,195,195,195,195,195,0,
194,0,0,0,0,0,0,0,0,
139,139,139,139,139,139,139,0,139,
0,0,133,133,133,133,133,0,133,
158,0,158,158,158,158,158,158,158,
146,146,146,0,146,146,146,146,146,
141,141,141,0,141,0,0,0,141,
129,129,129,129,129,0,129,129,129,
0,0,0,0,0,0,161,161,161,
148,148,148,148,148,148,148,0,148,
130,130,130,130,130,0,130,130,130,
124,124,124,124,124,0,124,124,124,
155,0,0,0,0,155,155,155,155,
143,0,114,114,143,114,114,7,143,
131,6,105,0,131,105,105,6,131,
120,6,96,6,0,6,96,6,120,
149,149,149,0,119,7,149,149,149,
0,0,110,110,110,110,110,110,138,
121,0,121,121,121,121,121,121,121,
0,0,115,115,115,115,115,115,115,
144,144,144,0,144,144,144,144,144,
133,133,133,0,0,0,0,0,133,
122,0,122,0,122,122,122,0,122,
0,0,0,0,111,111,111,111,111,
0,138,138,0,0,138,138,138,138,
0,127,127,127,0,0,127,127,127,
0,0,117,117,0,0,117,117,117,
0,0,107,107,0,107,107,107,107,
0,106,106,106,0,106,106,0,106,
0,96,96,96,96,96,0,0,96,
0,0,95,95,95,95,0,0,0,
94,94,0,94,94,94,94,94,0,
84,0,84,84,84,0,0,84,84,
0,0,83,83,0,0,83,83,83,
0,82,82,0,82,82,82,82,82,
0,81,81,81,81,0,0,0,81,
80,0,0,0,80,80,80,0,80,
79,79,79,79,0,79,79,0,79,
0,0,0,0,0,0,0,0,0,
0,0,0,0,0,0,0,0,0,
0,0,0,0,0,0,0,0,0.