[layer]
type=Tile Layer 1
data=
0,0,0,0,0,1,0,1,21,
0,1,1,1,1,1,21,1,1,
0,1,0,0,0,21,0,1,0,
0,1,0,1,1,1,1,1,21,
0,0,0,1,0,21,0,0,2,
0,2,2,2,2,2,21,2,9,
0,2,2,2,2,2,2,7,21,
0,1,1,1,0,2,2,2,21,
0,2,2,0,0,2,8,2,21,
2,9,2,2,21,2,2,2,0,
1,2,2,1,0,1,1,21,0,
1,0,21,0,0,1,1,0,0,
1,21,1,1,0,0,2,2,1,
0,1,1,0,21,1,2,8,1,
21,1,1,1,1,1,2,2,1,
0,0,0,0,0,0,0,0,0,
0,0,0,0,0,0,0,0,0,
0,0,0,0,0,0,0,0,0.
[layer]
type=Tile Layer 2
data=
0,0,0,0,0,123,0,123,0,
0,115,115,115,115,115,0,115,115,
0,119,0,0,0,0,0,119,0,
0,89,0,89,89,89,89,89,0,
0,0,0,81,0,0,0,0,81,
0,80,80,80,80,80,0,80,80,
0,72,72,72,72,72,72,72,0,
0,71,71,71,0,71,71,71,0,
0,70,70,0,0,70,70,70,0,
62,62,62,62,0,62,62,62,0,
61,61,61,61,0,61,61,0,0,
60,0,0,0,0,60,60,0,0,
59,0,59,59,0,0,59,59,59,
0,58,58,0,0,58,58,58,58,
0,52,52,52,52,52,52,52,52,
0,0,0,0,0,0,0,0,0,
0,0,0,0,0,0,0,0,0,
0,0,0,0,0,0,0,0,0.