[layer]
type=Tile Layer 1
data=
5,5,21,0,5,4,3,1,1,
4,3,3,0,0,0,21,0,0,
3,1,5,1,4,4,5,4,21,
21,1,4,6,1,5,4,4,5,
0,6,5,6,1,5,0,21,0,
0,5,1,4,1,4,0,6,21,
0,0,0,0,21,1,0,6,0,
1,3,6,6,21,3,0,5,3,
0,0,0,5,0,5,0,1,21,
0,4,1,3,0,4,21,6,0,
0,0,0,21,0,3,0,0,0,
21,4,1,3,1,1,6,3,6,
3,0,21,0,0,6,3,5,5,
3,0,0,0,21,0,0,0,0,
1,6,6,6,1,1,5,1,21,
5,1,6,1,5,6,5,4,21,
4,6,21,1,1,1,1,1,0,
0,0,21,6,1,4,4,1,5,
21,3,5,5,1,5,3,4,4,
0,21,4,1,4,3,1,1,4,
1,21,5,3,1,5,4,3,5,
1,3,4,5,4,3,0,21,0,
5,5,1,3,5,4,0,21,0,
4,3,3,0,21,1,1,0,0,
3,1,5,1,0,6,3,21,0,
6,21,0,0,0,3,5,6,0,
1,21,5,1,3,6,5,3,0,
6,0,4,5,1,6,6,21,0,
5,0,6,1,1,4,1,21,0,
4,5,4,5,0,21,0,0,0,
1,1,0,0,21,0,0,3,0,
1,4,21,1,5,5,0,4,0,
3,5,0,4,3,4,0,21,0,
3,4,21,6,1,6,3,6,4,
0,21,1,1,1,4,1,0,0,
3,3,4,6,1,4,21,3,0,
0,0,21,1,1,1,1,1,0,
0,5,3,5,4,4,5,1,21,
0,4,1,1,1,1,1,3,21,
1,6,1,21,6,5,1,3,6,
3,3,5,0,0,21,0,0,3,
6,1,1,0,21,1,5,0,0,
4,1,4,4,21,0,0,0,0,
3,1,3,0,21,0,1,4,3,
6,6,1,21,3,0,6,6,3,
0,0,0,0,0,0,0,0,0,
0,0,0,0,0,0,0,0,0,
0,0,0,0,0,0,0,0,0.
[layer]
type=Tile Layer 2
data=
208,208,0,0,208,208,208,208,208,
206,206,206,0,0,0,0,0,0,
194,194,194,194,194,194,194,194,0,
0,170,170,170,170,170,170,170,170,
0,165,165,165,165,165,0,0,0,
0,152,152,152,152,152,0,152,0,
0,0,0,0,0,138,0,138,0,
173,173,173,173,0,173,0,173,173,
0,0,0,160,0,160,0,160,0,
0,147,147,147,0,147,0,147,0,
0,0,0,0,0,134,0,0,0,
0,159,159,159,159,159,159,159,159,
154,0,0,0,0,154,154,154,154,
142,0,0,0,0,0,0,0,0,
123,99,99,99,123,99,99,99,0,
154,123,123,123,154,123,123,123,0,
149,119,0,7,7,7,7,7,0,
0,0,0,110,110,110,137,137,137,
0,95,95,95,95,95,95,95,119,
0,0,156,156,156,156,156,156,156,
137,0,137,137,137,137,137,137,137,
132,132,132,132,132,132,0,0,0,
121,121,121,121,121,121,0,0,0,
150,150,150,0,0,150,150,0,0,
139,139,139,139,0,139,139,0,0,
128,0,0,0,0,128,128,128,0,
116,0,116,116,116,116,116,116,0,
145,0,145,145,145,145,145,0,0,
134,0,134,134,134,134,134,0,0,
123,123,123,123,0,0,0,0,0,
112,112,0,0,0,0,0,112,0,
139,139,0,139,139,139,0,139,0,
128,128,0,128,128,128,0,0,0,
112,112,0,112,112,112,112,112,112,
0,0,5,86,86,86,5,0,0,
107,107,85,85,85,85,0,107,0,
0,0,0,4,4,4,4,97,0,
0,96,76,76,76,76,76,96,0,
0,95,4,4,4,4,4,95,0,
85,85,4,0,68,68,4,85,85,
84,84,84,0,0,0,0,0,84,
83,83,83,0,0,83,83,0,0,
82,82,82,82,0,0,0,0,0,
81,81,81,0,0,0,81,81,81,
80,80,80,0,80,0,80,80,80,
0,0,0,0,0,0,0,0,0,
0,0,0,0,0,0,0,0,0,
0,0,0,0,0,0,0,0,0.