[layer]
type=Tile Layer 1
data=
0,21,1,1,0,1,1,0,1,
0,1,1,1,0,1,1,21,1,
1,1,1,21,0,0,1,1,1,
0,1,1,1,1,0,21,1,1,
0,0,0,21,1,0,1,0,1,
1,1,1,21,0,0,1,0,1,
0,21,0,1,1,0,1,0,0,
1,1,21,1,1,1,1,1,0,
1,1,0,1,1,1,0,0,21,
0,1,1,1,21,1,0,1,1,
0,0,0,1,0,1,21,1,0,
1,1,21,1,0,1,0,1,1,
0,0,0,0,0,0,0,0,0,
0,0,0,0,0,0,0,0,0,
0,0,0,0,0,0,0,0,0.
[layer]
type=Tile Layer 2
data=
0,0,89,89,0,89,89,0,89,
0,64,64,64,0,64,64,0,64,
63,63,63,0,0,0,63,63,63,
0,62,62,62,62,0,0,62,62,
0,0,0,0,55,0,55,0,55,
54,54,54,0,0,0,54,0,54,
0,0,0,53,53,0,53,0,0,
50,50,0,50,50,50,50,50,0,
51,51,0,51,51,51,0,0,0,
0,50,50,50,0,50,0,50,50,
0,0,0,49,0,49,0,49,0,
48,48,0,48,0,48,0,48,48,
0,0,0,0,0,0,0,0,0,
0,0,0,0,0,0,0,0,0,
0,0,0,0,0,0,0,0,0.