[layer]
type=Tile Layer 1
data=
1,1,1,1,1,1,1,21,1,
1,1,1,1,1,1,1,21,0,
1,1,1,1,1,1,1,1,21,
1,1,1,1,1,1,1,1,21,
0,21,0,1,1,1,1,1,0,
1,1,21,1,1,1,1,1,0,
0,1,0,0,0,1,0,1,21,
0,1,1,1,1,1,0,1,21,
0,21,0,0,0,0,0,1,0,
1,1,1,1,21,1,1,1,0,
1,1,1,1,21,1,1,1,0,
1,1,1,1,21,1,1,1,1,
0,1,1,1,0,1,1,1,21,
0,1,1,1,0,1,1,1,21,
0,1,1,0,1,0,1,1,21,
1,1,1,1,1,1,1,1,21,
1,1,21,1,1,1,1,1,0,
1,1,21,1,1,1,1,1,0,
1,1,21,1,1,1,1,1,0,
1,1,21,1,1,1,1,1,0,
0,1,21,0,0,0,0,0,0,
1,1,1,21,1,1,1,1,1,
1,21,1,0,1,1,1,1,1,
1,21,1,0,1,1,1,1,1,
1,21,1,0,1,1,1,1,1,
1,21,1,0,1,1,1,1,1,
0,0,0,0,1,0,21,0,0,
1,1,1,21,1,1,1,1,1,
0,0,1,21,1,1,1,1,1,
1,1,1,21,1,1,1,1,1,
1,1,1,21,1,1,1,1,1,
1,1,1,0,1,21,0,0,1,
1,1,1,21,1,1,1,0,1,
0,0,0,0,1,21,0,0,1,
1,21,1,1,1,1,1,0,1,
1,21,1,1,1,1,1,0,1,
1,21,1,1,1,1,1,0,1,
1,0,0,0,0,0,1,21,0,
1,1,1,1,1,21,1,1,1,
1,1,1,1,1,0,21,0,0,
1,1,1,1,1,21,0,0,0,
1,1,1,1,1,1,1,21,0,
1,1,1,1,21,1,1,0,0,
1,1,1,1,0,21,0,0,0,
1,1,1,0,0,0,21,0,1,
1,1,1,21,1,1,0,1,1,
0,21,1,0,1,1,1,1,1,
0,1,1,21,1,1,1,1,1,
1,21,0,1,1,1,1,1,1,
1,1,0,21,0,0,1,1,1,
1,1,1,1,1,21,0,1,1,
0,0,0,21,0,0,0,1,1,
21,1,1,1,1,1,1,1,1,
0,0,0,0,21,0,0,1,1,
0,0,0,0,0,0,0,0,0,
0,0,0,0,0,0,0,0,0,
0,0,0,0,0,0,0,0,0.
[layer]
type=Tile Layer 2
data=
227,227,227,227,227,227,227,0,227,
237,237,237,237,237,237,237,0,0,
224,224,224,224,224,224,224,224,0,
156,156,156,156,156,156,156,156,0,
0,0,0,205,205,205,205,205,0,
189,189,0,189,189,189,189,189,0,
0,174,0,0,0,174,0,174,0,
0,159,159,159,159,159,0,159,0,
0,0,0,0,0,0,0,199,0,
184,184,184,184,0,184,184,184,0,
169,169,169,169,0,169,169,169,0,
147,147,147,147,0,147,147,147,147,
0,193,193,193,0,193,193,193,0,
0,179,179,179,0,179,179,179,0,
0,165,165,0,165,0,165,165,0,
143,143,143,143,143,143,143,143,0,
188,188,0,188,188,188,188,188,0,
174,174,0,174,174,174,174,174,0,
160,160,0,160,160,160,160,160,0,
146,146,0,146,146,146,146,146,0,
0,182,0,0,0,0,0,0,0,
160,160,160,0,160,160,160,160,160,
155,0,155,0,155,155,155,155,155,
142,0,142,0,142,142,142,142,142,
177,0,177,0,177,177,177,177,177,
163,0,163,0,163,163,163,163,163,
0,0,0,0,150,0,0,0,0,
131,131,131,0,131,131,131,131,131,
0,0,171,0,171,171,171,171,171,
151,151,151,0,151,151,151,151,151,
138,138,138,0,138,138,138,138,138,
133,133,133,0,133,0,0,0,133,
165,165,165,0,165,165,165,0,165,
0,0,0,0,153,0,0,0,153,
141,0,141,141,141,141,141,0,141,
128,0,128,128,128,128,128,0,128,
160,0,160,160,160,160,160,0,160,
148,0,0,0,0,0,148,0,0,
129,129,129,129,129,0,129,129,129,
124,124,124,124,124,0,0,0,0,
154,154,154,154,154,0,0,0,0,
142,142,142,142,142,142,142,0,0,
131,131,131,131,0,131,131,0,0,
120,120,120,120,0,0,0,0,0,
119,119,119,0,0,0,0,0,119,
108,108,108,0,108,108,0,108,108,
0,0,107,0,107,107,107,107,107,
0,106,106,0,106,106,106,106,106,
95,0,0,95,95,95,95,95,95,
94,94,0,0,0,0,94,94,94,
93,93,93,93,93,0,0,93,93,
0,0,0,0,0,0,0,92,92,
0,87,87,87,87,87,87,87,87,
0,0,0,0,0,0,0,90,90,
0,0,0,0,0,0,0,0,0,
0,0,0,0,0,0,0,0,0,
0,0,0,0,0,0,0,0,0.