[layer]
type=Tile Layer 1
data=
4,1,1,0,0,0,0,21,0,
5,5,5,21,1,1,5,1,3,
4,4,3,21,3,4,5,3,3,
0,5,0,4,5,1,1,5,21,
0,21,0,1,5,6,4,4,0,
6,6,21,6,4,5,1,4,1,
0,3,0,0,0,21,0,0,0,
0,5,21,1,4,5,5,3,1,
0,4,0,0,0,0,0,21,0,
21,3,6,1,4,4,1,3,6,
1,1,1,1,1,3,21,1,1,
4,1,1,3,3,4,6,21,6,
1,3,3,6,6,3,21,1,4,
0,4,3,6,6,1,21,4,1,
0,6,3,1,1,4,21,0,4,
0,0,0,0,6,1,5,0,21,
5,3,5,21,3,1,3,3,0,
1,1,6,5,6,0,0,21,0,
6,3,3,4,6,21,0,0,4,
3,6,3,1,1,0,0,21,0,
1,4,4,6,0,21,0,1,0,
5,4,1,4,5,0,0,21,0,
4,5,6,6,5,4,6,21,0,
1,1,5,6,1,0,21,0,4,
0,0,0,21,0,0,6,3,1,
21,6,6,3,1,1,5,5,6,
0,21,3,5,3,1,3,5,6,
3,21,0,0,0,0,0,3,1,
1,4,5,1,0,21,0,1,5,
3,3,3,4,21,5,4,4,5,
5,1,21,5,1,3,3,4,5,
0,0,0,4,0,0,0,21,0,
5,3,21,4,0,1,3,1,4,
0,21,0,1,1,1,3,5,6,
5,6,1,3,21,3,6,3,1,
0,0,1,6,21,5,1,0,0,
1,4,21,5,1,5,5,5,5,
6,6,1,6,1,1,21,1,1,
4,6,21,6,1,1,4,4,1,
5,4,5,3,3,0,21,0,0,
4,1,4,4,5,21,1,1,0,
5,5,3,1,1,3,4,3,21,
1,4,1,3,4,0,21,0,0,
3,6,4,1,0,21,0,6,3,
3,6,4,6,0,1,21,0,0,
0,0,0,0,0,0,0,0,0,
0,0,0,0,0,0,0,0,0,
0,0,0,0,0,0,0,0,0.
[layer]
type=Tile Layer 2
data=
208,208,208,0,0,0,0,0,0,
196,196,196,0,196,196,196,196,196,
194,194,194,0,194,194,194,194,194,
0,178,0,178,178,178,178,178,0,
0,0,0,165,165,165,165,165,0,
144,144,0,144,144,144,144,144,144,
0,138,0,0,0,0,0,0,0,
0,173,0,173,173,173,173,173,173,
0,160,0,0,0,0,0,0,0,
0,112,112,112,112,112,112,112,112,
6,6,6,6,6,107,0,6,6,
127,127,127,127,127,127,127,0,127,
7,123,123,123,123,123,0,123,123,
0,142,142,142,142,142,0,142,142,
0,130,130,130,130,130,0,0,130,
0,0,0,0,162,162,162,0,0,
149,149,149,0,149,149,149,149,0,
137,137,137,137,137,0,0,0,0,
125,125,125,125,125,0,0,0,125,
156,156,156,156,156,0,0,0,0,
144,144,144,144,0,0,0,144,0,
132,132,132,132,132,0,0,0,0,
121,121,121,121,121,121,121,0,0,
150,150,150,150,150,0,0,0,150,
0,0,0,0,0,0,139,139,139,
0,122,122,122,122,122,122,122,122,
0,0,116,116,116,116,116,116,116,
145,0,0,0,0,0,0,145,145,
134,134,134,134,0,0,0,134,134,
117,117,117,117,0,117,117,117,117,
107,107,0,107,107,107,107,107,107,
0,0,0,139,0,0,0,0,0,
128,128,0,128,0,128,128,128,128,
0,0,0,118,5,118,118,118,118,
103,103,103,82,0,82,103,103,103,
0,0,5,85,0,85,5,0,0,
97,77,0,77,4,77,77,77,97,
76,76,4,76,4,4,0,4,4,
90,72,0,72,72,72,72,72,90,
85,85,85,85,85,0,0,0,0,
84,84,84,84,84,0,84,84,0,
79,79,79,79,79,79,79,79,0,
82,82,82,82,82,0,0,0,0,
81,81,81,81,0,0,0,81,81,
80,80,80,80,0,80,0,0,0,
0,0,0,0,0,0,0,0,0,
0,0,0,0,0,0,0,0,0,
0,0,0,0,0,0,0,0,0.