[layer]
type=Tile Layer 1
data=
1,0,21,1,1,1,0,1,1,
1,0,0,21,2,2,2,0,1,
2,2,2,2,2,9,2,21,0,
1,2,2,2,2,2,0,21,0,
1,2,8,0,0,21,0,1,0,
1,2,2,2,1,1,21,1,0,
1,0,21,0,0,0,1,1,0,
2,2,21,2,2,2,2,7,0,
2,2,21,2,2,2,2,0,7,
2,2,1,1,1,1,1,1,1,
8,2,21,1,1,0,1,0,1,
0,2,0,1,1,0,1,21,0,
0,0,1,1,1,1,1,0,21,
0,1,1,0,21,0,1,1,0,
0,1,1,0,21,0,1,1,0,
0,0,0,0,0,0,0,0,0,
0,0,0,0,0,0,0,0,0,
0,0,0,0,0,0,0,0,0.
[layer]
type=Tile Layer 2
data=
121,0,0,121,121,121,0,121,121,
119,0,0,0,119,119,119,0,119,
118,118,118,118,118,118,118,0,0,
88,88,88,88,88,88,0,0,0,
80,80,80,0,0,0,0,80,0,
75,75,75,75,75,75,0,75,0,
71,0,0,0,0,0,71,71,0,
70,70,0,70,70,70,70,70,0,
69,69,0,69,69,69,69,0,69,
52,52,52,52,52,52,52,52,52,
61,61,0,61,61,0,61,0,61,
0,60,0,60,60,0,60,0,0,
0,0,59,59,59,59,59,0,0,
0,58,58,0,0,0,58,58,0,
0,57,57,0,0,0,57,57,0,
0,0,0,0,0,0,0,0,0,
0,0,0,0,0,0,0,0,0,
0,0,0,0,0,0,0,0,0.