[layer]
type=Tile Layer 1
data=
1,1,1,0,0,0,21,0,0,
1,1,1,21,1,1,1,1,1,
0,0,1,21,1,1,1,1,1,
1,21,1,1,1,1,1,1,1,
1,0,21,0,1,1,1,1,1,
1,1,1,21,1,1,1,1,1,
1,0,0,0,21,0,0,0,1,
1,1,1,1,1,21,1,1,1,
1,1,1,21,1,0,1,1,1,
0,21,1,1,1,1,1,1,0,
1,0,1,1,1,1,21,0,1,
0,0,0,1,0,1,21,0,0,
1,1,0,1,0,21,1,1,0,
1,1,21,0,0,1,1,0,0,
1,1,1,1,21,0,0,1,1,
0,0,21,0,0,0,0,1,1,
0,1,21,0,1,1,1,1,1,
0,0,1,0,0,0,1,0,21,
1,1,1,1,21,1,1,1,0,
1,1,1,1,21,1,1,1,0,
1,1,1,1,21,1,1,1,0,
1,1,1,1,21,1,1,1,0,
1,1,1,1,21,1,1,1,0,
0,21,0,0,0,1,1,0,1,
1,1,21,1,1,1,1,1,1,
0,1,0,1,0,0,0,0,21,
0,1,21,1,0,1,1,1,0,
1,1,1,1,1,1,21,1,1,
0,1,1,1,1,1,21,0,0,
21,1,1,1,1,1,1,1,1,
0,1,1,1,1,1,21,1,1,
0,1,1,1,1,1,21,1,1,
0,21,0,1,0,0,0,1,1,
0,1,1,1,21,1,1,1,1,
0,0,0,1,0,1,21,0,0,
1,1,1,1,21,1,1,1,1,
1,0,0,21,1,0,0,1,1,
1,1,0,1,21,1,0,0,0,
1,1,0,1,21,1,1,1,0,
1,0,1,1,1,21,0,1,0,
1,21,0,1,1,1,1,1,0,
0,1,1,1,1,0,21,1,0,
0,0,0,1,1,1,1,21,0,
0,1,1,1,0,21,0,0,1,
0,0,0,0,1,1,0,21,1,
1,1,1,21,1,1,1,1,1,
1,1,1,21,1,1,1,1,1,
0,0,21,0,1,1,1,1,1,
1,1,1,21,1,1,1,1,1,
1,0,0,0,0,0,0,21,0,
1,1,1,1,1,1,1,21,1,
0,0,0,0,0,0,0,0,0,
0,0,0,0,0,0,0,0,0,
0,0,0,0,0,0,0,0,0.
[layer]
type=Tile Layer 2
data=
234,234,234,0,0,0,0,0,0,
221,221,221,0,221,221,221,221,221,
0,0,231,0,231,231,231,231,231,
166,0,166,166,166,166,166,166,166,
159,0,0,0,159,159,159,159,159,
189,189,189,0,189,189,189,189,189,
184,0,0,0,0,0,0,0,184,
161,161,161,161,161,0,161,161,161,
155,155,155,0,155,0,155,155,155,
0,0,193,193,193,193,193,193,0,
179,0,179,179,179,179,0,0,179,
0,0,0,165,0,165,0,0,0,
150,150,0,150,0,0,150,150,0,
188,188,0,0,0,188,188,0,0,
174,174,174,174,0,0,0,174,174,
0,0,0,0,0,0,0,160,160,
0,146,0,0,146,146,146,146,146,
0,0,182,0,0,0,182,0,0,
168,168,168,168,0,168,168,168,0,
155,155,155,155,0,155,155,155,0,
142,142,142,142,0,142,142,142,0,
177,177,177,177,0,177,177,177,0,
163,163,163,163,0,163,163,163,0,
0,0,0,0,0,150,150,0,150,
131,131,0,131,131,131,131,131,131,
0,171,0,171,0,0,0,0,0,
0,158,0,158,0,158,158,158,0,
138,138,138,138,138,138,0,138,138,
0,133,133,133,133,133,0,0,0,
0,157,157,157,157,157,157,157,157,
0,153,153,153,153,153,0,153,153,
0,141,141,141,141,141,0,141,141,
0,0,0,128,0,0,0,128,128,
0,160,160,160,0,160,160,160,160,
0,0,0,148,0,148,0,0,0,
129,129,129,129,0,129,129,129,129,
124,0,0,0,124,0,0,124,124,
154,154,0,154,0,154,0,0,0,
142,142,0,142,0,142,142,142,0,
131,0,131,131,131,0,0,131,0,
120,0,0,120,120,120,120,120,0,
0,119,119,119,119,0,0,119,0,
0,0,0,108,108,108,108,0,0,
0,107,107,107,0,0,0,0,107,
0,0,0,0,106,106,0,0,106,
91,91,91,0,91,91,91,91,91,
90,90,90,0,90,90,90,90,90,
0,0,0,0,93,93,93,93,93,
88,88,88,0,88,88,88,88,88,
91,0,0,0,0,0,0,0,0,
86,86,86,86,86,86,86,0,86,
0,0,0,0,0,0,0,0,0,
0,0,0,0,0,0,0,0,0,
0,0,0,0,0,0,0,0,0.