[layer]
type=Tile Layer 1
data=
0,21,0,0,0,0,1,1,1,
1,1,1,21,1,0,1,1,1,
1,1,1,0,1,21,1,0,0,
1,1,1,1,1,21,1,1,1,
1,1,1,21,1,0,1,1,1,
1,1,1,21,1,0,1,1,1,
1,1,1,1,0,21,0,0,1,
0,0,0,1,21,1,0,0,1,
1,1,21,0,0,0,0,1,1,
0,21,1,1,1,1,1,1,1,
0,1,1,0,21,1,1,1,1,
1,0,0,1,21,0,0,0,0,
1,1,21,0,0,1,1,1,0,
1,1,1,1,1,21,0,0,0,
1,1,1,0,21,0,1,1,0,
1,1,1,1,1,1,21,1,1,
0,1,0,0,0,0,21,1,1,
21,1,1,1,1,1,1,1,1,
1,1,21,1,0,0,0,0,1,
21,1,1,1,1,1,1,1,1,
0,1,21,1,0,1,0,1,0,
0,1,1,1,1,1,21,1,1,
0,1,1,1,1,1,0,1,21,
21,1,1,1,1,1,1,1,1,
0,0,0,21,0,1,0,1,0,
1,1,1,1,1,1,21,1,0,
0,1,1,1,1,1,0,1,21,
0,1,1,1,1,1,21,1,1,
0,1,0,1,0,0,1,21,0,
1,1,21,1,1,1,1,1,0,
0,1,21,1,1,1,1,1,0,
1,1,21,1,1,1,1,1,1,
0,21,0,1,1,1,1,1,0,
0,21,0,0,0,0,1,1,1,
0,0,0,21,1,0,0,1,1,
1,1,1,21,1,1,0,1,1,
1,0,0,0,1,1,0,21,0,
1,0,1,1,1,1,21,0,0,
1,1,0,0,0,21,0,1,1,
1,1,1,1,1,21,0,0,0,
1,1,1,1,1,21,1,0,0,
1,1,0,0,0,21,1,0,1,
1,1,0,1,21,1,1,1,0,
1,1,1,1,1,1,1,1,21,
1,0,21,1,1,0,0,0,0,
1,1,1,1,1,1,21,1,1,
0,0,0,1,1,1,21,1,1,
1,1,1,1,1,1,21,1,1,
0,0,0,0,0,0,0,0,0,
0,0,0,0,0,0,0,0,0,
0,0,0,0,0,0,0,0,0.
[layer]
type=Tile Layer 2
data=
0,0,0,0,0,0,228,228,228,
227,227,227,0,227,0,227,227,227,
225,225,225,0,225,0,225,0,0,
174,174,174,174,174,0,174,174,174,
168,168,168,0,168,0,168,168,168,
154,154,154,0,154,0,154,154,154,
192,192,192,192,0,0,0,0,192,
0,0,0,178,0,178,0,0,178,
164,164,0,0,0,0,0,164,164,
0,0,149,149,149,149,149,149,149,
0,187,187,0,0,187,187,187,187,
173,0,0,173,0,0,0,0,0,
159,159,0,0,0,159,159,159,0,
145,145,145,145,145,0,0,0,0,
181,181,181,0,0,0,181,181,0,
159,159,159,159,159,159,0,159,159,
0,154,0,0,0,0,0,154,154,
0,134,134,134,134,134,134,134,134,
176,176,0,176,0,0,0,0,176,
0,154,154,154,154,154,154,154,154,
0,149,0,149,0,149,0,149,0,
0,136,136,136,136,136,0,136,136,
0,170,170,170,170,170,0,170,0,
0,150,150,150,150,150,150,150,150,
0,0,0,0,0,144,0,144,0,
132,132,132,132,132,132,0,132,0,
0,164,164,164,164,164,0,164,0,
0,152,152,152,152,152,0,152,152,
0,140,0,140,0,0,140,0,0,
127,127,0,127,127,127,127,127,0,
0,159,0,159,159,159,159,159,0,
140,140,0,140,140,140,140,140,140,
0,0,0,135,135,135,135,135,0,
0,0,0,0,0,0,123,123,123,
0,0,0,0,153,0,0,153,153,
141,141,141,0,141,141,0,141,141,
130,0,0,0,130,130,0,0,0,
119,0,119,119,119,119,0,0,0,
118,118,0,0,0,0,0,118,118,
107,107,107,107,107,0,0,0,0,
106,106,106,106,106,0,106,0,0,
105,105,0,0,0,0,105,0,105,
94,94,0,94,0,94,94,94,0,
89,89,89,89,89,89,89,89,0,
92,0,0,92,92,0,0,0,0,
87,87,87,87,87,87,0,87,87,
0,0,0,90,90,90,0,90,90,
85,85,85,85,85,85,0,85,85,
0,0,0,0,0,0,0,0,0,
0,0,0,0,0,0,0,0,0,
0,0,0,0,0,0,0,0,0.