[layer]
type=Tile Layer 1
data=
0,5,0,1,1,3,21,1,1,
1,1,0,1,0,6,0,5,21,
1,1,1,1,0,1,1,1,21,
1,1,0,0,21,1,0,0,0,
0,1,21,3,5,1,1,1,5,
1,1,1,1,0,0,1,21,0,
0,0,0,4,0,3,1,1,21,
1,21,1,1,0,1,0,1,1,
1,0,0,0,21,5,1,1,6,
0,21,0,1,4,3,0,0,0,
0,1,1,1,1,6,1,21,0,
1,0,1,21,1,0,1,0,0,
0,0,0,0,0,0,0,0,0,
0,0,0,0,0,0,0,0,0,
0,0,0,0,0,0,0,0,0.
[layer]
type=Tile Layer 2
data=
0,88,0,88,88,88,0,88,88,
63,63,0,63,0,63,0,63,0,
59,59,59,59,0,59,59,59,0,
61,61,0,0,0,61,0,0,0,
0,51,0,51,51,51,51,51,51,
53,53,53,53,0,0,53,0,0,
0,0,0,52,0,52,52,52,0,
51,0,51,51,0,51,0,51,51,
50,0,0,0,0,50,50,50,50,
0,0,0,49,49,49,0,0,0,
0,48,48,48,48,48,48,0,0,
47,0,47,0,47,0,47,0,0,
0,0,0,0,0,0,0,0,0,
0,0,0,0,0,0,0,0,0,
0,0,0,0,0,0,0,0,0.