[layer]
type=Tile Layer 1
data=
1,1,1,1,1,1,1,21,1,
1,0,0,0,21,0,1,0,0,
1,1,1,1,1,21,1,0,1,
1,21,1,0,0,0,1,0,1,
1,21,1,1,1,1,1,0,1,
1,0,1,1,1,1,1,21,0,
1,21,1,1,1,1,1,0,1,
1,21,0,0,0,0,0,0,1,
1,1,21,1,1,1,1,1,1,
1,0,0,0,0,1,21,1,0,
1,21,1,1,1,1,1,1,1,
0,0,0,21,0,0,1,1,1,
1,0,1,1,1,21,1,0,1,
1,0,1,21,0,0,1,0,0,
1,21,1,0,1,1,1,1,1,
1,0,1,21,1,0,0,0,0,
1,21,1,0,1,0,1,1,1,
0,0,0,0,1,0,21,0,1,
1,1,1,21,1,1,1,0,1,
1,21,1,0,1,0,1,0,1,
1,21,1,0,1,0,1,0,1,
1,1,1,21,0,0,0,1,1,
1,1,1,21,1,0,1,1,1,
1,1,1,21,0,0,1,1,1,
0,1,1,1,1,21,0,0,1,
0,1,1,1,1,1,21,0,1,
0,0,0,0,1,1,21,1,1,
1,1,1,1,21,0,0,1,1,
0,1,1,1,1,1,21,1,1,
0,0,0,21,0,0,1,1,1,
0,21,1,1,1,1,1,0,1,
0,1,0,21,0,0,1,1,1,
0,1,1,1,1,21,0,1,1,
0,1,1,1,0,1,21,0,0,
1,0,0,21,0,1,0,1,0,
1,1,1,1,21,0,1,1,0,
0,0,0,0,0,0,0,0,0,
0,0,0,0,0,0,0,0,0,
0,0,0,0,0,0,0,0,0.
[layer]
type=Tile Layer 2
data=
168,168,168,168,168,168,168,0,168,
175,0,0,0,0,0,175,0,0,
173,173,173,173,173,0,173,0,173,
140,0,140,0,0,0,140,0,140,
129,0,129,129,129,129,129,0,129,
118,0,118,118,118,118,118,0,0,
147,0,147,147,147,147,147,0,147,
135,0,0,0,0,0,0,0,135,
118,118,0,118,118,118,118,118,118,
113,0,0,0,0,113,0,113,0,
134,0,134,134,134,134,134,134,134,
0,0,0,0,0,0,130,130,130,
119,0,119,119,119,0,119,0,119,
109,0,109,0,0,0,109,0,0,
135,0,135,0,135,135,135,135,135,
125,0,125,0,125,0,0,0,0,
115,0,115,0,115,0,115,115,115,
0,0,0,0,104,0,0,0,104,
130,130,130,0,130,130,130,0,130,
120,0,120,0,120,0,120,0,120,
110,0,110,0,110,0,110,0,110,
100,100,100,0,0,0,0,100,100,
124,124,124,0,124,0,124,124,124,
114,114,114,0,0,0,114,114,114,
0,105,105,105,105,0,0,0,105,
0,96,96,96,96,96,0,0,96,
0,0,0,0,95,95,0,95,95,
86,86,86,86,0,0,0,86,86,
0,85,85,85,85,85,0,85,85,
0,0,0,0,0,0,84,84,84,
0,0,75,75,75,75,75,0,75,
0,74,0,0,0,0,74,74,74,
0,73,73,73,73,0,0,73,73,
0,72,72,72,0,72,0,0,0,
71,0,0,0,0,71,0,71,0,
70,70,70,70,0,0,70,70,0,
0,0,0,0,0,0,0,0,0,
0,0,0,0,0,0,0,0,0,
0,0,0,0,0,0,0,0,0.