[layer]
type=Tile Layer 1
data=
1,1,1,1,1,21,6,1,0,
4,1,6,4,1,21,1,1,0,
1,1,1,1,3,21,0,0,1,
1,6,0,6,1,1,1,21,0,
0,0,0,1,3,1,1,0,21,
0,21,1,1,1,1,1,0,4,
1,1,6,1,1,0,1,21,0,
6,1,1,0,0,21,1,3,0,
1,1,5,0,0,0,21,1,0,
3,1,21,0,4,1,1,1,0,
1,5,0,1,0,21,0,0,0,
1,1,0,0,0,0,1,21,0,
1,3,0,0,0,21,0,1,1,
0,0,0,0,0,21,0,4,6,
0,21,1,1,1,1,1,1,1,
1,0,0,0,0,0,0,21,0,
6,1,1,1,1,1,4,1,21,
1,6,1,5,1,1,1,21,0,
1,1,6,1,5,1,1,21,0,
5,3,1,1,1,1,1,1,21,
1,1,1,1,1,1,3,6,21,
1,1,1,1,0,0,0,21,0,
0,0,0,21,0,1,1,1,1,
21,1,1,4,5,1,4,3,1,
0,21,0,1,1,6,1,1,1,
5,1,0,21,0,1,1,1,1,
1,5,1,3,0,21,0,0,0,
3,1,3,1,1,5,0,21,0,
4,1,1,1,1,1,0,21,0,
1,4,1,1,1,1,1,1,21,
1,1,21,0,0,1,1,0,1,
3,3,21,1,0,1,6,1,1,
5,1,21,0,0,1,1,1,1,
1,1,0,1,0,21,0,0,0,
1,5,0,0,21,3,0,4,0,
1,1,21,1,0,0,1,0,0,
1,1,0,0,0,21,0,0,1,
1,5,1,1,1,3,1,21,0,
1,1,1,1,6,5,21,0,0,
1,0,0,0,1,21,6,0,1,
6,1,1,3,4,21,1,1,1,
1,1,1,1,1,21,0,0,0,
1,1,1,1,5,21,1,1,5,
3,1,1,1,1,21,1,0,1,
1,1,4,3,4,21,1,0,1,
4,21,0,1,0,0,1,1,1,
1,21,1,1,1,1,6,1,6,
0,21,0,1,1,0,5,0,0,
1,21,1,1,5,1,1,0,1,
1,0,1,4,1,0,1,21,0,
1,0,3,4,1,21,1,0,1,
1,0,21,0,0,0,1,0,1,
1,21,4,5,1,5,1,0,6,
1,0,1,1,1,1,1,21,0,
0,0,0,0,0,0,0,0,0,
0,0,0,0,0,0,0,0,0,
0,0,0,0,0,0,0,0,0.
[layer]
type=Tile Layer 2
data=
239,239,239,239,239,0,239,239,0,
237,237,237,237,237,0,237,237,0,
236,236,236,236,236,0,0,0,236,
164,164,0,164,164,164,164,0,0,
0,0,0,205,205,205,205,0,0,
0,0,189,189,189,189,189,0,189,
174,174,174,174,174,0,174,0,0,
159,159,159,0,0,0,159,159,0,
199,199,199,0,0,0,0,199,0,
184,184,0,0,184,184,184,184,0,
169,169,0,169,0,0,0,0,0,
155,155,0,0,0,0,155,0,0,
193,193,0,0,0,0,0,193,193,
0,0,0,0,0,0,0,179,179,
0,0,165,165,165,165,165,165,165,
150,0,0,0,0,0,0,0,0,
179,179,179,179,179,179,179,179,0,
174,174,174,174,174,174,174,0,0,
160,160,160,160,160,160,160,0,0,
139,139,139,139,139,139,139,139,0,
173,173,173,173,173,173,173,173,0,
168,168,168,168,0,0,0,0,0,
0,0,0,0,0,155,155,155,155,
0,135,135,135,135,135,135,135,135,
0,0,0,177,177,177,177,177,177,
163,163,0,0,0,163,163,163,163,
150,150,150,150,0,0,0,0,0,
137,137,137,137,137,137,0,0,0,
171,171,171,171,171,171,0,0,0,
151,151,151,151,151,151,151,151,0,
145,145,0,0,0,145,145,0,145,
133,133,0,133,0,133,133,133,133,
165,165,0,0,0,165,165,165,165,
153,153,0,153,0,0,0,0,0,
141,141,0,0,0,141,0,141,0,
128,128,0,128,0,0,128,0,0,
160,160,0,0,0,0,0,0,160,
148,148,148,148,148,148,148,0,0,
136,136,136,136,136,136,0,0,0,
124,0,0,0,124,0,124,0,124,
147,147,147,147,147,0,147,147,147,
142,142,142,142,142,0,0,0,0,
125,125,125,125,125,0,125,125,125,
120,120,120,120,120,0,120,0,120,
119,119,119,119,119,0,119,0,119,
108,0,0,108,0,0,108,108,108,
102,0,102,102,102,102,102,102,102,
0,0,0,106,106,0,106,0,0,
95,0,95,95,95,95,95,0,95,
94,0,94,94,94,0,94,0,0,
93,0,93,93,93,0,93,0,93,
92,0,0,0,0,0,92,0,92,
91,0,91,91,91,91,91,0,91,
90,0,90,90,90,90,90,0,0,
0,0,0,0,0,0,0,0,0,
0,0,0,0,0,0,0,0,0,
0,0,0,0,0,0,0,0,0.