[layer]
type=Tile Layer 1
data=
1,0,21,0,1,1,1,1,0,
1,0,1,0,0,21,0,0,1,
1,21,1,1,1,1,1,0,1,
1,0,0,21,1,1,1,1,0,
1,1,1,0,1,0,21,1,0,
1,1,1,21,0,1,1,0,1,
1,1,1,1,21,1,1,0,1,
1,1,1,0,21,0,0,0,1,
1,1,0,0,0,21,0,1,0,
0,1,21,1,1,1,0,1,1,
0,1,21,1,1,1,0,1,1,
0,0,0,1,21,1,0,0,0,
0,1,1,1,0,1,1,1,21,
0,21,0,1,1,1,0,1,0,
1,1,0,1,0,1,21,1,0,
0,0,0,0,0,0,0,0,0,
0,0,0,0,0,0,0,0,0,
0,0,0,0,0,0,0,0,0.
[layer]
type=Tile Layer 2
data=
108,0,0,0,108,108,108,108,0,
84,0,84,0,0,0,0,0,84,
79,0,79,79,79,79,79,0,79,
82,0,0,0,82,82,82,82,0,
74,74,74,0,74,0,0,74,0,
73,73,73,0,0,73,73,0,73,
68,68,68,68,0,68,68,0,68,
64,64,64,0,0,0,0,0,64,
63,63,0,0,0,0,0,63,0,
0,62,0,62,62,62,0,62,62,
0,61,0,61,61,61,0,61,61,
0,0,0,60,0,60,0,0,0,
0,59,59,59,0,59,59,59,0,
0,0,0,58,58,58,0,58,0,
57,57,0,57,0,57,0,57,0,
0,0,0,0,0,0,0,0,0,
0,0,0,0,0,0,0,0,0,
0,0,0,0,0,0,0,0,0.