[layer]
type=Tile Layer 1
data=
6,0,1,0,0,0,21,0,1,
5,0,1,21,3,0,1,1,1,
1,0,1,0,1,0,1,21,0,
1,21,6,0,1,1,5,0,1,
1,0,1,0,1,21,0,0,1,
1,21,3,0,1,0,1,6,1,
1,21,1,0,1,0,1,0,0,
1,0,4,0,6,21,1,0,1,
5,0,1,21,0,0,1,0,1,
1,1,1,21,0,1,5,0,0,
1,5,4,1,21,0,1,1,0,
1,1,1,6,1,0,0,21,0,
1,1,1,3,4,21,3,0,1,
1,1,21,0,0,0,1,0,1,
5,21,0,1,1,1,1,0,1,
0,0,0,0,0,0,0,0,0,
0,0,0,0,0,0,0,0,0,
0,0,0,0,0,0,0,0,0.
[layer]
type=Tile Layer 2
data=
123,0,123,0,0,0,0,0,123,
121,0,121,0,121,0,121,121,121,
119,0,119,0,119,0,119,0,0,
89,0,89,0,89,89,89,0,89,
81,0,81,0,81,0,0,0,81,
80,0,80,0,80,0,80,80,80,
72,0,72,0,72,0,72,0,0,
71,0,71,0,71,0,71,0,71,
70,0,70,0,0,0,70,0,70,
62,62,62,0,0,62,62,0,0,
61,61,61,61,0,0,61,61,0,
60,60,60,60,60,0,0,0,0,
56,56,56,56,56,0,56,0,56,
58,58,0,0,0,0,58,0,58,
57,0,0,57,57,57,57,0,57,
0,0,0,0,0,0,0,0,0,
0,0,0,0,0,0,0,0,0,
0,0,0,0,0,0,0,0,0.