[layer]
type=Tile Layer 1
data=
1,1,6,0,1,1,21,0,0,
1,6,0,1,1,1,1,1,21,
6,21,4,0,5,1,1,1,0,
0,4,1,0,0,5,1,21,0,
0,0,1,1,0,5,21,0,0,
0,0,0,1,3,21,0,0,0,
0,0,0,0,0,0,0,0,0,
0,0,0,0,0,0,0,0,0,
0,0,0,0,0,0,0,0,0.
[layer]
type=Tile Layer 2
data=
35,35,35,0,35,35,0,0,0,
31,31,0,31,31,31,31,31,0,
32,0,32,0,32,32,32,32,0,
0,33,33,0,0,33,33,0,0,
0,0,32,32,0,32,0,0,0,
0,0,0,32,32,0,0,0,0,
0,0,0,0,0,0,0,0,0,
0,0,0,0,0,0,0,0,0,
0,0,0,0,0,0,0,0,0.