[layer]
type=Tile Layer 1
data=
1,1,1,21,1,1,1,1,1,
1,1,1,21,1,1,1,1,1,
1,1,1,0,0,0,1,21,0,
1,1,1,0,1,21,1,0,1,
1,0,0,0,1,21,1,0,1,
1,21,1,1,1,0,1,1,1,
1,0,0,0,1,21,1,0,1,
1,1,1,21,1,1,1,0,1,
1,1,1,0,1,0,0,21,0,
0,0,2,2,21,1,1,1,1,
0,2,9,2,21,2,2,2,2,
1,21,2,2,0,1,1,1,1,
1,0,21,1,0,1,1,1,1,
2,2,21,1,0,1,1,1,1,
9,2,2,2,2,21,0,2,2,
0,21,1,1,0,0,0,0,0,
0,0,21,1,2,2,2,1,0,
1,1,21,0,2,10,2,1,0,
0,2,2,1,2,2,21,1,1,
0,8,0,1,0,1,0,21,0,
1,2,2,1,21,1,1,1,1,
2,21,1,1,1,1,1,1,1,
8,2,1,2,2,21,0,0,1,
2,2,2,2,9,21,2,0,2,
0,21,1,2,2,0,1,0,1,
1,1,1,21,1,0,1,1,1,
2,7,2,21,2,2,2,2,0,
1,2,10,21,1,1,0,1,1,
1,2,2,21,2,2,2,0,1,
2,2,21,2,2,9,2,2,0,
1,1,0,0,2,21,0,0,0,
2,7,2,21,2,2,2,2,2,
1,1,1,0,0,21,0,0,0,
0,0,0,0,0,0,0,0,0,
0,0,0,0,0,0,0,0,0,
0,0,0,0,0,0,0,0,0.
[layer]
type=Tile Layer 2
data=
163,163,163,0,163,163,163,163,163,
162,162,162,0,162,162,162,162,162,
168,168,168,0,0,0,168,0,0,
147,147,147,0,147,0,147,0,147,
135,0,0,0,135,0,135,0,135,
124,0,124,124,124,0,124,124,124,
113,0,0,0,113,0,113,0,113,
141,141,141,0,141,141,141,0,141,
130,130,130,0,130,0,0,0,0,
0,0,119,119,0,119,119,119,119,
0,109,109,109,0,109,109,109,109,
135,0,135,135,0,135,135,135,135,
125,0,0,125,0,125,125,125,125,
115,115,0,115,0,115,115,115,115,
104,104,104,104,104,0,0,104,104,
0,0,130,130,0,0,0,0,0,
0,0,0,120,120,120,120,120,0,
110,110,0,0,110,110,110,110,0,
0,100,100,100,100,100,0,100,100,
0,124,0,124,0,124,0,0,0,
109,109,109,109,0,109,109,109,109,
100,0,100,100,100,100,100,100,100,
96,96,96,96,96,0,0,0,96,
95,95,95,95,95,0,95,0,95,
0,0,86,86,86,0,86,0,86,
85,85,85,0,85,0,85,85,85,
84,84,84,0,84,84,84,84,0,
75,75,75,0,75,75,0,75,75,
74,74,74,0,74,74,74,0,74,
73,73,0,73,73,73,73,73,0,
72,72,0,0,72,0,0,0,0,
71,71,71,0,71,71,71,71,71,
70,70,70,0,0,0,0,0,0,
0,0,0,0,0,0,0,0,0,
0,0,0,0,0,0,0,0,0,
0,0,0,0,0,0,0,0,0.