[layer]
type=Tile Layer 1
data=
0,0,4,1,6,5,1,21,5,
6,0,0,1,5,1,6,21,0,
0,0,0,4,6,4,5,4,21,
0,1,5,5,6,6,4,6,21,
0,0,5,4,1,6,0,21,0,
4,21,0,5,1,4,0,1,1,
3,0,21,5,3,0,4,5,0,
1,0,1,0,1,1,21,0,0,
0,6,21,0,1,0,4,5,3,
1,1,1,21,5,1,3,1,1,
1,1,6,1,21,1,5,1,3,
6,1,6,21,5,1,3,1,5,
1,21,4,5,1,4,6,1,1,
6,0,1,0,6,21,1,0,4,
0,0,0,1,1,6,0,21,0,
0,0,0,0,0,0,0,0,0,
0,0,0,0,0,0,0,0,0,
0,0,0,0,0,0,0,0,0.
[layer]
type=Tile Layer 2
data=
0,0,108,108,108,108,108,0,108,
84,0,0,84,84,84,84,0,0,
0,0,0,83,83,83,83,83,0,
0,78,78,78,78,78,78,78,0,
0,0,74,74,74,74,0,0,0,
73,0,0,73,73,73,0,73,73,
72,0,0,72,72,0,72,72,0,
64,0,64,0,64,64,0,0,0,
0,63,0,0,63,0,63,63,63,
3,3,49,0,49,3,49,3,3,
49,49,49,3,0,3,49,49,49,
48,3,48,0,48,3,48,3,48,
45,0,45,45,45,45,45,2,45,
58,0,58,0,58,0,58,0,58,
0,0,0,57,57,57,0,0,0,
0,0,0,0,0,0,0,0,0,
0,0,0,0,0,0,0,0,0,
0,0,0,0,0,0,0,0,0.