[layer]
type=Tile Layer 1
data=
1,3,1,0,4,21,0,0,24,
1,1,1,21,1,6,1,0,1,
0,0,0,21,4,1,1,0,2,
5,1,1,21,1,1,1,2,19,
6,1,1,0,0,0,1,21,0,
5,1,1,3,1,21,1,0,1,
1,1,1,0,0,21,0,0,1,
2,2,0,21,2,20,0,2,2,
1,1,21,1,2,0,2,3,4,
6,4,0,1,1,1,21,0,1,
1,1,0,0,0,21,1,1,0,
1,1,1,1,3,3,0,21,0,
1,1,21,4,1,1,1,5,0,
3,1,1,1,5,1,1,1,21,
0,0,0,21,0,1,0,0,0,
21,2,2,2,3,1,1,1,1,
0,2,19,0,5,0,6,21,0,
0,2,2,2,1,1,21,1,1,
0,5,1,1,1,1,21,3,0,
0,1,1,1,1,1,21,3,1,
0,1,0,6,21,0,0,0,0,
2,2,2,2,2,21,20,0,0,
5,1,1,1,0,21,2,2,0,
2,2,2,2,0,2,0,21,18,
5,1,21,0,0,0,0,1,1,
1,1,21,3,4,0,2,2,1,
1,0,0,0,0,21,24,2,1,
0,0,0,0,0,0,0,0,0,
0,0,0,0,0,0,0,0,0,
0,0,0,0,0,0,0,0,0.
[layer]
type=Tile Layer 2
data=
160,160,160,0,160,0,0,0,0,
158,158,158,0,158,158,158,0,158,
0,0,0,0,157,157,157,0,157,
117,117,117,0,117,117,117,117,0,
107,107,107,0,0,0,107,0,0,
133,133,133,133,133,0,133,0,133,
123,123,123,0,0,0,0,0,123,
113,113,0,0,113,0,0,113,113,
102,102,0,102,102,0,102,102,102,
128,128,0,128,128,128,0,0,128,
118,118,0,0,0,0,118,118,0,
108,108,108,108,108,108,0,0,0,
98,98,0,98,98,98,98,98,0,
116,116,116,116,116,116,116,116,0,
0,0,0,0,0,112,0,0,0,
0,98,98,98,98,98,98,98,98,
0,94,0,0,94,0,94,0,0,
0,93,93,93,93,93,0,93,93,
0,84,84,84,84,84,0,84,0,
0,83,83,83,83,83,0,83,83,
0,82,0,82,0,0,0,0,0,
73,73,73,73,73,0,0,0,0,
72,72,72,72,0,0,72,72,0,
71,71,71,71,0,71,0,0,0,
70,70,0,0,0,0,0,70,70,
69,69,0,69,69,0,69,69,69,
68,0,0,0,0,0,0,68,68,
0,0,0,0,0,0,0,0,0,
0,0,0,0,0,0,0,0,0,
0,0,0,0,0,0,0,0,0.