[layer]
type=Tile Layer 1
data=
1,18,1,1,0,1,1,18,1,
1,1,1,1,18,1,1,1,1,
1,18,1,1,0,1,1,18,1,
1,1,1,1,18,1,1,1,1,
1,18,1,1,0,1,1,18,1,
1,1,1,1,18,1,1,1,1,
0,0,0,0,0,0,0,0,0,
0,0,0,0,0,0,0,0,0,
0,0,0,0,0,0,0,0,0.
[layer]
type=Tile Layer 2
data=
37,0,37,37,0,37,37,0,37,
33,33,33,33,0,33,33,33,33,
37,0,37,37,0,37,37,0,37,
33,33,33,33,0,33,33,33,33,
37,0,37,37,0,37,37,0,37,
33,33,33,33,0,33,33,33,33,
0,0,0,0,0,0,0,0,0,
0,0,0,0,0,0,0,0,0,
0,0,0,0,0,0,0,0,0.