[layer]
type=Tile Layer 1
data=
1,1,0,0,21,0,0,0,0,
1,1,1,1,1,1,1,1,21,
1,1,1,1,1,1,1,1,21,
1,1,1,21,1,1,1,1,1,
0,0,1,0,0,0,1,21,1,
1,1,1,21,1,1,1,0,1,
1,1,1,0,1,1,1,21,0,
1,1,1,21,1,1,1,0,1,
1,1,1,0,0,0,21,0,1,
1,1,1,21,1,1,1,1,1,
0,0,0,21,1,0,0,0,0,
1,1,1,0,1,21,1,0,1,
1,1,1,1,1,21,1,1,1,
0,0,1,1,1,1,1,21,1,
1,1,1,1,1,21,1,1,1,
0,0,0,21,1,0,1,1,1,
1,1,1,21,1,1,1,1,1,
1,1,1,21,1,0,1,1,1,
1,1,1,21,1,0,1,1,1,
1,1,1,21,0,0,0,0,0,
1,1,1,21,1,1,1,0,1,
1,1,1,1,1,1,1,21,1,
1,1,1,1,1,21,1,0,1,
1,1,1,1,1,21,1,0,1,
0,1,21,0,1,1,0,1,0,
1,1,1,1,1,21,1,1,1,
1,21,0,0,1,0,1,1,1,
1,1,1,1,1,21,1,1,1,
1,1,1,0,1,0,21,0,1,
1,1,1,21,1,1,1,0,1,
1,1,1,1,1,21,1,1,1,
1,1,0,0,1,21,0,1,1,
1,21,1,1,1,1,1,1,1,
1,0,1,0,0,0,0,21,0,
1,0,1,21,1,1,1,0,1,
1,21,1,0,1,1,1,0,1,
1,0,1,21,1,1,1,0,1,
0,21,1,0,1,1,1,0,1,
1,21,1,0,1,1,1,0,1,
1,21,0,1,1,1,1,1,1,
1,0,0,21,0,0,0,0,0,
1,1,1,1,1,1,1,1,21,
1,1,1,1,0,0,0,21,0,
1,1,1,1,0,21,0,0,1,
1,1,1,1,1,0,21,0,1,
1,1,1,1,1,21,0,1,1,
1,1,1,1,1,1,21,1,1,
1,1,1,1,1,1,21,1,1,
1,1,1,21,0,0,0,1,1,
1,1,1,21,0,0,0,1,1,
1,1,21,0,0,0,1,1,1,
1,1,21,0,0,1,1,1,1,
1,1,21,1,0,1,1,1,1,
1,1,0,1,21,0,1,1,1,
0,0,0,0,0,0,0,0,0,
0,0,0,0,0,0,0,0,0,
0,0,0,0,0,0,0,0,0.
[layer]
type=Tile Layer 2
data=
239,239,0,0,0,0,0,0,0,
226,226,226,226,226,226,226,226,0,
224,224,224,224,224,224,224,224,0,
156,156,156,0,156,156,156,156,156,
0,0,205,0,0,0,205,0,205,
189,189,189,0,189,189,189,0,189,
174,174,174,0,174,174,174,0,0,
159,159,159,0,159,159,159,0,159,
199,199,199,0,0,0,0,0,199,
175,175,175,0,175,175,175,175,175,
0,0,0,0,169,0,0,0,0,
155,155,155,0,155,0,155,0,155,
184,184,184,184,184,0,184,184,184,
0,0,179,179,179,179,179,0,179,
157,157,157,157,157,0,157,157,157,
0,0,0,0,150,0,150,150,150,
179,179,179,0,179,179,179,179,179,
174,174,174,0,174,0,174,174,174,
160,160,160,0,160,0,160,160,160,
146,146,146,0,0,0,0,0,0,
182,182,182,0,182,182,182,0,182,
160,160,160,160,160,160,160,0,160,
155,155,155,155,155,0,155,0,155,
142,142,142,142,142,0,142,0,142,
0,177,0,0,177,177,0,177,0,
155,155,155,155,155,0,155,155,155,
150,0,0,0,150,0,150,150,150,
131,131,131,131,131,0,131,131,131,
171,171,171,0,171,0,0,0,171,
158,158,158,0,158,158,158,0,158,
138,138,138,138,138,0,138,138,138,
133,133,0,0,133,0,0,133,133,
157,0,157,157,157,157,157,157,157,
153,0,153,0,0,0,0,0,0,
141,0,141,0,141,141,141,0,141,
128,0,128,0,128,128,128,0,128,
160,0,160,0,160,160,160,0,160,
0,0,148,0,148,148,148,0,148,
136,0,136,0,136,136,136,0,136,
124,0,0,124,124,124,124,124,124,
154,0,0,0,0,0,0,0,0,
136,136,136,136,136,136,136,136,0,
131,131,131,131,0,0,0,0,0,
120,120,120,120,0,0,0,0,120,
119,119,119,119,119,0,0,0,119,
108,108,108,108,108,0,0,108,108,
102,102,102,102,102,102,0,102,102,
101,101,101,101,101,101,0,101,101,
95,95,95,0,0,0,0,95,95,
94,94,94,0,0,0,0,94,94,
93,93,0,0,0,0,93,93,93,
92,92,0,0,0,92,92,92,92,
91,91,0,91,0,91,91,91,91,
90,90,0,90,0,0,90,90,90,
0,0,0,0,0,0,0,0,0,
0,0,0,0,0,0,0,0,0,
0,0,0,0,0,0,0,0,0.