[layer]
type=Tile Layer 1
data=
0,0,1,0,0,0,0,21,0,
1,1,1,5,21,1,1,5,4,
0,1,1,1,0,1,1,3,21,
21,3,1,3,1,1,5,1,6,
0,0,21,0,0,1,0,0,0,
1,1,1,1,21,1,0,1,0,
4,3,4,1,21,1,0,1,0,
1,1,1,1,21,1,0,5,1,
0,0,0,1,0,1,0,0,21,
1,1,21,1,1,1,1,6,0,
1,1,21,1,5,3,1,1,1,
1,0,0,0,0,21,0,6,0,
3,3,1,6,21,6,1,1,0,
0,21,0,1,0,1,1,1,0,
1,4,1,1,1,1,1,1,21,
0,0,0,21,0,1,1,6,0,
1,1,4,1,21,1,1,5,0,
0,0,21,1,0,0,0,1,0,
1,1,1,1,1,21,1,0,6,
0,0,5,0,0,0,1,0,21,
6,21,1,0,1,1,4,1,1,
1,0,1,0,1,0,21,0,1,
1,21,5,0,5,0,1,0,1,
1,0,1,0,1,21,3,0,6,
1,21,1,0,1,0,1,1,3,
1,0,1,21,5,0,0,0,1,
4,0,1,21,1,0,3,0,1,
1,1,21,0,4,1,1,0,0,
5,3,1,21,1,4,1,1,0,
1,1,3,21,1,1,1,1,0,
1,1,6,21,5,1,1,1,0,
1,1,21,0,1,1,0,0,0,
1,1,21,1,1,1,0,4,4,
6,1,0,0,21,0,0,1,1,
0,0,1,1,21,0,0,1,4,
0,21,0,0,1,1,1,3,1,
1,1,0,21,0,0,0,4,1,
1,1,0,21,0,4,0,0,0,
3,1,1,1,5,21,1,1,0,
1,4,1,1,1,21,1,1,0,
1,1,3,0,21,5,1,1,0,
0,0,21,0,1,1,0,5,0,
0,0,0,0,0,0,0,0,0,
0,0,0,0,0,0,0,0,0,
0,0,0,0,0,0,0,0,0.
[layer]
type=Tile Layer 2
data=
0,0,203,0,0,0,0,0,0,
191,191,191,191,0,191,191,191,191,
0,200,200,200,0,200,200,200,0,
0,132,132,132,132,132,132,132,132,
0,0,0,0,0,173,0,0,0,
160,160,160,160,0,160,0,160,0,
147,147,147,147,0,147,0,147,0,
134,134,134,134,0,134,0,134,134,
0,0,0,167,0,167,0,0,0,
154,154,0,154,154,154,154,154,0,
135,135,0,135,135,135,135,135,135,
130,0,0,0,0,0,0,130,0,
162,162,162,162,0,162,162,162,0,
0,0,0,149,0,149,149,149,0,
131,131,131,131,131,131,131,131,0,
0,0,0,0,0,125,125,125,0,
156,156,156,156,0,156,156,156,0,
0,0,0,144,0,0,0,144,0,
132,132,132,132,132,0,132,0,132,
0,0,121,0,0,0,121,0,0,
150,0,150,0,150,150,150,150,150,
139,0,139,0,139,0,0,0,139,
128,0,128,0,128,0,128,0,128,
116,0,116,0,116,0,116,0,116,
145,0,145,0,145,0,145,145,145,
134,0,134,0,134,0,0,0,134,
123,0,123,0,123,0,123,0,123,
112,112,0,0,112,112,112,0,0,
139,139,139,0,139,139,139,139,0,
128,128,128,0,128,128,128,128,0,
118,118,118,0,118,118,118,118,0,
108,108,0,0,108,108,0,0,0,
107,107,0,107,107,107,0,107,107,
97,97,0,0,0,0,0,97,97,
0,0,96,96,0,0,0,96,96,
0,0,0,0,95,95,95,95,95,
85,85,0,0,0,0,0,85,85,
84,84,0,0,0,84,0,0,0,
83,83,83,83,83,0,83,83,0,
82,82,82,82,82,0,82,82,0,
81,81,81,0,0,81,81,81,0,
0,0,0,0,80,80,0,80,0,
0,0,0,0,0,0,0,0,0,
0,0,0,0,0,0,0,0,0,
0,0,0,0,0,0,0,0,0.