[layer]
type=Tile Layer 1
data=
0,1,0,21,0,1,0,1,0,
1,1,1,1,1,1,21,1,1,
1,1,21,0,0,0,0,1,0,
1,1,0,1,1,1,1,1,21,
0,1,21,1,0,0,0,0,0,
0,1,0,1,1,1,1,1,21,
0,0,0,0,0,0,0,0,0,
0,0,0,0,0,0,0,0,0,
0,0,0,0,0,0,0,0,0.
[layer]
type=Tile Layer 2
data=
0,40,0,0,0,40,0,40,0,
33,33,33,33,33,33,0,33,33,
38,38,0,0,0,0,0,38,0,
34,34,0,34,34,34,34,34,0,
0,37,0,37,0,0,0,0,0,
0,34,0,34,34,34,34,34,0,
0,0,0,0,0,0,0,0,0,
0,0,0,0,0,0,0,0,0,
0,0,0,0,0,0,0,0,0.