[layer]
type=Tile Layer 1
data=
1,2,0,1,21,1,2,8,1,
1,8,2,1,0,0,21,2,1,
1,2,0,1,1,1,0,2,21,
0,1,0,0,21,1,0,1,0,
1,1,1,1,2,21,0,1,1,
0,0,1,2,8,2,21,1,0,
0,21,2,2,2,2,1,1,1,
21,1,2,8,2,1,0,1,0,
0,1,21,2,2,1,0,1,1,
0,1,0,0,0,0,1,21,1,
0,21,0,1,1,1,0,0,0,
1,1,0,0,0,1,1,1,21,
0,0,0,0,0,0,0,0,0,
0,0,0,0,0,0,0,0,0,
0,0,0,0,0,0,0,0,0.
[layer]
type=Tile Layer 2
data=
88,88,0,88,0,88,88,88,88,
63,63,63,63,0,0,0,63,63,
62,62,0,62,62,62,0,62,0,
0,61,0,0,0,61,0,61,0,
51,51,51,51,51,0,0,51,51,
0,0,53,53,53,53,0,53,0,
0,0,49,49,49,49,49,49,49,
0,51,51,51,51,51,0,51,0,
0,50,0,50,50,50,0,50,50,
0,49,0,0,0,0,49,0,49,
0,0,0,48,48,48,0,0,0,
47,47,0,0,0,47,47,47,0,
0,0,0,0,0,0,0,0,0,
0,0,0,0,0,0,0,0,0,
0,0,0,0,0,0,0,0,0.