[layer]
type=Tile Layer 1
data=
0,1,0,0,21,1,1,0,1,
1,21,1,1,1,1,1,0,1,
1,0,1,1,1,0,21,0,1,
0,1,1,1,1,21,1,1,1,
1,1,1,1,21,0,0,0,0,
1,1,0,0,21,1,1,1,0,
1,1,0,1,0,0,21,0,0,
1,0,21,1,0,1,1,1,1,
1,21,1,1,0,1,1,1,1,
1,21,0,1,0,1,1,1,1,
1,1,21,1,0,1,1,1,1,
1,1,21,0,0,1,1,1,1,
0,0,0,1,0,1,0,0,21,
0,1,1,1,21,1,0,1,1,
0,0,0,1,0,1,21,0,0,
0,1,0,1,0,1,1,1,21,
0,1,0,21,0,1,0,0,0,
0,1,1,1,1,1,21,1,1,
0,0,0,0,0,0,0,0,0,
0,0,0,0,0,0,0,0,0,
0,0,0,0,0,0,0,0,0.
[layer]
type=Tile Layer 2
data=
0,128,0,0,0,128,128,0,128,
121,0,121,121,121,121,121,0,121,
125,0,125,125,125,0,0,0,125,
0,82,82,82,82,0,82,82,82,
107,107,107,107,0,0,0,0,0,
98,98,0,0,0,98,98,98,0,
90,90,0,90,0,0,0,0,0,
82,0,0,82,0,82,82,82,82,
77,0,77,77,0,77,77,77,77,
73,0,0,73,0,73,73,73,73,
68,68,0,68,0,68,68,68,68,
71,71,0,0,0,71,71,71,71,
0,0,0,63,0,63,0,0,0,
0,62,62,62,0,62,0,62,62,
0,0,0,61,0,61,0,0,0,
0,60,0,60,0,60,60,60,0,
0,59,0,0,0,59,0,0,0,
0,56,56,56,56,56,0,56,56,
0,0,0,0,0,0,0,0,0,
0,0,0,0,0,0,0,0,0,
0,0,0,0,0,0,0,0,0.