[layer]
type=Tile Layer 1
data=
1,1,1,1,4,1,1,1,21,
0,0,20,2,0,21,0,2,0,
0,2,2,2,0,2,21,5,1,
1,3,1,21,2,19,2,3,6,
1,0,5,0,2,21,0,0,1,
1,1,1,21,1,0,1,1,1,
3,6,2,21,2,0,1,0,1,
1,1,2,24,2,21,5,0,1,
1,1,1,0,1,21,1,0,0,
1,5,1,21,1,0,1,1,6,
0,0,1,0,1,21,1,0,0,
2,0,2,21,2,0,2,18,2,
1,0,0,0,0,21,5,0,0,
1,0,1,1,3,21,1,0,1,
4,0,1,0,0,21,1,0,1,
1,21,1,1,1,1,1,0,1,
1,0,21,0,0,0,0,0,1,
1,6,6,1,1,3,5,21,2,
0,0,2,0,0,21,2,0,20,
1,0,1,21,1,2,19,2,2,
6,0,1,0,1,21,2,0,3,
1,1,1,21,0,0,0,1,5,
1,1,1,0,21,0,0,0,3,
1,1,3,1,1,0,6,21,0,
1,3,1,1,1,0,21,3,0,
1,1,6,1,1,1,21,0,0,
0,6,1,1,1,1,21,4,1,
0,0,0,0,1,1,0,21,0,
1,6,2,21,0,1,1,0,0,
1,4,2,19,21,1,1,0,2,
1,1,2,2,2,0,1,21,24,
2,2,2,2,2,0,2,21,18,
1,1,1,1,3,21,1,4,0,
1,1,1,1,0,21,4,5,0,
1,0,0,0,21,1,1,1,0,
0,21,2,2,0,18,0,0,0,
0,0,0,0,0,0,0,0,0,
0,0,0,0,0,0,0,0,0,
0,0,0,0,0,0,0,0,0.
[layer]
type=Tile Layer 2
data=
168,168,168,168,168,168,168,168,0,
0,0,0,175,0,0,0,175,0,
0,173,173,173,0,173,0,173,173,
140,140,140,0,140,0,140,140,140,
129,0,129,0,129,0,0,0,129,
118,118,118,0,118,0,118,118,118,
147,147,147,0,147,0,147,0,147,
135,135,135,0,135,0,135,0,135,
124,124,124,0,124,0,124,0,0,
113,113,113,0,113,0,113,113,113,
0,0,141,0,141,0,141,0,0,
130,0,130,0,130,0,130,0,130,
119,0,0,0,0,0,119,0,0,
109,0,109,109,109,0,109,0,109,
135,0,135,0,0,0,135,0,135,
125,0,125,125,125,125,125,0,125,
115,0,0,0,0,0,0,0,115,
100,100,100,100,100,100,100,0,100,
0,0,130,0,0,0,130,0,0,
120,0,120,0,120,120,0,120,120,
110,0,110,0,110,0,110,0,110,
100,100,100,0,0,0,0,100,100,
124,124,124,0,0,0,0,0,124,
114,114,114,114,114,0,114,0,0,
105,105,105,105,105,0,0,105,0,
96,96,96,96,96,96,0,0,0,
0,95,95,95,95,95,0,95,95,
0,0,0,0,86,86,0,0,0,
85,85,85,0,0,85,85,0,0,
84,84,84,0,0,84,84,0,84,
75,75,75,75,75,0,75,0,0,
74,74,74,74,74,0,74,0,0,
73,73,73,73,73,0,73,73,0,
72,72,72,72,0,0,72,72,0,
71,0,0,0,0,71,71,71,0,
0,0,70,70,0,0,0,0,0,
0,0,0,0,0,0,0,0,0,
0,0,0,0,0,0,0,0,0,
0,0,0,0,0,0,0,0,0.