[layer]
type=Tile Layer 1
data=
1,1,1,1,21,0,1,1,0,
1,1,1,1,1,1,1,1,21,
1,1,1,0,0,21,0,0,0,
0,0,0,1,21,1,1,0,1,
0,1,1,1,1,0,21,0,1,
0,0,1,0,21,0,5,1,1,
1,1,0,1,1,3,21,1,1,
0,0,0,1,0,5,1,1,21,
0,4,4,1,21,3,0,1,1,
3,5,1,1,21,1,0,1,1,
1,0,0,1,1,1,21,1,1,
1,1,0,1,21,1,0,1,0,
0,0,0,0,0,0,0,0,0,
0,0,0,0,0,0,0,0,0,
0,0,0,0,0,0,0,0,0.
[layer]
type=Tile Layer 2
data=
88,88,88,88,0,0,88,88,0,
56,56,56,56,56,56,56,56,0,
62,62,62,0,0,0,0,0,0,
0,0,0,61,0,61,61,0,61,
0,54,54,54,54,0,0,0,54,
0,0,53,0,0,0,53,53,53,
49,49,0,49,49,49,0,49,49,
0,0,0,51,0,51,51,51,0,
0,50,50,50,0,50,0,50,50,
47,47,47,47,0,47,0,47,47,
48,0,0,48,48,48,0,48,48,
47,47,0,47,0,47,0,47,0,
0,0,0,0,0,0,0,0,0,
0,0,0,0,0,0,0,0,0,
0,0,0,0,0,0,0,0,0.