[layer]
type=Tile Layer 1
data=
2,2,0,7,2,2,21,0,2,
1,1,21,0,2,2,3,5,1,
0,21,0,2,8,2,6,0,1,
0,21,5,2,2,2,4,0,0,
1,3,0,1,2,2,21,1,0,
0,2,21,1,2,9,2,2,0,
1,1,1,1,2,2,2,1,21,
1,1,1,1,1,1,1,21,2,
1,1,21,3,1,1,1,4,1,
0,0,0,0,0,0,0,0,0,
0,0,0,0,0,0,0,0,0,
0,0,0,0,0,0,0,0,0.
[layer]
type=Tile Layer 2
data=
75,75,0,75,75,75,0,0,75,
45,45,0,0,45,45,45,45,45,
0,0,0,47,47,47,47,0,47,
0,0,46,37,37,37,46,0,0,
45,45,0,2,36,36,0,45,0,
0,44,0,2,35,35,44,44,0,
2,2,35,2,35,35,35,2,0,
2,34,2,2,34,2,2,0,34,
2,33,0,33,33,33,2,33,2,
0,0,0,0,0,0,0,0,0,
0,0,0,0,0,0,0,0,0,
0,0,0,0,0,0,0,0,0.