[layer]
type=Tile Layer 1
data=
0,0,0,1,0,1,0,1,21,
0,1,1,1,1,1,0,1,21,
0,1,1,1,1,1,0,1,21,
0,1,1,1,1,1,0,1,21,
0,1,1,1,1,1,21,1,0,
0,1,1,1,1,1,21,1,1,
1,21,1,1,1,0,1,1,1,
1,21,1,1,1,0,1,0,0,
1,1,1,1,1,21,1,1,1,
0,0,0,21,0,0,1,1,1,
1,1,1,1,1,21,1,1,1,
0,0,0,21,1,0,1,1,1,
2,2,1,1,1,21,1,1,1,
19,0,0,21,0,0,1,0,0,
2,21,2,2,2,2,2,18,2,
1,1,21,1,1,1,0,1,1,
1,0,0,21,0,0,0,0,0,
1,21,2,2,2,1,1,1,1,
2,21,2,20,0,0,0,0,2,
1,21,2,2,2,0,1,0,1,
1,0,1,0,0,21,1,0,1,
1,21,2,0,2,0,1,1,1,
0,0,21,24,2,0,1,0,0,
1,1,1,1,1,1,1,21,1,
1,1,1,1,21,0,0,0,0,
0,0,1,1,1,0,21,1,0,
24,2,1,1,1,1,1,21,0,
24,2,1,1,1,1,1,21,1,
0,0,0,1,1,2,21,0,1,
2,2,21,2,2,2,20,2,2,
1,1,1,2,19,2,0,21,0,
1,1,1,2,0,21,1,1,0,
1,1,0,0,0,0,0,21,0,
0,0,2,2,21,18,2,2,2,
0,1,1,1,1,0,21,1,1,
0,0,1,1,1,1,21,1,1,
0,0,1,1,1,1,21,1,1,
0,1,1,1,1,1,21,0,1,
0,0,0,0,21,1,1,0,1,
0,0,0,0,0,0,0,0,0,
0,0,0,0,0,0,0,0,0,
0,0,0,0,0,0,0,0,0.
[layer]
type=Tile Layer 2
data=
0,0,0,197,0,197,0,197,0,
0,195,195,195,195,195,0,195,0,
0,194,194,194,194,194,0,194,0,
0,146,146,146,146,146,0,146,0,
0,133,133,133,133,133,0,133,0,
0,166,166,166,166,166,0,166,166,
153,0,153,153,153,0,153,153,153,
141,0,141,141,141,0,141,0,0,
122,122,122,122,122,0,122,122,122,
0,0,0,0,0,0,161,161,161,
141,141,141,141,141,0,141,141,141,
0,0,0,0,136,0,136,136,136,
118,118,118,118,118,0,118,118,118,
0,0,0,0,0,0,155,0,0,
143,0,143,143,143,143,143,0,143,
131,131,0,131,131,131,0,131,131,
120,0,0,0,0,0,0,0,0,
142,0,142,142,142,142,142,142,142,
138,0,138,0,0,0,0,0,138,
127,0,127,127,127,0,127,0,127,
115,0,115,0,0,0,115,0,115,
144,0,144,0,144,0,144,144,144,
0,0,0,0,133,0,133,0,0,
116,116,116,116,116,116,116,0,116,
111,111,111,111,0,0,0,0,0,
0,0,138,138,138,0,0,138,0,
0,127,127,127,127,127,127,0,0,
0,117,117,117,117,117,117,0,117,
0,0,0,107,107,107,0,0,107,
106,106,0,106,106,106,0,106,106,
96,96,96,96,0,96,0,0,0,
95,95,95,95,0,0,95,95,0,
94,94,0,0,0,0,0,0,0,
0,0,84,84,0,0,84,84,84,
0,83,83,83,83,0,0,83,83,
0,0,82,82,82,82,0,82,82,
0,0,81,81,81,81,0,81,81,
0,80,80,80,80,80,0,0,80,
0,0,0,0,0,79,79,0,79,
0,0,0,0,0,0,0,0,0,
0,0,0,0,0,0,0,0,0,
0,0,0,0,0,0,0,0,0.