[layer]
type=Tile Layer 1
data=
1,0,21,0,0,1,1,1,1,
1,1,0,0,0,0,21,0,0,
1,1,21,1,1,1,1,1,0,
1,1,1,0,21,0,0,0,0,
1,1,1,21,1,0,1,1,1,
1,21,0,1,1,1,1,1,1,
0,1,1,1,1,21,1,1,1,
0,1,1,1,1,21,1,1,1,
0,0,0,0,21,1,1,1,1,
1,1,1,1,21,1,1,1,1,
1,1,1,1,21,1,1,1,1,
0,1,0,21,0,0,0,1,0,
0,1,1,1,1,1,21,1,1,
0,1,1,1,1,1,0,0,21,
0,1,1,1,1,1,21,1,1,
0,0,0,0,0,1,0,21,0,
1,1,21,1,0,1,1,1,0,
1,1,0,1,21,1,1,1,0,
1,21,1,1,1,1,1,0,1,
0,0,1,0,21,0,1,0,1,
1,1,1,0,1,21,1,0,1,
1,0,1,21,1,0,1,0,1,
1,0,1,21,1,0,1,0,1,
1,21,1,0,1,0,1,0,1,
1,0,1,0,1,21,1,0,1,
0,0,21,0,1,0,1,0,1,
1,1,1,1,1,21,1,0,1,
0,1,1,1,1,1,0,1,21,
0,1,1,1,1,1,21,1,0,
0,1,1,1,1,1,21,1,0,
0,1,0,0,0,21,0,1,0,
21,1,1,1,1,1,1,1,1,
0,1,0,21,0,1,0,1,1,
0,0,0,0,0,0,0,0,0,
0,0,0,0,0,0,0,0,0,
0,0,0,0,0,0,0,0,0.
[layer]
type=Tile Layer 2
data=
170,0,0,0,0,170,170,170,170,
169,169,0,0,0,0,0,0,0,
167,167,0,167,167,167,167,167,0,
146,146,146,0,0,0,0,0,0,
134,134,134,0,134,0,134,134,134,
123,0,0,123,123,123,123,123,123,
0,112,112,112,112,0,112,112,112,
0,140,140,140,140,0,140,140,140,
0,0,0,0,0,129,129,129,129,
113,113,113,113,0,113,113,113,113,
103,103,103,103,0,103,103,103,103,
0,134,0,0,0,0,0,134,0,
0,124,124,124,124,124,0,124,124,
0,114,114,114,114,114,0,0,0,
0,103,103,103,103,103,0,103,103,
0,0,0,0,0,129,0,0,0,
119,119,0,119,0,119,119,119,0,
109,109,0,109,0,109,109,109,0,
99,0,99,99,99,99,99,0,99,
0,0,123,0,0,0,123,0,123,
113,113,113,0,113,0,113,0,113,
104,0,104,0,104,0,104,0,104,
95,0,95,0,95,0,95,0,95,
94,0,94,0,94,0,94,0,94,
85,0,85,0,85,0,85,0,85,
0,0,0,0,84,0,84,0,84,
83,83,83,83,83,0,83,0,83,
0,74,74,74,74,74,0,74,0,
0,73,73,73,73,73,0,73,0,
0,72,72,72,72,72,0,72,0,
0,71,0,0,0,0,0,71,0,
0,67,67,67,67,67,67,67,67,
0,69,0,0,0,69,0,69,69,
0,0,0,0,0,0,0,0,0,
0,0,0,0,0,0,0,0,0,
0,0,0,0,0,0,0,0,0.