[layer]
type=Tile Layer 1
data=
0,1,1,1,0,21,1,1,1,
0,1,1,1,21,0,1,1,1,
0,21,18,2,2,0,2,2,2,
1,1,21,0,1,0,0,0,0,
1,1,1,21,1,1,1,1,0,
1,1,21,1,1,1,1,0,1,
1,1,21,0,0,0,1,1,0,
1,2,2,1,1,1,21,2,0,
2,19,2,2,2,2,2,21,20,
1,2,2,21,1,1,1,2,2,
1,1,1,21,1,0,0,0,0,
1,1,1,21,1,1,1,1,1,
1,1,1,21,1,0,0,0,1,
1,1,2,21,2,1,1,0,1,
0,0,0,20,2,0,21,0,2,
1,1,2,2,2,21,1,1,1,
1,0,0,0,21,0,1,1,1,
1,21,1,1,1,1,1,1,1,
2,21,2,0,2,18,2,0,2,
19,0,1,0,1,0,1,21,0,
2,2,1,21,1,0,1,1,1,
0,0,0,0,1,0,0,21,1,
1,21,1,1,1,1,1,1,1,
1,0,1,21,0,0,0,0,0,
1,1,1,21,1,1,1,1,1,
0,0,0,0,1,0,21,0,0,
1,1,1,1,1,1,2,21,1,
1,0,0,0,1,0,21,24,1,
1,21,1,1,1,1,1,1,1,
1,0,1,0,21,0,0,0,1,
1,0,1,21,1,1,1,0,1,
0,0,2,0,1,1,1,21,1,
1,24,2,21,1,1,1,0,1,
0,0,0,0,0,0,0,0,0,
0,0,0,0,0,0,0,0,0,
0,0,0,0,0,0,0,0,0.
[layer]
type=Tile Layer 2
data=
0,171,171,171,0,0,171,171,171,
0,170,170,170,0,0,170,170,170,
0,0,0,168,168,0,168,168,168,
147,147,0,0,147,0,0,0,0,
135,135,135,0,135,135,135,135,0,
124,124,0,124,124,124,124,0,124,
113,113,0,0,0,0,113,113,0,
141,141,141,141,141,141,0,141,0,
130,0,130,130,130,130,130,0,0,
114,114,114,0,114,114,114,114,114,
109,109,109,0,109,0,0,0,0,
129,129,129,0,129,129,129,129,129,
125,125,125,0,125,0,0,0,125,
115,115,115,0,115,115,115,0,115,
0,0,0,0,104,0,0,0,104,
124,124,124,124,124,0,124,124,124,
120,0,0,0,0,0,120,120,120,
105,0,105,105,105,105,105,105,105,
100,0,100,0,100,0,100,0,100,
0,0,124,0,124,0,124,0,0,
114,114,114,0,114,0,114,114,114,
0,0,0,0,105,0,0,0,105,
91,0,91,91,91,91,91,91,91,
95,0,95,0,0,0,0,0,0,
82,82,82,0,82,82,82,82,82,
0,0,0,0,85,0,0,0,0,
80,80,80,80,80,80,80,0,80,
75,0,0,0,75,0,0,0,75,
71,0,71,71,71,71,71,71,71,
73,0,73,0,0,0,0,0,73,
72,0,72,0,72,72,72,0,72,
0,0,71,0,71,71,71,0,71,
70,0,70,0,70,70,70,0,70,
0,0,0,0,0,0,0,0,0,
0,0,0,0,0,0,0,0,0,
0,0,0,0,0,0,0,0,0.