[layer]
type=Tile Layer 1
data=
0,21,0,1,1,1,1,1,1,
1,1,0,1,0,21,0,1,1,
1,1,0,21,0,0,1,1,1,
1,1,1,0,0,21,0,1,1,
1,1,1,1,21,1,0,0,1,
1,1,1,1,0,21,1,0,1,
1,1,1,1,1,0,0,21,0,
1,1,1,1,1,1,21,0,0,
1,1,1,1,1,1,1,21,0,
1,1,21,1,1,1,1,1,0,
1,1,0,1,0,21,0,0,0,
1,1,21,1,0,1,1,1,1,
0,0,0,1,21,1,0,0,0,
1,1,1,1,21,1,0,1,1,
0,0,0,0,0,21,0,1,1,
1,1,1,1,1,1,21,1,1,
0,0,21,1,1,1,0,0,1,
1,1,1,1,1,1,1,21,1,
1,1,1,0,21,1,0,1,1,
1,1,0,21,1,1,0,0,0,
1,1,21,1,1,1,1,0,0,
1,1,0,0,0,1,21,0,1,
1,1,1,21,0,1,0,1,1,
0,0,21,0,1,1,1,1,1,
0,21,1,1,1,1,1,1,1,
0,21,0,1,1,1,1,1,1,
0,0,21,1,1,1,1,1,1,
1,1,1,21,0,1,1,1,0,
1,1,1,1,0,21,1,1,0,
1,1,1,1,1,0,0,21,0,
1,1,1,1,1,1,21,0,1,
1,1,21,0,1,0,0,1,1,
1,1,21,1,1,1,0,1,1,
1,1,21,1,1,1,0,1,1,
1,1,21,0,0,1,1,0,0,
1,1,1,1,1,0,0,21,0,
0,1,1,1,0,21,0,0,0,
21,1,1,1,1,1,1,1,1,
0,0,21,0,0,1,1,1,1,
1,1,1,1,21,1,1,1,1,
0,0,0,1,0,0,0,21,0,
1,1,21,1,1,1,1,1,1,
0,1,0,1,21,0,0,0,0,
0,1,21,1,0,1,1,1,1,
0,1,0,1,21,1,1,1,1,
1,0,21,1,1,1,1,0,0,
1,1,0,21,0,1,1,0,0,
1,1,1,1,0,1,1,21,0,
1,1,1,0,21,1,1,1,0,
0,0,21,0,1,1,1,1,1,
1,21,0,1,1,1,1,0,1,
0,0,0,0,0,0,0,0,0,
0,0,0,0,0,0,0,0,0,
0,0,0,0,0,0,0,0,0.
[layer]
type=Tile Layer 2
data=
0,0,0,234,234,234,234,234,234,
233,233,0,233,0,0,0,233,233,
231,231,0,0,0,0,231,231,231,
174,174,174,0,0,0,0,174,174,
159,159,159,159,0,159,0,0,159,
199,199,199,199,0,0,199,0,199,
184,184,184,184,184,0,0,0,0,
169,169,169,169,169,169,0,0,0,
155,155,155,155,155,155,155,0,0,
193,193,0,193,193,193,193,193,0,
179,179,0,179,0,0,0,0,0,
165,165,0,165,0,165,165,165,165,
0,0,0,150,0,150,0,0,0,
188,188,188,188,0,188,0,188,188,
0,0,0,0,0,0,0,174,174,
152,152,152,152,152,152,0,152,152,
0,0,0,146,146,146,0,0,146,
173,173,173,173,173,173,173,0,173,
168,168,168,0,0,168,0,168,168,
155,155,0,0,155,155,0,0,0,
142,142,0,142,142,142,142,0,0,
177,177,0,0,0,177,0,0,177,
163,163,163,0,0,163,0,163,163,
0,0,0,0,150,150,150,150,150,
0,0,137,137,137,137,137,137,137,
0,0,0,171,171,171,171,171,171,
0,0,0,158,158,158,158,158,158,
145,145,145,0,0,145,145,145,0,
133,133,133,133,0,0,133,133,0,
165,165,165,165,165,0,0,0,0,
153,153,153,153,153,153,0,0,153,
141,141,0,0,141,0,0,141,141,
128,128,0,128,128,128,0,128,128,
160,160,0,160,160,160,0,160,160,
148,148,0,0,0,148,148,0,0,
136,136,136,136,136,0,0,0,0,
0,124,124,124,0,0,0,0,0,
0,147,147,147,147,147,147,147,147,
0,0,0,0,0,142,142,142,142,
125,125,125,125,0,125,125,125,125,
0,0,0,120,0,0,0,0,0,
113,113,0,113,113,113,113,113,113,
0,108,0,108,0,0,0,0,0,
0,107,0,107,0,107,107,107,107,
0,106,0,106,0,106,106,106,106,
95,0,0,95,95,95,95,0,0,
94,94,0,0,0,94,94,0,0,
93,93,93,93,0,93,93,0,0,
92,92,92,0,0,92,92,92,0,
0,0,0,0,91,91,91,91,91,
90,0,0,90,90,90,90,0,90,
0,0,0,0,0,0,0,0,0,
0,0,0,0,0,0,0,0,0,
0,0,0,0,0,0,0,0,0.