[layer]
type=Tile Layer 1
data=
0,4,21,2,18,0,2,2,2,
0,2,21,1,1,0,0,1,2,
0,2,21,5,0,1,0,0,0,
6,0,21,0,2,2,2,0,20,
0,2,1,0,1,0,1,1,21,
0,20,2,2,21,2,2,2,0,
1,0,21,1,0,4,1,1,0,
1,0,1,0,1,0,21,0,4,
1,0,1,21,6,0,1,0,0,
0,0,0,0,0,0,0,0,0,
0,0,0,0,0,0,0,0,0,
0,0,0,0,0,0,0,0,0.
[layer]
type=Tile Layer 2
data=
0,75,0,75,0,0,75,75,75,
0,47,0,47,47,0,0,47,47,
0,47,0,47,0,47,0,0,0,
46,0,0,0,46,46,46,0,0,
0,45,45,0,45,0,45,45,0,
0,0,44,44,0,44,44,44,0,
43,0,0,43,0,43,43,43,0,
43,0,43,0,43,0,0,0,43,
42,0,42,0,42,0,42,0,0,
0,0,0,0,0,0,0,0,0,
0,0,0,0,0,0,0,0,0,
0,0,0,0,0,0,0,0,0.