[layer]
type=Tile Layer 1
data=
0,0,1,0,0,0,0,21,1,
0,1,1,21,1,1,1,1,1,
0,1,1,21,1,1,1,1,1,
1,1,0,1,1,1,1,21,0,
1,1,0,0,21,0,0,1,0,
1,1,1,21,1,1,0,0,0,
1,1,1,21,1,1,1,0,1,
1,1,1,0,0,0,0,21,0,
1,1,1,21,1,1,1,1,1,
0,0,0,0,1,0,21,0,0,
1,1,1,1,1,21,1,1,1,
0,0,1,21,1,0,1,1,1,
1,1,1,21,1,0,1,1,1,
0,0,21,0,0,0,0,0,1,
1,21,1,1,1,1,1,0,1,
0,0,1,1,0,0,21,0,0,
0,1,1,1,0,0,0,0,21,
0,1,1,1,1,21,0,0,0,
0,1,1,1,1,1,1,1,21,
0,0,1,1,1,1,1,0,21,
0,0,21,1,1,1,0,0,0,
0,0,0,0,0,0,0,0,0,
0,0,0,0,0,0,0,0,0,
0,0,0,0,0,0,0,0,0.
[layer]
type=Tile Layer 2
data=
0,0,133,0,0,0,0,0,133,
0,125,125,0,125,125,125,125,125,
0,124,124,0,124,124,124,124,124,
113,113,0,113,113,113,113,0,0,
104,104,0,0,0,0,0,104,0,
95,95,95,0,95,95,0,0,0,
82,82,82,0,82,82,82,0,82,
107,107,107,0,0,0,0,0,0,
89,89,89,0,89,89,89,89,89,
0,0,0,0,90,0,0,0,0,
74,74,74,74,74,0,74,74,74,
0,0,81,0,81,0,81,81,81,
69,69,69,0,69,0,69,69,69,
0,0,0,0,0,0,0,0,72,
67,0,67,67,67,67,67,0,67,
0,0,63,63,0,0,0,0,0,
0,62,62,62,0,0,0,0,0,
0,61,61,61,61,0,0,0,0,
0,57,57,57,57,57,57,57,0,
0,0,59,59,59,59,59,0,0,
0,0,0,58,58,58,0,0,0,
0,0,0,0,0,0,0,0,0,
0,0,0,0,0,0,0,0,0,
0,0,0,0,0,0,0,0,0.