[layer]
type=Tile Layer 1
data=
0,0,0,0,1,21,0,0,1,
1,1,1,1,6,21,2,2,3,
0,0,2,21,0,2,10,2,0,
2,21,9,2,2,2,2,0,2,
1,2,2,21,1,0,1,0,4,
1,1,5,21,1,0,1,1,1,
0,0,1,0,0,1,4,2,21,
1,21,1,1,5,0,1,2,10,
1,21,0,0,1,0,1,2,2,
1,21,1,1,0,0,0,1,3,
1,21,1,1,4,1,0,1,1,
0,0,1,1,5,21,0,1,1,
0,21,2,2,0,0,2,2,2,
1,2,10,2,21,3,2,10,2,
0,0,2,2,21,1,4,1,2,
0,0,0,0,0,0,0,0,0,
0,0,0,0,0,0,0,0,0,
0,0,0,0,0,0,0,0,0.
[layer]
type=Tile Layer 2
data=
0,0,0,0,108,0,0,0,108,
76,76,76,76,76,0,76,76,76,
0,0,83,0,0,83,83,83,0,
82,0,82,82,82,82,82,0,82,
74,74,74,0,74,0,74,0,74,
69,69,69,0,69,0,69,69,69,
0,0,72,0,0,72,72,72,0,
64,0,64,64,64,0,64,64,64,
63,0,0,0,63,0,63,63,63,
62,0,62,62,0,0,0,62,62,
58,0,58,58,58,58,0,58,58,
0,0,60,60,60,0,0,60,60,
0,0,59,59,0,0,59,59,59,
58,58,58,58,0,58,58,58,58,
0,0,57,57,0,57,57,57,57,
0,0,0,0,0,0,0,0,0,
0,0,0,0,0,0,0,0,0,
0,0,0,0,0,0,0,0,0.