[layer]
type=Tile Layer 1
data=
1,1,0,0,21,0,5,1,1,
1,1,1,0,1,21,0,4,6,
1,5,1,21,1,1,0,1,1,
1,5,1,0,1,1,0,21,0,
6,2,2,2,0,0,0,21,0,
2,2,20,21,2,0,2,2,2,
5,2,21,2,1,0,2,2,1,
6,1,1,0,1,21,24,0,1,
1,1,1,0,21,0,4,0,1,
1,3,1,21,0,0,0,0,1,
1,1,5,21,1,2,2,2,1,
0,21,0,0,2,0,20,0,2,
1,1,1,21,1,2,2,2,3,
0,0,1,21,4,1,1,1,3,
1,21,1,1,5,1,1,2,2,
0,0,21,0,0,0,2,0,20,
1,1,1,5,6,21,1,0,2,
1,4,1,1,1,0,1,21,0,
0,21,1,0,1,0,0,0,1,
1,1,1,21,1,5,4,1,3,
0,0,1,0,0,21,1,0,0,
1,21,1,5,1,0,1,0,3,
1,0,0,21,1,0,1,0,1,
5,1,1,21,1,0,1,0,6,
0,0,1,0,0,0,1,21,0,
1,21,1,1,1,5,3,4,1,
1,0,1,0,0,0,1,21,0,
1,1,4,2,2,2,3,21,4,
1,0,0,0,24,0,21,0,1,
1,21,2,1,1,1,5,1,1,
1,24,2,0,0,21,0,0,0,
1,1,1,21,1,1,1,1,1,
1,6,4,21,1,6,1,0,3,
0,0,0,0,0,0,0,0,0,
0,0,0,0,0,0,0,0,0,
0,0,0,0,0,0,0,0,0.
[layer]
type=Tile Layer 2
data=
170,170,0,0,0,0,170,170,170,
169,169,169,0,169,0,0,169,169,
167,167,167,0,167,167,0,167,167,
146,146,146,0,146,146,0,0,0,
134,134,134,134,0,0,0,0,0,
123,123,0,0,123,0,123,123,123,
112,112,0,112,112,0,112,112,112,
140,140,140,0,140,0,0,0,140,
129,129,129,0,0,0,129,0,129,
118,118,118,0,0,0,0,0,118,
103,103,103,0,103,103,103,103,103,
0,0,0,0,134,0,0,0,134,
118,118,118,0,118,118,118,118,118,
0,0,114,0,114,114,114,114,114,
99,0,99,99,99,99,99,99,99,
0,0,0,0,0,0,129,0,0,
119,119,119,119,119,0,119,0,119,
109,109,109,109,109,0,109,0,0,
0,0,99,0,99,0,0,0,99,
117,117,117,0,117,117,117,117,117,
0,0,113,0,0,0,113,0,0,
104,0,104,104,104,0,104,0,104,
95,0,0,0,95,0,95,0,95,
94,94,94,0,94,0,94,0,94,
0,0,85,0,0,0,85,0,0,
80,0,80,80,80,80,80,80,80,
83,0,83,0,0,0,83,0,0,
70,70,70,70,70,70,70,0,70,
73,0,0,0,0,0,0,0,73,
69,0,69,69,69,69,69,69,69,
71,0,71,0,0,0,0,0,0,
67,67,67,0,67,67,67,67,67,
69,69,69,0,69,69,69,0,69,
0,0,0,0,0,0,0,0,0,
0,0,0,0,0,0,0,0,0,
0,0,0,0,0,0,0,0,0.