[layer]
type=Tile Layer 1
data=
0,0,1,0,0,0,21,0,1,
0,0,1,1,1,0,21,0,1,
1,21,1,1,1,0,1,1,1,
1,21,1,1,1,0,1,1,1,
1,0,0,21,0,0,1,1,1,
1,1,1,1,21,1,0,1,1,
1,1,1,1,21,1,0,1,1,
1,1,1,1,0,21,0,0,1,
1,1,1,1,1,1,0,21,0,
1,1,1,1,1,21,1,1,1,
0,0,0,21,1,0,1,1,1,
1,1,1,21,1,0,1,1,1,
0,0,0,0,1,0,0,0,21,
1,1,1,1,1,1,1,1,21,
1,1,1,0,1,0,0,21,0,
1,1,1,21,1,1,1,1,1,
0,0,0,21,1,1,1,1,1,
1,1,1,21,1,1,1,1,1,
1,21,1,1,1,0,1,1,1,
1,0,0,0,1,0,21,0,1,
1,0,1,21,1,1,1,0,1,
1,21,1,0,0,0,1,0,0,
1,1,1,1,1,21,1,1,1,
0,0,0,0,1,21,0,0,1,
1,21,1,0,1,1,1,0,1,
1,0,1,0,1,21,0,0,1,
1,21,1,0,1,0,1,1,1,
0,0,0,0,0,1,21,1,0,
1,1,1,1,21,1,0,1,1,
0,1,1,1,0,1,0,1,21,
0,1,1,1,0,1,21,1,0,
0,1,1,1,0,0,0,1,21,
0,1,1,1,21,1,1,1,0,
0,0,0,0,0,0,0,0,0,
0,0,0,0,0,0,0,0,0,
0,0,0,0,0,0,0,0,0.
[layer]
type=Tile Layer 2
data=
0,0,170,0,0,0,0,0,170,
0,0,169,169,169,0,0,0,169,
167,0,167,167,167,0,167,167,167,
146,0,146,146,146,0,146,146,146,
134,0,0,0,0,0,134,134,134,
123,123,123,123,0,123,0,123,123,
112,112,112,112,0,112,0,112,112,
140,140,140,140,0,0,0,0,140,
129,129,129,129,129,129,0,0,0,
113,113,113,113,113,0,113,113,113,
0,0,0,0,108,0,108,108,108,
134,134,134,0,134,0,134,134,134,
0,0,0,0,124,0,0,0,0,
108,108,108,108,108,108,108,108,0,
103,103,103,0,103,0,0,0,0,
123,123,123,0,123,123,123,123,123,
0,0,0,0,119,119,119,119,119,
104,104,104,0,104,104,104,104,104,
99,0,99,99,99,0,99,99,99,
123,0,0,0,123,0,0,0,123,
113,0,113,0,113,113,113,0,113,
104,0,104,0,0,0,104,0,0,
90,90,90,90,90,0,90,90,90,
0,0,0,0,94,0,0,0,94,
85,0,85,0,85,85,85,0,85,
84,0,84,0,84,0,0,0,84,
83,0,83,0,83,0,83,83,83,
0,0,0,0,0,74,0,74,0,
73,73,73,73,0,73,0,73,73,
0,72,72,72,0,72,0,72,0,
0,71,71,71,0,71,0,71,0,
0,70,70,70,0,0,0,70,0,
0,69,69,69,0,69,69,69,0,
0,0,0,0,0,0,0,0,0,
0,0,0,0,0,0,0,0,0,
0,0,0,0,0,0,0,0,0.