[layer]
type=Tile Layer 1
data=
4,0,0,21,0,1,1,1,1,
1,21,1,1,3,1,1,1,5,
1,21,1,0,0,2,2,0,1,
1,1,2,2,21,10,2,0,5,
6,5,2,8,2,2,2,21,0,
1,1,2,6,2,21,1,3,0,
0,0,21,4,1,2,2,2,0,
1,21,1,1,1,2,8,2,0,
1,0,1,1,0,0,21,0,4,
0,0,0,0,0,0,0,0,0,
0,0,0,0,0,0,0,0,0,
0,0,0,0,0,0,0,0,0.
[layer]
type=Tile Layer 2
data=
79,0,0,0,0,79,79,79,79,
45,0,45,45,45,45,45,45,45,
49,0,49,0,0,49,49,0,49,
48,48,48,48,0,48,48,0,48,
48,48,48,48,48,48,48,0,0,
44,44,44,44,44,0,44,44,0,
0,0,0,46,46,46,46,46,0,
45,0,45,45,45,45,45,45,0,
44,0,44,44,0,0,0,0,44,
0,0,0,0,0,0,0,0,0,
0,0,0,0,0,0,0,0,0,
0,0,0,0,0,0,0,0,0.