[layer]
type=Tile Layer 1
data=
0,0,0,0,21,1,1,1,0,
0,1,1,1,21,1,1,1,0,
0,1,1,1,0,0,0,21,0,
0,1,1,1,21,1,1,1,1,
0,1,1,1,0,0,0,0,21,
0,1,1,1,21,1,1,1,1,
1,1,0,1,0,21,0,1,1,
1,1,0,1,21,1,0,1,1,
1,1,21,1,0,1,1,1,1,
1,1,21,1,0,0,0,0,0,
1,1,1,21,0,1,1,0,0,
1,1,1,21,0,1,0,0,1,
1,1,0,0,1,1,21,0,0,
0,21,0,1,1,1,1,1,0,
0,1,1,1,1,1,1,21,0,
1,1,1,21,1,1,1,1,1,
0,0,1,0,0,0,1,21,0,
1,21,1,1,1,1,1,1,1,
1,0,0,0,0,21,0,0,0,
1,21,1,1,1,1,1,1,1,
1,21,1,0,0,0,1,0,0,
0,0,0,0,0,0,0,0,0,
0,0,0,0,0,0,0,0,0,
0,0,0,0,0,0,0,0,0.
[layer]
type=Tile Layer 2
data=
0,0,0,0,0,133,133,133,0,
0,132,132,132,0,132,132,132,0,
0,130,130,130,0,0,0,0,0,
0,107,107,107,0,107,107,107,107,
0,104,104,104,0,0,0,0,0,
0,90,90,90,0,90,90,90,90,
86,86,0,86,0,0,0,86,86,
107,107,0,107,0,107,0,107,107,
94,94,0,94,0,94,94,94,94,
90,90,0,90,0,0,0,0,0,
82,82,82,0,0,82,82,0,0,
81,81,81,0,0,81,0,0,81,
73,73,0,0,73,73,0,0,0,
0,0,0,72,72,72,72,72,0,
0,71,71,71,71,71,71,0,0,
57,57,57,0,57,57,57,57,57,
0,0,62,0,0,0,62,0,0,
55,0,55,55,55,55,55,55,55,
60,0,0,0,0,0,0,0,0,
54,0,54,54,54,54,54,54,54,
58,0,58,0,0,0,58,0,0,
0,0,0,0,0,0,0,0,0,
0,0,0,0,0,0,0,0,0,
0,0,0,0,0,0,0,0,0.