[layer]
type=Tile Layer 1
data=
1,1,5,21,0,0,0,6,0,
6,0,0,0,4,1,1,21,0,
1,21,1,1,1,1,1,0,1,
0,0,0,0,0,1,0,21,0,
5,1,6,1,1,1,21,2,0,
2,2,21,2,2,2,2,9,0,
2,2,21,2,2,2,2,7,0,
1,3,0,1,0,21,0,4,0,
1,1,1,1,21,2,2,2,0,
0,0,0,0,21,2,8,2,0,
0,1,4,1,21,2,2,2,0,
0,2,21,2,0,1,5,1,0,
1,2,8,2,1,21,1,1,1,
2,2,2,2,2,21,2,7,0,
1,3,1,5,1,1,1,21,0,
1,1,1,1,21,1,0,0,0,
4,1,1,1,1,0,0,21,0,
3,6,1,1,1,21,0,0,1,
1,2,2,21,0,1,1,0,0,
6,8,2,21,0,1,1,0,0,
1,2,2,4,21,0,1,0,1,
4,21,0,6,1,1,1,1,1,
3,1,0,2,21,0,1,1,1,
1,3,2,8,2,21,0,2,1,
0,0,2,2,2,0,21,10,1,
21,10,2,1,3,1,2,2,1,
0,2,2,0,0,0,21,1,5,
1,1,1,6,1,1,21,1,3,
5,2,2,1,1,21,1,1,1,
2,9,2,2,2,21,2,2,2,
2,9,2,2,2,2,21,2,0,
1,2,2,1,6,1,21,1,0,
0,0,0,0,1,1,21,5,0,
1,5,1,1,3,1,21,2,0,
0,0,0,0,0,0,0,8,21,
2,2,7,2,21,2,2,2,0,
0,0,0,1,0,1,21,0,0,
1,4,21,5,1,1,4,1,0,
0,2,21,1,1,1,1,6,0,
10,2,1,1,1,0,21,0,0,
2,2,1,1,1,21,3,0,6,
6,1,1,1,21,1,1,0,5,
1,1,1,6,21,0,0,0,1,
1,1,0,0,21,1,1,0,0,
1,1,21,4,0,1,6,5,0,
0,0,0,0,0,0,0,0,0,
0,0,0,0,0,0,0,0,0,
0,0,0,0,0,0,0,0,0.
[layer]
type=Tile Layer 2
data=
208,208,208,0,0,0,0,208,0,
206,0,0,0,206,206,206,0,0,
204,0,204,204,204,204,204,0,204,
0,0,0,0,0,178,0,0,0,
165,165,165,165,165,165,0,165,0,
152,152,0,152,152,152,152,152,0,
138,138,0,138,138,138,138,138,0,
173,173,0,173,0,0,0,173,0,
160,160,160,160,0,160,160,160,0,
0,0,0,0,0,147,147,147,0,
0,134,134,134,0,134,134,134,0,
0,167,0,167,0,167,167,167,0,
123,123,123,123,123,0,123,7,7,
142,113,113,113,113,0,113,113,0,
130,130,104,104,6,104,104,0,0,
162,162,162,129,0,8,0,0,0,
149,149,149,149,7,0,0,0,0,
137,137,137,110,6,0,0,0,137,
125,125,125,0,0,125,125,0,0,
156,156,156,0,0,156,156,0,0,
144,144,144,144,0,0,144,0,144,
132,0,0,132,132,132,132,132,132,
121,121,0,121,0,0,121,121,121,
150,150,150,150,150,0,0,150,150,
0,0,139,139,139,0,0,139,139,
0,128,128,128,128,128,128,128,128,
0,116,116,0,0,0,0,116,116,
138,138,138,138,138,138,0,138,138,
107,107,107,107,107,0,6,107,107,
123,98,98,98,98,0,98,98,123,
112,112,90,90,90,90,0,112,0,
139,139,139,111,111,111,0,139,0,
0,0,0,0,6,128,0,128,0,
118,118,118,94,94,94,0,118,0,
0,0,0,0,0,0,0,108,0,
107,107,107,107,0,107,107,107,0,
0,0,0,97,0,97,0,0,0,
96,96,0,96,96,96,96,96,0,
0,95,0,95,95,95,95,95,0,
85,85,85,85,85,0,0,0,0,
84,84,84,84,84,0,84,0,84,
83,83,83,83,0,83,83,0,83,
82,82,82,82,0,0,0,0,82,
81,81,0,0,0,81,81,0,0,
80,80,0,80,0,80,80,80,0,
0,0,0,0,0,0,0,0,0,
0,0,0,0,0,0,0,0,0,
0,0,0,0,0,0,0,0,0.