[layer]
type=Tile Layer 1
data=
1,1,1,21,0,0,1,0,0,
1,1,1,1,1,0,21,0,1,
1,1,1,1,21,0,0,1,1,
0,1,21,1,1,1,0,1,1,
0,0,0,0,21,1,0,0,0,
0,1,1,1,21,1,1,1,1,
0,1,1,1,0,0,21,0,0,
1,1,1,1,21,1,1,1,1,
0,21,0,1,0,1,1,1,1,
0,1,1,1,21,1,1,1,1,
0,1,0,0,0,1,0,0,21,
1,1,21,1,1,1,1,1,1,
0,0,1,1,1,1,1,0,21,
0,21,0,0,1,1,1,1,0,
1,1,1,0,1,1,1,21,0,
0,0,1,1,1,1,0,21,1,
1,0,0,21,0,0,0,1,1,
0,1,1,1,1,21,1,1,1,
0,0,0,0,0,0,0,0,0,
0,0,0,0,0,0,0,0,0,
0,0,0,0,0,0,0,0,0.
[layer]
type=Tile Layer 2
data=
128,128,128,0,0,0,128,0,0,
127,127,127,127,127,0,0,0,127,
125,125,125,125,0,0,0,125,125,
0,86,0,86,86,86,0,86,86,
0,0,0,0,0,107,0,0,0,
0,94,94,94,0,94,94,94,94,
0,90,90,90,0,0,0,0,0,
74,74,74,74,0,74,74,74,74,
0,0,0,81,0,81,81,81,81,
0,69,69,69,0,69,69,69,69,
0,72,0,0,0,72,0,0,0,
64,64,0,64,64,64,64,64,64,
0,0,63,63,63,63,63,0,0,
0,0,0,0,62,62,62,62,0,
61,61,61,0,61,61,61,0,0,
0,0,60,60,60,60,0,0,60,
59,0,0,0,0,0,0,59,59,
0,56,56,56,56,0,56,56,56,
0,0,0,0,0,0,0,0,0,
0,0,0,0,0,0,0,0,0,
0,0,0,0,0,0,0,0,0.