[layer]
type=Tile Layer 1
data=
1,1,21,1,1,0,0,0,1,
1,1,0,21,1,1,1,0,1,
1,1,0,21,1,1,0,0,1,
1,1,0,0,21,0,0,0,1,
1,1,1,0,0,21,1,0,1,
1,1,1,0,1,1,1,21,0,
1,1,1,1,0,0,21,0,0,
1,1,1,1,21,1,1,1,0,
0,21,0,0,0,0,0,1,0,
21,1,1,1,1,1,1,1,1,
0,0,0,1,0,21,0,1,0,
1,1,1,1,21,1,1,1,1,
0,1,0,1,0,0,0,21,0,
1,1,21,1,1,1,1,1,1,
0,1,0,1,1,1,21,0,0,
0,0,21,1,1,1,1,1,1,
0,1,21,1,1,1,1,1,1,
21,1,1,1,1,1,1,1,1,
0,0,21,0,0,0,0,0,1,
0,0,1,1,1,1,21,0,1,
1,0,1,1,1,1,21,1,0,
0,0,0,0,0,0,0,0,0,
0,0,0,0,0,0,0,0,0,
0,0,0,0,0,0,0,0,0.
[layer]
type=Tile Layer 2
data=
133,133,0,133,133,0,0,0,133,
132,132,0,0,132,132,132,0,132,
130,130,0,0,130,130,0,0,130,
113,113,0,0,0,0,0,0,113,
104,104,104,0,0,0,104,0,104,
95,95,95,0,95,95,95,0,0,
86,86,86,86,0,0,0,0,0,
102,102,102,102,0,102,102,102,0,
0,0,0,0,0,0,0,98,0,
0,81,81,81,81,81,81,81,81,
0,0,0,82,0,0,0,82,0,
73,73,73,73,0,73,73,73,73,
0,73,0,73,0,0,0,0,0,
65,65,0,65,65,65,65,65,65,
0,71,0,71,71,71,0,0,0,
0,0,0,63,63,63,63,63,63,
0,59,0,59,59,59,59,59,59,
0,55,55,55,55,55,55,55,55,
0,0,0,0,0,0,0,0,60,
0,0,59,59,59,59,0,0,59,
58,0,58,58,58,58,0,58,0,
0,0,0,0,0,0,0,0,0,
0,0,0,0,0,0,0,0,0,
0,0,0,0,0,0,0,0,0.