[layer]
type=Tile Layer 1
data=
0,0,0,0,0,21,2,20,2,
2,21,2,2,2,2,2,18,2,
1,21,1,6,1,1,4,0,1,
0,0,1,5,1,1,1,0,21,
0,21,6,1,1,1,1,6,0,
0,0,0,0,0,1,1,4,21,
1,1,3,0,21,0,0,1,0,
1,4,1,1,1,1,21,1,1,
0,0,0,21,0,0,0,0,6,
2,2,1,21,1,1,2,24,0,
19,2,1,0,1,1,1,21,2,
0,21,0,0,5,6,1,0,24,
1,21,4,0,1,6,1,0,1,
0,0,1,0,1,1,2,21,1,
2,21,2,0,2,2,2,20,2,
2,21,2,0,2,20,0,0,0,
5,1,1,21,2,2,2,1,1,
2,0,0,21,18,0,2,2,2,
1,1,1,1,1,21,1,1,1,
1,3,1,1,1,21,6,5,6,
3,1,1,5,1,21,2,2,1,
1,0,0,21,1,1,2,24,1,
1,21,1,5,1,4,6,1,1,
1,0,0,0,0,0,21,0,6,
3,1,1,21,1,4,1,0,1,
1,1,5,21,3,1,1,0,1,
1,1,1,5,1,1,4,21,1,
1,1,1,0,1,1,1,21,0,
3,1,1,21,1,4,6,1,0,
0,21,6,1,1,1,0,0,0,
1,1,3,4,21,0,6,0,2,
2,2,2,0,0,0,2,21,20,
1,1,1,21,1,1,1,2,2,
4,0,21,0,0,0,0,0,0,
1,0,1,21,1,1,6,1,0,
1,21,1,0,1,1,5,1,0,
1,0,4,0,0,21,0,0,0,
1,0,1,6,21,1,0,0,1,
0,0,21,0,1,3,1,0,1,
1,21,1,1,1,1,6,1,1,
0,21,0,0,0,0,1,0,0,
1,21,1,1,3,3,1,0,5,
0,0,1,5,5,1,1,21,1,
1,1,1,4,1,1,4,21,1,
1,21,3,1,1,1,1,0,1,
0,0,0,0,0,0,0,0,0,
0,0,0,0,0,0,0,0,0,
0,0,0,0,0,0,0,0,0.
[layer]
type=Tile Layer 2
data=
0,0,0,0,0,0,208,0,208,
206,0,206,206,206,206,206,0,206,
204,0,204,204,204,204,204,0,204,
0,0,178,178,178,178,178,0,0,
0,0,165,165,165,165,165,165,0,
0,0,0,0,0,152,152,152,0,
138,138,138,0,0,0,0,138,0,
164,164,164,164,164,164,0,164,164,
0,0,0,0,0,0,0,0,160,
147,147,147,0,147,147,147,0,0,
0,134,134,0,134,134,134,0,134,
0,0,0,0,167,167,167,0,0,
154,0,154,0,154,154,154,0,154,
0,0,142,0,142,142,142,0,142,
130,0,130,0,130,130,130,0,130,
162,0,162,0,162,0,0,0,0,
142,142,142,0,142,142,142,142,142,
137,0,0,0,0,0,137,137,137,
119,119,119,119,119,0,119,119,119,
148,148,148,148,148,0,148,148,148,
137,137,137,137,137,0,137,137,137,
132,0,0,0,132,132,132,0,132,
115,0,115,115,115,115,115,115,115,
150,0,0,0,0,0,0,0,150,
139,139,139,0,139,139,139,0,139,
128,128,128,0,128,128,128,0,128,
111,111,111,111,111,111,111,0,111,
145,145,145,0,145,145,145,0,0,
134,134,134,0,134,134,134,134,0,
0,0,123,123,123,123,0,0,0,
112,112,112,112,0,0,112,0,112,
139,139,139,0,0,0,139,0,0,
122,122,122,0,122,122,122,122,122,
118,0,0,0,0,0,0,0,0,
108,0,108,0,108,108,108,108,0,
107,0,107,0,107,107,107,107,0,
97,0,97,0,0,0,0,0,0,
96,0,96,96,0,96,0,0,96,
0,0,0,0,95,95,95,0,95,
81,0,81,81,81,81,81,81,81,
0,0,0,0,0,0,84,0,0,
83,0,83,83,83,83,83,0,83,
0,0,82,82,82,82,82,0,82,
78,78,78,78,78,78,78,0,78,
80,0,80,80,80,80,80,0,80,
0,0,0,0,0,0,0,0,0,
0,0,0,0,0,0,0,0,0,
0,0,0,0,0,0,0,0,0.