[layer]
type=Tile Layer 1
data=
0,21,0,2,0,0,0,2,0,
2,2,2,2,21,2,2,2,20,
0,1,0,1,1,1,0,0,21,
1,1,3,5,0,1,21,1,1,
1,1,0,0,0,1,0,21,1,
0,2,20,5,2,2,6,4,21,
1,6,3,0,21,1,0,1,1,
2,2,0,21,2,2,0,0,18,
1,1,21,5,1,1,1,3,0,
1,4,21,0,0,2,0,0,0,
5,1,1,1,21,2,24,2,1,
0,0,1,1,21,3,3,0,6,
0,0,0,0,0,0,0,0,0,
0,0,0,0,0,0,0,0,0,
0,0,0,0,0,0,0,0,0.
[layer]
type=Tile Layer 2
data=
0,0,0,88,0,0,0,88,0,
59,59,59,59,0,59,59,59,0,
0,62,0,62,62,62,0,0,0,
58,58,58,58,0,58,0,58,58,
54,54,0,0,0,54,0,0,54,
0,53,0,53,53,53,53,53,0,
52,52,52,0,0,52,0,52,52,
51,51,0,0,51,51,0,0,0,
48,48,0,48,48,48,48,48,0,
49,49,0,0,0,49,0,0,0,
46,46,46,46,0,46,0,46,46,
0,0,47,47,0,47,47,0,47,
0,0,0,0,0,0,0,0,0,
0,0,0,0,0,0,0,0,0,
0,0,0,0,0,0,0,0,0.