[layer]
type=Tile Layer 1
data=
1,1,1,1,21,1,0,1,0,
0,0,0,0,0,1,21,1,0,
1,1,1,1,1,1,1,1,21,
1,1,1,21,1,1,1,1,1,
0,0,1,0,1,21,1,1,1,
1,21,1,1,1,0,1,1,1,
1,1,1,0,1,0,1,21,0,
1,1,1,21,1,0,1,1,1,
0,0,1,21,1,0,0,0,0,
1,1,1,21,1,1,1,1,1,
1,21,0,0,1,0,0,0,0,
1,21,1,1,1,1,1,1,1,
1,21,1,0,1,1,1,1,1,
1,21,1,1,1,1,1,1,1,
1,0,1,0,0,21,0,0,0,
1,1,1,21,1,1,1,0,1,
1,0,21,0,0,0,1,0,1,
1,1,1,1,1,21,1,0,1,
0,0,1,0,1,21,1,0,1,
1,0,1,0,1,21,1,0,1,
0,0,1,0,0,21,1,0,0,
1,1,1,1,1,1,1,21,1,
1,21,0,0,0,0,1,0,1,
1,0,1,21,1,0,1,0,1,
0,0,1,1,1,1,1,1,21,
0,1,1,1,1,1,1,21,0,
0,1,1,1,1,1,1,21,1,
0,1,1,1,1,0,0,21,1,
0,0,21,0,0,0,1,1,1,
1,1,1,21,1,0,1,1,1,
1,1,1,0,1,0,21,0,1,
1,1,1,21,0,1,1,0,1,
0,0,0,1,21,1,1,1,1,
1,1,0,21,0,1,1,0,1,
1,1,21,1,0,1,1,1,1,
1,1,21,0,0,1,1,1,1,
1,1,0,1,0,0,21,0,0,
1,1,0,0,0,1,21,1,0,
1,1,0,1,21,0,1,0,0,
0,0,0,0,0,0,0,0,0,
0,0,0,0,0,0,0,0,0,
0,0,0,0,0,0,0,0,0.
[layer]
type=Tile Layer 2
data=
197,197,197,197,0,197,0,197,0,
0,0,0,0,0,195,0,195,0,
184,184,184,184,184,184,184,184,0,
139,139,139,0,139,139,139,139,139,
0,0,133,0,133,0,133,133,133,
166,0,166,166,166,0,166,166,166,
153,153,153,0,153,0,153,0,0,
141,141,141,0,141,0,141,141,141,
0,0,129,0,129,0,0,0,0,
153,153,153,0,153,153,153,153,153,
148,0,0,0,148,0,0,0,0,
130,0,130,130,130,130,130,130,130,
124,0,124,0,124,124,124,124,124,
147,0,147,147,147,147,147,147,147,
143,0,143,0,0,0,0,0,0,
131,131,131,0,131,131,131,0,131,
120,0,0,0,0,0,120,0,120,
149,149,149,149,149,0,149,0,149,
0,0,138,0,138,0,138,0,138,
127,0,127,0,127,0,127,0,127,
0,0,115,0,0,0,115,0,0,
137,137,137,137,137,137,137,0,137,
133,0,0,0,0,0,133,0,133,
122,0,122,0,122,0,122,0,122,
0,0,111,111,111,111,111,111,0,
0,138,138,138,138,138,138,0,0,
0,127,127,127,127,127,127,0,127,
0,117,117,117,117,0,0,0,117,
0,0,0,0,0,0,107,107,107,
106,106,106,0,106,0,106,106,106,
96,96,96,0,96,0,0,0,96,
95,95,95,0,0,95,95,0,95,
0,0,0,94,0,94,94,94,94,
84,84,0,0,0,84,84,0,84,
83,83,0,83,0,83,83,83,83,
82,82,0,0,0,82,82,82,82,
81,81,0,81,0,0,0,0,0,
80,80,0,0,0,80,0,80,0,
79,79,0,79,0,0,79,0,0,
0,0,0,0,0,0,0,0,0,
0,0,0,0,0,0,0,0,0,
0,0,0,0,0,0,0,0,0.