[layer]
type=Tile Layer 1
data=
1,1,1,1,1,6,1,1,21,
4,1,21,4,5,1,1,1,0,
1,1,21,1,1,5,6,1,0,
1,1,21,1,1,1,6,1,0,
1,1,21,1,5,1,3,3,0,
0,1,0,0,0,21,0,0,0,
4,1,1,1,1,0,21,0,0,
3,1,1,21,0,4,0,0,0,
1,1,1,21,0,0,0,1,5,
0,0,0,0,0,1,21,6,1,
0,3,21,1,0,0,0,1,1,
0,21,0,0,1,0,0,1,1,
0,0,1,21,0,0,5,1,1,
0,1,6,1,1,0,21,1,1,
0,0,0,21,0,0,0,3,1,
1,5,1,21,1,0,0,0,0,
6,1,1,21,1,1,1,1,5,
0,21,1,0,1,0,4,1,1,
1,1,1,21,1,0,1,5,1,
1,1,6,0,0,21,1,0,0,
1,5,3,21,1,1,1,0,1,
1,1,1,21,3,1,1,0,1,
1,1,1,1,4,1,1,21,3,
0,21,0,0,4,1,5,0,1,
1,3,1,1,1,21,1,1,6,
1,0,1,21,0,0,4,6,3,
1,21,1,1,1,0,1,1,1,
1,21,1,1,1,0,6,0,0,
5,21,1,1,1,0,1,1,1,
1,21,1,3,1,0,5,3,1,
1,21,1,1,1,0,3,1,6,
1,0,21,0,1,0,1,6,3,
1,1,1,21,1,0,1,4,1,
4,5,21,1,0,0,0,0,0,
0,0,21,1,1,1,0,1,0,
0,1,1,3,1,1,21,1,0,
0,4,21,1,0,0,5,0,0,
0,1,1,1,0,1,1,21,4,
1,0,3,1,1,21,1,0,1,
5,0,1,0,1,0,21,0,1,
0,0,1,1,0,1,4,21,6,
0,1,21,0,0,1,1,0,1,
1,21,1,1,1,6,1,0,1,
4,1,1,1,1,1,6,21,1,
0,0,0,1,21,1,4,1,3,
1,6,1,1,1,21,5,1,1,
0,0,0,21,1,0,1,1,4,
1,6,1,21,5,1,1,1,1,
0,0,0,0,0,0,0,0,0,
0,0,0,0,0,0,0,0,0,
0,0,0,0,0,0,0,0,0.
[layer]
type=Tile Layer 2
data=
218,218,218,218,218,218,218,218,0,
228,228,0,228,228,228,228,228,0,
226,226,0,226,226,226,226,226,0,
184,184,0,184,184,184,184,184,0,
169,169,0,169,169,169,169,169,0,
0,155,0,0,0,0,0,0,0,
193,193,193,193,193,0,0,0,0,
179,179,179,0,0,179,0,0,0,
165,165,165,0,0,0,0,165,165,
0,0,0,0,0,150,0,150,150,
0,188,0,188,0,0,0,188,188,
0,0,0,0,174,0,0,174,174,
0,0,160,0,0,0,160,160,160,
0,146,146,146,146,0,0,146,146,
0,0,0,0,0,0,0,182,182,
168,168,168,0,168,0,0,0,0,
148,148,148,0,148,148,148,148,148,
0,0,142,0,142,0,142,142,142,
177,177,177,0,177,0,177,177,177,
163,163,163,0,0,0,163,0,0,
150,150,150,0,150,150,150,0,150,
137,137,137,0,137,137,137,0,137,
163,163,163,163,163,163,163,0,163,
0,0,0,0,158,158,158,0,158,
138,138,138,138,138,0,138,138,138,
133,0,133,0,0,0,133,133,133,
165,0,165,165,165,0,165,165,165,
153,0,153,153,153,0,153,0,0,
141,0,141,141,141,0,141,141,141,
128,0,128,128,128,0,128,128,128,
160,0,160,160,160,0,160,160,160,
148,0,0,0,148,0,148,148,148,
136,136,136,0,136,0,136,136,136,
124,124,0,124,0,0,0,0,0,
0,0,0,154,154,154,0,154,0,
0,142,142,142,142,142,0,142,0,
0,131,0,131,0,0,131,0,0,
0,120,120,120,0,120,120,0,120,
119,0,119,119,119,0,119,0,119,
108,0,108,0,108,0,0,0,108,
0,0,107,107,0,107,107,0,107,
0,106,0,0,0,106,106,0,106,
95,0,95,95,95,95,95,0,95,
90,90,90,90,90,90,90,0,90,
0,0,0,93,0,93,93,93,93,
88,88,88,88,88,0,88,88,88,
0,0,0,0,91,0,91,91,91,
86,86,86,0,86,86,86,86,86,
0,0,0,0,0,0,0,0,0,
0,0,0,0,0,0,0,0,0,
0,0,0,0,0,0,0,0,0.