[layer]
type=Tile Layer 1
data=
0,2,2,2,2,2,2,21,9,
2,9,2,2,2,2,2,21,2,
1,2,2,5,1,21,0,0,0,
1,3,6,3,1,21,5,1,1,
1,1,1,1,1,21,1,1,1,
2,2,2,2,7,21,2,2,2,
0,0,21,0,1,0,1,1,1,
1,4,1,1,5,21,1,6,1,
4,1,1,0,0,0,0,21,0,
1,0,21,0,0,0,2,2,1,
1,1,1,1,21,2,10,2,3,
1,1,5,1,6,2,21,2,0,
3,1,1,1,1,6,21,1,0,
0,0,21,0,0,0,0,0,1,
0,2,21,2,0,5,1,1,1,
0,2,10,2,21,0,1,3,1,
6,2,2,0,0,0,0,21,0,
0,21,1,1,1,1,1,0,0,
0,0,21,0,1,1,1,0,3,
1,1,1,1,4,1,1,21,1,
4,6,6,21,1,1,1,0,1,
5,1,1,21,1,1,1,0,1,
7,2,2,2,2,21,2,0,2,
4,3,1,21,1,0,1,5,1,
1,0,0,21,2,2,1,1,3,
1,21,2,2,8,2,6,1,1,
1,2,8,21,2,0,1,0,0,
0,21,7,2,2,2,2,2,2,
6,21,1,1,5,1,1,0,1,
5,21,1,1,1,1,1,0,3,
1,21,3,1,1,1,5,1,1,
0,0,0,0,1,21,0,0,1,
2,2,2,2,2,21,7,2,2,
4,1,1,5,1,21,1,1,1,
1,1,1,1,5,21,1,6,1,
0,0,0,0,1,21,0,0,0,
0,0,2,0,2,1,21,4,1,
0,0,2,10,2,6,0,21,1,
0,1,2,2,2,0,1,21,1,
0,0,1,1,0,0,21,0,6,
1,0,21,4,0,1,0,1,0,
2,2,21,2,2,7,2,2,0,
1,1,0,1,6,21,0,1,0,
0,2,2,7,2,2,2,2,21,
0,2,2,2,2,2,21,2,9,
0,3,0,1,2,10,21,2,2,
0,0,0,1,2,21,0,0,0,
5,1,1,1,21,1,1,1,4,
0,21,0,1,0,0,0,0,0,
1,1,5,1,21,1,1,6,1,
1,1,6,1,21,1,4,1,1,
0,0,0,0,0,0,0,0,0,
0,0,0,0,0,0,0,0,0,
0,0,0,0,0,0,0,0,0.
[layer]
type=Tile Layer 2
data=
0,234,234,234,234,234,234,0,234,
233,233,233,233,233,233,233,0,233,
231,231,231,231,231,0,0,0,0,
166,166,166,166,166,0,166,166,166,
152,152,152,152,152,0,152,152,152,
199,199,199,199,199,0,199,199,199,
0,0,0,0,184,0,184,184,184,
161,161,161,161,161,0,161,161,161,
155,155,155,0,0,0,0,0,0,
193,0,0,0,0,0,193,193,193,
179,179,179,179,0,179,179,179,179,
165,165,165,165,165,165,0,165,0,
150,150,150,150,150,150,0,150,0,
0,0,0,0,0,0,0,0,188,
0,174,0,174,0,174,174,174,174,
0,160,160,160,0,0,160,160,160,
146,146,146,0,0,0,0,0,0,
0,0,182,182,182,182,182,0,0,
0,0,0,0,168,168,168,0,168,
148,148,148,148,148,148,148,0,148,
142,142,142,0,142,142,142,0,142,
177,177,177,0,177,177,177,0,177,
163,163,163,163,163,0,163,0,163,
150,150,150,0,150,0,150,150,150,
137,0,0,0,137,137,137,137,137,
171,0,171,171,171,171,171,171,171,
158,158,158,0,158,0,158,0,0,
0,0,145,145,145,145,145,145,145,
133,0,133,133,133,133,133,0,133,
165,0,165,165,165,165,165,0,165,
146,0,146,146,146,146,146,146,146,
0,0,0,0,141,0,0,0,141,
128,128,128,128,128,0,128,128,128,
152,152,152,152,152,0,152,152,152,
141,141,141,141,141,0,141,141,141,
0,0,0,0,136,0,0,0,0,
0,0,124,0,124,124,0,124,124,
0,0,154,154,154,154,0,0,154,
0,142,142,142,142,0,142,0,142,
0,0,131,131,0,0,0,0,131,
120,0,0,120,0,120,0,120,0,
119,119,0,119,119,119,119,119,0,
108,108,0,108,108,0,0,108,0,
0,107,107,107,107,107,107,107,0,
0,106,106,106,106,106,0,106,106,
0,95,0,95,95,95,0,95,95,
0,0,0,94,94,0,0,0,0,
89,89,89,89,0,89,89,89,89,
0,0,0,92,0,0,0,0,0,
87,87,87,87,0,87,87,87,87,
86,86,86,86,0,86,86,86,86,
0,0,0,0,0,0,0,0,0,
0,0,0,0,0,0,0,0,0,
0,0,0,0,0,0,0,0,0.