[layer]
type=Tile Layer 1
data=
1,1,0,21,1,1,1,1,0,
1,1,21,0,1,1,0,0,0,
1,1,21,0,1,1,0,0,1,
1,1,21,1,1,1,1,0,1,
1,0,0,21,0,1,1,1,1,
0,21,1,1,0,1,1,1,1,
1,1,1,0,0,21,0,1,1,
1,1,0,21,1,1,0,1,1,
1,0,0,1,1,1,0,21,0,
0,21,1,1,1,1,1,1,0,
0,0,1,1,1,1,1,1,21,
1,1,1,1,1,21,1,1,0,
1,1,0,0,21,0,1,1,0,
1,1,0,1,1,1,1,21,0,
1,1,21,0,0,0,0,0,1,
1,21,1,0,1,1,1,0,1,
0,0,1,0,1,0,21,0,1,
1,1,1,21,1,1,1,1,1,
0,0,1,0,21,0,0,0,1,
1,21,1,1,1,1,1,0,1,
1,0,1,0,0,0,21,0,1,
1,21,1,0,1,1,1,1,1,
1,0,1,0,0,0,1,21,0,
1,21,1,1,1,0,1,1,1,
1,1,1,0,0,21,0,0,1,
1,1,1,21,1,1,1,1,1,
1,1,1,0,0,0,21,0,1,
1,1,1,1,1,1,1,21,1,
0,0,0,0,1,1,1,21,1,
1,1,1,1,1,1,1,21,1,
0,1,1,0,21,0,0,0,0,
1,1,1,1,1,21,1,1,1,
1,1,1,1,1,21,1,1,1,
1,1,1,1,21,1,0,1,1,
1,1,1,1,0,0,21,1,0,
1,1,1,1,21,1,1,1,0,
1,1,1,1,0,1,21,0,0,
1,1,1,1,0,1,21,1,0,
0,1,0,1,0,1,0,1,21,
0,0,0,0,0,0,0,0,0,
0,0,0,0,0,0,0,0,0,
0,0,0,0,0,0,0,0,0.
[layer]
type=Tile Layer 2
data=
197,197,0,0,197,197,197,197,0,
195,195,0,0,195,195,0,0,0,
194,194,0,0,194,194,0,0,194,
146,146,0,146,146,146,146,0,146,
133,0,0,0,0,133,133,133,133,
0,0,166,166,0,166,166,166,166,
153,153,153,0,0,0,0,153,153,
141,141,0,0,141,141,0,141,141,
129,0,0,129,129,129,0,0,0,
0,0,161,161,161,161,161,161,0,
0,0,148,148,148,148,148,148,0,
136,136,136,136,136,0,136,136,0,
124,124,0,0,0,0,124,124,0,
155,155,0,155,155,155,155,0,0,
143,143,0,0,0,0,0,0,143,
131,0,131,0,131,131,131,0,131,
0,0,120,0,120,0,0,0,120,
142,142,142,0,142,142,142,142,142,
0,0,138,0,0,0,0,0,138,
127,0,127,127,127,127,127,0,127,
115,0,115,0,0,0,0,0,115,
144,0,144,0,144,144,144,144,144,
133,0,133,0,0,0,133,0,0,
122,0,122,122,122,0,122,122,122,
111,111,111,0,0,0,0,0,111,
132,132,132,0,132,132,132,132,132,
127,127,127,0,0,0,0,0,127,
111,111,111,111,111,111,111,0,111,
0,0,0,0,107,107,107,0,107,
101,101,101,101,101,101,101,0,101,
0,96,96,0,0,0,0,0,0,
90,90,90,90,90,0,90,90,90,
89,89,89,89,89,0,89,89,89,
84,84,84,84,0,84,0,84,84,
83,83,83,83,0,0,0,83,0,
82,82,82,82,0,82,82,82,0,
81,81,81,81,0,81,0,0,0,
80,80,80,80,0,80,0,80,0,
0,79,0,79,0,79,0,79,0,
0,0,0,0,0,0,0,0,0,
0,0,0,0,0,0,0,0,0,
0,0,0,0,0,0,0,0,0.