[layer]
type=Tile Layer 1
data=
1,0,1,21,1,0,0,0,1,
1,21,1,0,1,3,1,0,5,
0,0,4,0,0,21,1,0,1,
1,1,1,5,1,21,6,0,1,
1,0,21,0,0,0,1,0,1,
1,21,1,5,1,1,4,0,1,
1,21,3,0,0,0,0,0,1,
1,0,1,21,4,6,1,0,1,
0,21,1,0,1,0,1,0,0,
0,1,1,1,1,0,0,21,3,
0,0,1,5,1,1,1,21,1,
1,0,0,0,21,1,5,0,4,
4,1,6,3,0,0,21,0,0,
1,1,0,21,0,0,0,1,0,
1,1,0,21,0,1,1,1,0,
0,0,0,0,0,0,0,0,0,
0,0,0,0,0,0,0,0,0,
0,0,0,0,0,0,0,0,0.
[layer]
type=Tile Layer 2
data=
123,0,123,0,123,0,0,0,123,
121,0,121,0,121,121,121,0,121,
0,0,119,0,0,0,119,0,119,
85,85,85,85,85,0,85,0,85,
81,0,0,0,0,0,81,0,81,
76,0,76,76,76,76,76,0,76,
72,0,72,0,0,0,0,0,72,
71,0,71,0,71,71,71,0,71,
0,0,70,0,70,0,70,0,0,
0,62,62,62,62,0,0,0,62,
0,0,61,61,61,61,61,0,61,
60,0,0,0,0,60,60,0,60,
59,59,59,59,0,0,0,0,0,
58,58,0,0,0,0,0,58,0,
57,57,0,0,0,57,57,57,0,
0,0,0,0,0,0,0,0,0,
0,0,0,0,0,0,0,0,0,
0,0,0,0,0,0,0,0,0.