[layer]
type=Tile Layer 1
data=
1,1,1,1,1,21,1,0,0,
1,1,1,1,1,21,1,0,1,
1,1,1,1,1,21,1,0,1,
1,1,21,0,0,0,1,1,1,
1,1,1,21,1,0,0,1,1,
1,1,1,21,1,1,0,1,1,
1,1,1,0,1,1,21,0,0,
1,1,1,1,0,21,0,0,0,
1,1,21,0,1,0,1,1,1,
1,1,21,1,1,0,1,1,1,
1,1,1,21,1,0,0,0,1,
1,1,1,0,0,21,1,0,1,
1,1,1,1,1,21,1,1,1,
0,0,21,0,1,0,1,1,1,
1,1,1,21,1,0,1,1,1,
0,21,0,0,1,0,0,0,0,
1,1,1,1,1,1,1,1,21,
1,1,1,0,1,0,21,0,0,
1,1,1,21,1,1,1,1,1,
0,0,21,0,1,1,1,1,1,
1,1,1,21,1,1,1,1,1,
1,1,1,0,0,21,0,0,1,
1,1,1,21,1,1,1,0,1,
1,1,1,0,21,0,0,0,1,
1,1,1,1,0,1,1,21,0,
1,21,1,1,1,1,1,0,0,
1,0,0,1,1,1,1,21,0,
0,0,0,0,0,0,0,0,0,
0,0,0,0,0,0,0,0,0,
0,0,0,0,0,0,0,0,0.
[layer]
type=Tile Layer 2
data=
160,160,160,160,160,0,160,0,0,
158,158,158,158,158,0,158,0,158,
157,157,157,157,157,0,157,0,157,
117,117,0,0,0,0,117,117,117,
107,107,107,0,107,0,0,107,107,
133,133,133,0,133,133,0,133,133,
123,123,123,0,123,123,0,0,0,
113,113,113,113,0,0,0,0,0,
102,102,0,0,102,0,102,102,102,
128,128,0,128,128,0,128,128,128,
118,118,118,0,118,0,0,0,118,
108,108,108,0,0,0,108,0,108,
93,93,93,93,93,0,93,93,93,
0,0,0,0,122,0,122,122,122,
112,112,112,0,112,0,112,112,112,
0,0,0,0,103,0,0,0,0,
89,89,89,89,89,89,89,89,0,
93,93,93,0,93,0,0,0,0,
80,80,80,0,80,80,80,80,80,
0,0,0,0,83,83,83,83,83,
78,78,78,0,78,78,78,78,78,
73,73,73,0,0,0,0,0,73,
72,72,72,0,72,72,72,0,72,
71,71,71,0,0,0,0,0,71,
70,70,70,70,0,70,70,0,0,
69,0,69,69,69,69,69,0,0,
68,0,0,68,68,68,68,0,0,
0,0,0,0,0,0,0,0,0,
0,0,0,0,0,0,0,0,0,
0,0,0,0,0,0,0,0,0.