[layer]
type=Tile Layer 1
data=
1,1,1,1,1,21,1,1,1,
1,1,1,21,1,0,0,0,1,
1,1,1,21,1,1,1,0,1,
1,1,1,1,1,0,0,21,0,
1,1,1,1,1,0,21,0,0,
1,1,1,21,0,0,1,1,1,
0,0,18,2,0,2,2,2,21,
0,1,1,1,0,1,21,0,0,
0,0,1,1,21,0,0,1,1,
1,1,0,1,1,21,0,0,0,
1,1,21,1,1,0,1,1,0,
1,2,0,21,0,0,0,0,0,
1,21,19,0,1,1,1,1,1,
1,2,2,21,2,2,2,1,1,
1,1,1,0,0,19,21,0,0,
1,1,1,1,2,2,2,21,1,
1,1,1,21,1,1,1,0,1,
1,1,1,21,1,1,1,0,1,
0,0,1,21,0,0,1,0,0,
1,1,1,21,2,2,2,1,1,
2,2,2,21,2,20,2,2,2,
1,21,2,0,2,0,2,1,1,
1,24,2,21,2,0,1,1,1,
1,21,2,24,2,1,1,1,1,
0,0,1,21,0,0,0,0,1,
1,1,1,1,1,21,1,0,1,
1,1,1,1,1,21,1,0,1,
1,1,1,1,1,21,1,1,1,
1,21,0,1,0,0,1,1,0,
1,1,1,21,1,1,1,1,1,
0,1,1,1,1,0,0,1,21,
0,2,2,2,2,21,2,0,18,
0,0,0,21,1,0,1,1,1,
1,1,1,0,1,21,1,1,0,
2,2,2,21,2,0,18,2,0,
1,0,0,1,0,21,2,19,1,
1,0,1,21,0,0,2,2,0,
1,1,1,0,1,1,21,1,0,
0,0,0,21,0,0,0,2,0,
2,2,2,2,0,21,20,2,0,
1,1,1,1,1,2,2,2,21,
1,1,1,1,0,21,0,0,0,
1,1,1,1,1,1,1,1,21,
0,1,21,0,0,0,0,1,0,
1,1,21,1,1,1,1,1,0,
0,0,0,0,0,0,0,0,0,
0,0,0,0,0,0,0,0,0,
0,0,0,0,0,0,0,0,0.
[layer]
type=Tile Layer 2
data=
198,198,198,198,198,0,198,198,198,
206,206,206,0,206,0,0,0,206,
204,204,204,0,204,204,204,0,204,
178,178,178,178,178,0,0,0,0,
165,165,165,165,165,0,0,0,0,
152,152,152,0,0,0,152,152,152,
0,0,0,138,0,138,138,138,0,
0,173,173,173,0,173,0,0,0,
0,0,160,160,0,0,0,160,160,
147,147,0,147,147,0,0,0,0,
134,134,0,134,134,0,134,134,0,
167,167,0,0,0,0,0,0,0,
154,0,0,0,154,154,154,154,154,
135,135,135,0,135,135,135,135,135,
130,130,130,0,0,0,0,0,0,
154,154,154,154,154,154,154,0,154,
149,149,149,0,149,149,149,0,149,
137,137,137,0,137,137,137,0,137,
0,0,125,0,0,0,125,0,0,
148,148,148,0,148,148,148,148,148,
144,144,144,0,144,0,144,144,144,
132,0,132,0,132,0,132,132,132,
121,0,121,0,121,0,121,121,121,
150,0,150,0,150,150,150,150,150,
0,0,139,0,0,0,0,0,139,
128,128,128,128,128,0,128,0,128,
116,116,116,116,116,0,116,0,116,
138,138,138,138,138,0,138,138,138,
134,0,0,134,0,0,134,134,0,
117,117,117,0,117,117,117,117,117,
0,112,112,112,112,0,0,112,0,
0,139,139,139,139,0,139,0,0,
0,0,0,0,128,0,128,128,128,
118,118,118,0,118,0,118,118,0,
108,108,108,0,108,0,0,108,0,
107,0,0,107,0,0,107,0,107,
97,0,97,0,0,0,97,97,0,
96,96,96,0,96,96,0,96,0,
0,0,0,0,0,0,0,95,0,
85,85,85,85,0,0,0,85,0,
80,80,80,80,80,80,80,80,0,
83,83,83,83,0,0,0,0,0,
78,78,78,78,78,78,78,78,0,
0,81,0,0,0,0,0,81,0,
80,80,0,80,80,80,80,80,0,
0,0,0,0,0,0,0,0,0,
0,0,0,0,0,0,0,0,0,
0,0,0,0,0,0,0,0,0.