[layer]
type=Tile Layer 1
data=
1,1,1,1,21,5,1,0,1,
4,1,4,1,21,5,1,0,1,
1,1,6,1,21,1,1,0,1,
1,0,21,0,0,1,1,0,1,
1,21,1,3,3,6,0,0,1,
0,0,5,1,1,1,1,1,21,
0,1,1,0,0,0,0,0,21,
0,21,0,0,4,6,1,1,1,
0,21,0,5,1,1,1,1,1,
1,1,21,3,1,4,1,1,1,
0,21,0,0,0,1,0,4,6,
1,1,21,1,1,1,0,1,1,
0,1,0,0,0,0,21,0,0,
0,6,0,1,1,1,4,1,21,
0,1,21,1,1,3,1,1,0,
0,1,3,4,5,1,1,1,21,
0,0,0,0,0,1,0,0,21,
0,4,1,1,0,1,21,1,1,
1,0,21,0,0,1,1,1,1,
1,6,21,5,1,0,1,6,1,
1,1,21,0,0,0,1,3,1,
1,21,0,1,1,0,0,0,0,
0,0,1,1,21,0,1,0,0,
0,21,1,1,0,5,3,0,4,
0,0,0,0,0,0,0,0,0,
0,0,0,0,0,0,0,0,0,
0,0,0,0,0,0,0,0,0.
[layer]
type=Tile Layer 2
data=
131,131,131,131,0,131,131,0,131,
130,130,130,130,0,130,130,0,130,
128,128,128,128,0,128,128,0,128,
109,0,0,0,0,109,109,0,109,
100,0,100,100,100,100,0,0,100,
0,0,90,90,90,90,90,90,0,
0,113,113,0,0,0,0,0,0,
0,0,0,0,104,104,104,104,104,
0,0,0,95,95,95,95,95,95,
78,78,0,78,78,78,78,78,78,
0,0,0,0,0,107,0,107,107,
94,94,0,94,94,94,0,94,94,
0,90,0,0,0,0,0,0,0,
0,82,0,82,82,82,82,82,0,
0,81,0,81,81,81,81,81,0,
0,69,69,69,69,69,69,69,0,
0,0,0,0,0,72,0,0,0,
0,71,71,71,0,71,0,71,71,
63,0,0,0,0,63,63,63,63,
59,59,0,59,59,0,59,59,59,
61,61,0,0,0,0,61,61,61,
60,0,0,60,60,0,0,0,0,
0,0,59,59,0,0,59,0,0,
0,0,58,58,0,58,58,0,58,
0,0,0,0,0,0,0,0,0,
0,0,0,0,0,0,0,0,0,
0,0,0,0,0,0,0,0,0.