[layer]
type=Tile Layer 1
data=
0,21,0,1,0,1,0,1,0,
0,1,0,1,1,1,21,1,0,
0,1,0,1,0,21,0,1,0,
0,1,1,1,0,1,1,1,21,
0,0,0,21,0,1,0,0,0,
0,1,1,1,1,1,21,1,1,
0,0,0,1,0,0,0,0,21,
1,1,21,1,1,1,1,1,0,
0,0,0,1,0,0,21,0,0,
0,0,0,0,21,0,0,0,1,
1,21,0,0,1,1,1,0,1,
1,1,1,0,1,1,1,21,0,
1,1,1,0,1,1,1,21,0,
1,1,1,0,0,21,0,0,1,
1,1,1,21,1,1,1,0,1,
0,0,0,0,0,0,0,0,0,
0,0,0,0,0,0,0,0,0,
0,0,0,0,0,0,0,0,0.
[layer]
type=Tile Layer 2
data=
0,0,0,123,0,123,0,123,0,
0,121,0,121,121,121,0,121,0,
0,119,0,119,0,0,0,119,0,
0,89,89,89,0,89,89,89,0,
0,0,0,0,0,81,0,0,0,
0,76,76,76,76,76,0,76,76,
0,0,0,72,0,0,0,0,0,
67,67,0,67,67,67,67,67,0,
0,0,0,70,0,0,0,0,0,
0,0,0,0,0,0,0,0,62,
61,0,0,0,61,61,61,0,61,
60,60,60,0,60,60,60,0,0,
59,59,59,0,59,59,59,0,0,
58,58,58,0,0,0,0,0,58,
55,55,55,0,55,55,55,0,55,
0,0,0,0,0,0,0,0,0,
0,0,0,0,0,0,0,0,0,
0,0,0,0,0,0,0,0,0.