[layer]
type=Tile Layer 1
data=
0,1,1,4,1,1,0,1,21,
0,21,0,5,0,1,0,1,0,
0,1,1,3,0,4,21,1,0,
0,1,1,5,0,1,0,3,21,
1,1,1,1,1,6,1,6,21,
0,1,21,0,0,0,0,0,0,
1,1,1,5,5,4,1,21,1,
0,1,1,6,21,0,0,0,0,
0,1,1,1,21,1,1,1,1,
1,1,1,21,0,0,5,1,0,
1,1,1,0,21,1,1,0,0,
3,1,6,1,21,1,1,0,3,
1,1,1,5,0,1,21,0,6,
1,1,4,1,21,1,0,1,1,
1,1,1,1,4,6,21,0,1,
3,1,0,0,21,0,1,0,1,
6,1,21,1,1,1,1,0,1,
1,5,0,0,0,0,0,21,0,
0,0,0,1,21,0,0,6,0,
1,4,21,1,1,1,1,1,0,
0,0,0,1,0,0,21,0,0,
0,4,1,1,0,1,21,1,1,
0,0,21,1,0,5,0,0,0,
0,1,0,1,0,1,1,3,21,
0,0,0,0,0,0,0,0,0,
0,0,0,0,0,0,0,0,0,
0,0,0,0,0,0,0,0,0.
[layer]
type=Tile Layer 2
data=
0,138,138,138,138,138,0,138,0,
0,0,0,136,0,136,0,136,0,
0,135,135,135,0,135,0,135,0,
0,109,109,109,0,109,0,109,0,
90,90,90,90,90,90,90,90,0,
0,90,0,0,0,0,0,0,0,
102,102,102,102,102,102,102,0,102,
0,104,104,104,0,0,0,0,0,
0,90,90,90,0,90,90,90,90,
86,86,86,0,0,0,86,86,0,
107,107,107,0,0,107,107,0,0,
94,94,94,94,0,94,94,0,94,
90,90,90,90,0,90,0,0,90,
78,78,78,78,0,78,0,78,78,
77,77,77,77,77,77,0,0,77,
73,73,0,0,0,0,73,0,73,
68,68,0,68,68,68,68,0,68,
71,71,0,0,0,0,0,0,0,
0,0,0,63,0,0,0,63,0,
59,59,0,59,59,59,59,59,0,
0,0,0,61,0,0,0,0,0,
0,60,60,60,0,60,0,60,60,
0,0,0,59,0,59,0,0,0,
0,58,0,58,0,58,58,58,0,
0,0,0,0,0,0,0,0,0,
0,0,0,0,0,0,0,0,0,
0,0,0,0,0,0,0,0,0.