[layer]
type=Tile Layer 1
data=
1,1,1,1,21,1,1,3,1,
0,21,0,1,0,6,1,1,0,
1,5,21,1,0,1,5,1,0,
4,1,0,6,21,1,1,1,0,
4,1,21,5,1,1,1,1,1,
1,1,0,0,0,0,0,21,0,
3,1,1,1,1,5,21,1,1,
0,0,0,3,1,1,0,21,0,
0,1,0,1,4,1,21,1,1,
1,3,0,21,0,0,0,0,0,
6,1,1,1,6,1,1,1,21,
5,1,1,1,1,21,0,1,0,
1,6,6,1,21,0,0,0,0,
1,1,1,21,0,4,0,3,1,
1,1,1,21,1,1,0,0,0,
6,1,1,1,4,1,21,1,0,
1,4,1,21,0,5,0,0,1,
1,21,0,0,0,1,1,0,1,
1,0,4,21,0,0,1,0,0,
1,1,1,6,1,21,1,1,3,
0,0,0,21,1,0,1,1,6,
5,0,1,21,6,0,1,1,1,
1,0,3,21,1,0,1,1,1,
5,21,1,3,1,1,1,1,1,
1,0,0,0,21,0,5,1,0,
1,1,21,3,3,1,1,1,1,
0,1,0,0,6,1,0,0,21,
1,6,1,0,21,0,0,0,1,
1,1,1,1,21,0,3,0,1,
4,3,1,21,0,1,1,0,1,
0,0,0,21,1,3,0,0,4,
0,0,1,6,1,1,21,1,1,
1,0,0,1,0,21,0,1,1,
0,0,0,0,0,0,0,0,0,
0,0,0,0,0,0,0,0,0,
0,0,0,0,0,0,0,0,0.
[layer]
type=Tile Layer 2
data=
163,163,163,163,0,163,163,163,163,
0,0,0,170,0,170,170,170,0,
168,168,0,168,0,168,168,168,0,
147,147,0,147,0,147,147,147,0,
129,129,0,129,129,129,129,129,129,
124,124,0,0,0,0,0,0,0,
108,108,108,108,108,108,0,108,108,
0,0,0,141,141,141,0,0,0,
0,130,0,130,130,130,0,130,130,
119,119,0,0,0,0,0,0,0,
104,104,104,104,104,104,104,104,0,
135,135,135,135,135,0,0,135,0,
125,125,125,125,0,0,0,0,0,
115,115,115,0,0,115,0,115,115,
104,104,104,0,104,104,0,0,0,
130,130,130,130,130,130,0,130,0,
120,120,120,0,0,120,0,0,120,
110,0,0,0,0,110,110,0,110,
100,0,100,0,0,0,100,0,0,
118,118,118,118,118,0,118,118,118,
0,0,0,0,114,0,114,114,114,
105,0,105,0,105,0,105,105,105,
96,0,96,0,96,0,96,96,96,
90,0,90,90,90,90,90,90,90,
86,0,0,0,0,0,86,86,0,
81,81,0,81,81,81,81,81,81,
0,84,0,0,84,84,0,0,0,
75,75,75,0,0,0,0,0,75,
74,74,74,74,0,0,74,0,74,
73,73,73,0,0,73,73,0,73,
0,0,0,0,72,72,0,0,72,
0,0,71,71,71,71,0,71,71,
70,0,0,70,0,0,0,70,70,
0,0,0,0,0,0,0,0,0,
0,0,0,0,0,0,0,0,0,
0,0,0,0,0,0,0,0,0.