[layer]
type=Tile Layer 1
data=
1,1,1,0,0,21,0,1,1,
1,1,1,0,21,0,0,0,1,
1,1,1,1,1,0,1,21,0,
1,1,1,1,1,21,0,1,0,
1,1,1,1,1,1,21,0,0,
0,1,1,1,1,1,21,1,1,
0,0,0,21,1,1,0,0,0,
1,1,1,21,0,1,1,0,0,
1,1,1,21,0,1,1,0,1,
1,1,21,1,0,0,0,1,1,
1,1,21,1,0,1,0,1,1,
1,1,21,1,0,1,1,1,1,
1,1,0,1,0,21,0,0,0,
1,1,1,0,0,1,1,21,0,
1,1,1,21,0,1,0,0,1,
1,1,21,0,1,1,0,0,0,
0,21,0,1,1,1,1,1,0,
0,1,1,1,1,1,1,0,21,
1,21,1,0,1,1,1,1,1,
1,0,1,0,21,0,0,0,0,
1,21,1,1,1,1,1,1,1,
1,0,0,21,1,0,0,0,1,
1,21,1,0,1,0,1,1,1,
1,21,1,0,1,0,1,0,0,
1,1,1,0,1,21,1,0,1,
1,0,0,0,1,21,1,0,1,
1,0,1,1,1,21,1,0,1,
0,1,1,1,1,1,0,1,21,
0,1,1,1,1,1,21,1,1,
0,0,21,1,0,0,0,1,1,
1,1,1,1,21,1,0,1,1,
0,0,21,0,0,1,0,1,1,
21,1,1,1,1,1,1,1,1,
0,1,1,1,0,1,1,0,21,
21,1,1,1,1,1,1,1,1,
0,0,21,0,0,1,1,1,1,
0,1,0,21,0,1,0,0,0,
0,1,21,1,1,1,1,1,0,
0,1,0,1,1,1,1,1,21,
0,1,21,1,1,1,1,1,0,
0,1,21,1,1,1,1,1,0,
1,1,21,1,1,1,1,1,0,
0,0,0,0,0,0,0,0,0,
0,0,0,0,0,0,0,0,0,
0,0,0,0,0,0,0,0,0.
[layer]
type=Tile Layer 2
data=
203,203,203,0,0,0,0,203,203,
201,201,201,0,0,0,0,0,201,
200,200,200,200,200,0,200,0,0,
138,138,138,138,138,0,0,138,0,
173,173,173,173,173,173,0,0,0,
0,160,160,160,160,160,0,160,160,
0,0,0,0,147,147,0,0,0,
134,134,134,0,0,134,134,0,0,
167,167,167,0,0,167,167,0,167,
154,154,0,154,0,0,0,154,154,
142,142,0,142,0,142,0,142,142,
130,130,0,130,0,130,130,130,130,
162,162,0,162,0,0,0,0,0,
149,149,149,0,0,149,149,0,0,
137,137,137,0,0,137,0,0,137,
125,125,0,0,125,125,0,0,0,
0,0,0,156,156,156,156,156,0,
0,144,144,144,144,144,144,0,0,
132,0,132,0,132,132,132,132,132,
121,0,121,0,0,0,0,0,0,
143,0,143,143,143,143,143,143,143,
139,0,0,0,139,0,0,0,139,
128,0,128,0,128,0,128,128,128,
116,0,116,0,116,0,116,0,0,
145,145,145,0,145,0,145,0,145,
134,0,0,0,134,0,134,0,134,
123,0,123,123,123,0,123,0,123,
0,112,112,112,112,112,0,112,0,
0,139,139,139,139,139,0,139,139,
0,0,0,128,0,0,0,128,128,
118,118,118,118,0,118,0,118,118,
0,0,0,0,0,108,0,108,108,
0,102,102,102,102,102,102,102,102,
0,97,97,97,0,97,97,0,0,
0,91,91,91,91,91,91,91,91,
0,0,0,0,0,95,95,95,95,
0,85,0,0,0,85,0,0,0,
0,84,0,84,84,84,84,84,0,
0,83,0,83,83,83,83,83,0,
0,82,0,82,82,82,82,82,0,
0,81,0,81,81,81,81,81,0,
80,80,0,80,80,80,80,80,0,
0,0,0,0,0,0,0,0,0,
0,0,0,0,0,0,0,0,0,
0,0,0,0,0,0,0,0,0.