[layer]
type=Tile Layer 1
data=
6,1,21,3,0,1,4,4,4,
4,0,21,0,0,0,3,3,6,
0,0,3,1,3,21,6,1,6,
0,0,0,4,1,21,0,6,6,
1,1,0,6,4,1,0,21,0,
0,21,0,3,3,4,6,3,0,
3,0,0,21,0,0,0,0,0,
4,21,1,6,3,1,3,1,4,
6,1,1,1,4,1,6,21,0,
5,5,1,21,6,1,1,0,6,
3,6,3,1,5,21,6,0,1,
3,5,6,0,3,21,1,0,5,
0,0,3,1,1,21,1,0,5,
1,3,5,6,6,21,3,0,5,
0,0,6,21,1,0,3,0,0,
0,0,0,21,0,5,6,6,5,
0,1,3,0,21,1,6,1,1,
0,3,21,5,3,5,3,0,0,
1,0,21,1,3,5,3,0,0,
3,0,0,0,21,0,4,0,0,
5,4,5,4,21,4,1,0,0,
0,0,0,0,0,0,0,0,0,
0,0,0,0,0,0,0,0,0,
0,0,0,0,0,0,0,0,0.
[layer]
type=Tile Layer 2
data=
127,127,0,127,0,127,127,127,127,
132,0,0,0,0,0,132,132,132,
0,0,130,130,130,0,130,130,130,
0,0,0,113,113,0,0,113,113,
104,104,0,104,104,104,0,0,0,
0,0,0,95,95,95,95,95,0,
86,0,0,0,0,0,0,0,0,
77,0,77,77,77,77,77,77,77,
98,4,4,4,79,4,79,0,0,
90,90,72,0,72,4,72,0,90,
82,82,82,4,65,0,82,0,82,
81,81,81,0,64,0,81,0,81,
0,0,73,3,3,0,73,0,73,
68,68,68,68,68,0,68,0,68,
0,0,71,0,71,0,71,0,0,
0,0,0,0,0,63,63,63,63,
0,62,62,0,0,62,62,62,62,
0,61,0,61,61,61,61,0,0,
60,0,0,60,60,60,60,0,0,
59,0,0,0,0,0,59,0,0,
58,58,58,58,0,58,58,0,0,
0,0,0,0,0,0,0,0,0,
0,0,0,0,0,0,0,0,0,
0,0,0,0,0,0,0,0,0.