[layer]
type=Tile Layer 1
data=
6,1,1,1,1,0,0,21,0,
1,5,1,1,3,21,1,1,0,
1,5,1,1,1,0,1,21,0,
1,0,21,0,3,0,6,1,1,
6,1,1,1,1,21,1,4,1,
0,0,0,0,0,0,21,0,1,
3,1,5,1,1,21,1,1,1,
1,1,1,1,1,21,1,4,1,
1,1,3,5,1,21,4,1,1,
1,1,1,1,1,1,3,1,21,
1,1,1,5,1,21,1,1,1,
4,0,1,21,1,0,1,0,0,
1,1,1,3,1,5,1,21,1,
0,0,0,0,1,0,21,0,0,
1,1,1,3,4,21,1,1,1,
6,5,1,1,1,21,1,4,1,
1,5,1,1,1,21,1,1,1,
6,1,1,1,4,21,1,1,1,
1,1,1,1,4,21,1,1,1,
1,0,0,0,0,0,21,0,0,
1,1,1,21,3,1,5,1,5,
1,1,1,5,5,6,1,21,1,
1,1,1,1,1,0,21,0,0,
1,1,1,4,1,21,4,1,1,
1,4,1,1,1,0,1,21,0,
1,1,6,1,1,21,4,1,1,
1,1,21,1,0,0,0,0,5,
1,1,1,1,1,1,1,21,1,
1,0,0,21,1,0,6,0,1,
3,3,1,0,1,21,1,0,5,
1,1,21,1,1,1,1,1,1,
0,1,0,3,1,1,21,0,0,
0,4,0,3,6,1,21,1,0,
0,3,21,4,1,1,0,1,0,
0,1,0,1,5,1,21,1,1,
0,5,21,1,0,0,0,1,0,
0,3,1,6,1,1,1,6,21,
0,0,21,1,4,1,1,3,0,
0,1,1,1,1,1,1,1,21,
6,1,21,0,1,6,1,1,1,
4,1,1,21,0,1,4,1,1,
1,1,1,21,0,5,1,1,1,
1,1,1,1,21,1,1,0,6,
1,1,4,3,1,1,1,21,0,
1,1,6,21,1,1,1,0,0,
1,1,1,21,1,1,3,1,4,
1,21,1,1,6,1,4,1,1,
1,21,3,1,1,1,6,1,1,
1,0,21,0,0,6,1,4,1,
1,1,21,1,0,1,1,1,3,
1,1,21,0,0,6,1,1,1,
1,1,0,21,0,6,1,1,1,
1,6,0,21,0,1,1,1,1,
1,1,0,0,21,0,3,4,1,
0,0,0,0,0,0,0,0,0,
0,0,0,0,0,0,0,0,0,
0,0,0,0,0,0,0,0,0.
[layer]
type=Tile Layer 2
data=
239,239,239,239,239,0,0,0,0,
237,237,237,237,237,0,237,237,0,
236,236,236,236,236,0,236,0,0,
164,0,0,0,164,0,164,164,164,
195,195,195,195,195,0,195,195,195,
0,0,0,0,0,0,0,0,189,
166,166,166,166,166,0,166,166,166,
152,152,121,152,152,0,121,152,152,
189,151,151,151,189,0,151,151,189,
9,9,9,9,9,9,147,9,0,
161,129,129,129,161,0,129,129,161,
155,0,7,0,155,0,124,0,0,
184,147,147,147,184,147,147,0,184,
0,0,0,0,179,0,0,0,0,
157,157,157,157,157,0,157,157,157,
143,143,143,143,143,0,143,143,143,
179,179,179,179,179,0,179,179,179,
165,165,165,165,165,0,165,165,165,
152,152,152,152,152,0,152,152,152,
146,0,0,0,0,0,0,0,0,
173,173,173,0,173,173,173,173,173,
160,160,160,160,160,160,160,0,160,
155,155,155,155,155,0,0,0,0,
135,135,135,135,135,0,135,135,135,
177,177,177,177,177,0,177,0,0,
155,155,155,155,155,0,155,155,155,
150,150,0,150,0,0,0,0,150,
131,131,131,131,131,131,131,0,131,
171,0,0,0,171,0,171,0,171,
158,158,158,0,158,0,158,0,158,
138,138,0,138,138,138,138,138,138,
0,133,0,133,133,133,0,0,0,
0,165,0,165,165,165,0,165,0,
0,153,0,153,153,153,0,153,0,
0,141,0,141,141,141,0,141,141,
0,128,0,128,0,0,0,128,0,
0,160,160,160,160,160,160,160,0,
0,0,0,148,148,148,148,148,0,
0,136,136,136,136,136,136,136,0,
124,124,0,0,124,124,124,124,124,
154,154,154,0,0,154,154,154,154,
142,142,142,0,0,142,142,142,142,
131,131,105,6,0,6,6,0,131,
120,120,96,96,96,96,96,0,0,
119,119,95,0,5,5,5,0,0,
103,103,82,0,82,82,82,103,103,
107,0,5,5,85,85,85,107,107,
101,0,80,80,80,80,80,101,101,
95,0,0,0,0,95,95,95,95,
94,94,0,94,0,94,94,94,94,
93,93,0,0,0,93,93,93,93,
92,92,0,0,0,92,92,92,92,
91,91,0,0,0,91,91,91,91,
90,90,0,0,0,0,90,90,90,
0,0,0,0,0,0,0,0,0,
0,0,0,0,0,0,0,0,0,
0,0,0,0,0,0,0,0,0.