[layer]
type=Tile Layer 1
data=
1,1,5,1,1,21,0,1,1,
1,1,1,1,1,1,21,6,6,
1,5,1,3,1,1,21,1,3,
0,21,0,4,1,6,1,1,4,
1,1,1,21,1,1,1,1,5,
0,1,1,0,21,0,0,0,1,
0,0,21,1,1,1,1,1,1,
1,1,0,21,0,6,1,0,0,
1,4,6,1,1,1,1,3,21,
1,1,0,21,0,4,1,1,0,
1,1,0,1,1,1,21,0,4,
5,1,0,0,21,0,1,3,1,
6,1,1,3,21,0,1,1,1,
0,21,0,0,0,1,5,1,1,
0,21,1,1,6,1,1,1,1,
1,21,0,0,0,0,0,0,0,
1,1,1,1,5,0,21,0,0,
1,1,6,1,1,21,0,3,1,
1,1,1,1,3,1,21,1,3,
1,1,1,1,6,1,21,5,1,
1,1,1,6,1,5,21,1,1,
5,21,0,1,1,0,0,1,1,
5,6,0,1,1,1,21,0,0,
1,1,0,21,0,4,1,1,0,
1,1,0,21,0,4,5,1,3,
0,0,0,0,21,1,1,1,1,
0,21,0,0,5,1,1,1,1,
0,21,1,1,4,1,3,1,1,
0,21,6,1,1,1,1,1,1,
0,21,1,1,1,6,4,1,1,
3,1,21,1,1,0,5,1,1,
6,1,21,0,0,0,0,1,1,
1,1,1,0,0,21,0,0,6,
1,1,1,1,5,21,1,0,1,
1,1,3,1,1,21,3,0,1,
4,1,1,0,0,0,21,0,0,
1,1,1,0,21,1,1,3,0,
6,0,0,21,1,0,0,0,0,
1,0,21,0,0,0,1,4,1,
1,3,5,21,0,0,0,0,0,
1,1,1,21,1,1,6,1,1,
0,0,1,21,1,3,1,1,1,
1,21,1,5,1,1,1,3,4,
5,21,0,0,1,1,1,1,1,
1,1,3,21,1,1,1,1,4,
1,0,0,0,21,0,0,0,5,
1,4,1,1,1,21,6,1,1,
1,5,1,21,1,0,1,1,1,
5,6,1,1,1,1,21,1,1,
0,1,6,1,1,1,0,21,0,
1,3,1,3,1,1,21,1,1,
0,3,1,3,1,1,21,4,1,
0,1,1,1,1,1,21,1,5,
0,0,0,0,0,1,0,21,0,
0,0,0,0,0,0,0,0,0,
0,0,0,0,0,0,0,0,0,
0,0,0,0,0,0,0,0,0.
[layer]
type=Tile Layer 2
data=
239,239,239,239,239,0,0,239,239,
226,226,226,226,226,226,0,226,226,
224,224,224,224,224,224,0,224,224,
0,0,0,164,164,164,164,164,164,
195,195,195,0,195,195,195,195,195,
0,189,189,0,0,0,0,0,189,
0,0,0,174,174,174,174,174,174,
159,159,0,0,0,159,159,0,0,
189,189,189,189,189,189,189,189,0,
184,184,0,0,0,184,184,184,0,
169,169,0,169,169,169,0,0,169,
155,155,0,0,0,0,155,155,155,
193,193,193,193,0,0,193,193,193,
0,0,0,0,0,179,179,179,179,
0,0,165,165,165,165,165,165,165,
150,0,0,0,0,0,0,0,0,
188,188,188,188,188,0,0,0,0,
174,174,174,174,174,0,0,174,174,
152,152,152,152,152,152,0,152,152,
139,139,139,139,139,139,0,139,139,
173,173,173,173,173,173,0,173,173,
168,0,0,168,168,0,0,168,168,
155,155,0,155,155,155,0,0,0,
142,142,0,0,0,142,142,142,0,
177,177,0,0,0,177,177,177,177,
0,0,0,0,0,163,163,163,163,
0,0,0,0,150,150,150,150,150,
0,0,137,137,137,137,137,137,137,
0,0,171,171,171,171,171,171,171,
0,0,158,158,158,158,158,158,158,
145,145,0,145,145,0,145,145,145,
133,133,0,0,0,0,0,133,133,
165,165,165,0,0,0,0,0,165,
153,153,153,153,153,0,153,0,153,
141,141,141,141,141,0,141,0,141,
128,128,128,0,0,0,0,0,0,
160,160,160,0,0,160,160,160,0,
148,0,0,0,148,0,0,0,0,
136,0,0,0,0,0,136,136,136,
124,124,124,0,0,0,0,0,0,
147,147,147,0,147,147,147,147,147,
0,0,142,0,142,142,142,142,142,
125,0,125,125,125,125,125,125,125,
120,0,0,0,120,120,120,120,120,
113,113,113,0,113,113,113,113,113,
108,0,0,0,0,0,0,0,108,
102,102,102,102,102,0,102,102,102,
106,106,106,0,106,0,106,106,106,
91,91,91,91,91,91,0,91,91,
0,94,94,94,94,94,0,0,0,
89,89,89,89,89,89,0,89,89,
0,92,92,92,92,92,0,92,92,
0,91,91,91,91,91,0,91,91,
0,0,0,0,0,90,0,0,0,
0,0,0,0,0,0,0,0,0,
0,0,0,0,0,0,0,0,0,
0,0,0,0,0,0,0,0,0.