[layer]
type=Tile Layer 1
data=
1,1,1,1,1,1,1,21,1,
1,1,1,1,1,0,21,0,0,
2,2,2,2,2,21,2,7,2,
2,9,2,2,2,21,2,2,0,
1,2,2,1,1,21,1,1,1,
1,1,0,1,0,0,21,0,1,
1,1,1,1,1,1,1,21,1,
1,0,0,0,1,21,1,0,1,
1,1,1,21,1,0,1,0,1,
1,1,1,1,0,0,21,0,0,
1,1,1,1,0,1,1,21,0,
1,1,1,1,0,1,21,1,0,
1,1,1,0,21,2,2,1,0,
0,0,0,0,2,10,21,1,0,
0,1,1,0,2,2,0,0,21,
0,2,2,2,7,2,2,2,21,
1,0,1,0,1,1,21,1,0,
1,0,0,0,0,0,0,21,0,
1,21,0,0,1,1,1,1,1,
1,1,1,21,1,1,1,1,1,
1,1,1,0,0,0,0,21,0,
2,2,2,2,7,2,2,21,2,
7,2,2,21,2,2,2,0,2,
1,1,1,21,2,10,2,0,1,
0,0,1,0,2,0,2,0,21,
1,1,1,21,1,1,1,1,1,
1,1,1,21,1,0,1,2,2,
1,0,1,21,1,0,1,2,8,
1,21,1,0,2,2,2,2,2,
1,21,2,2,2,8,2,1,1,
0,0,8,21,2,2,0,0,1,
1,2,2,2,1,21,1,0,1,
1,1,1,1,1,21,1,0,1,
1,1,1,1,1,21,1,1,1,
1,0,0,1,0,21,1,1,0,
1,1,1,21,1,1,1,1,1,
0,0,0,0,0,1,1,1,21,
0,21,1,1,1,1,1,1,0,
0,0,1,1,0,1,1,0,21,
0,1,1,1,21,1,1,1,0,
0,0,0,0,0,1,1,21,0,
1,1,1,1,1,21,0,1,0,
2,2,21,1,1,1,1,1,0,
8,2,0,0,0,21,0,0,0,
2,0,1,1,1,1,1,1,21,
0,1,1,2,2,2,21,1,1,
1,1,1,2,10,2,21,1,1,
2,2,2,7,2,21,0,2,2,
21,2,2,2,9,2,2,2,2,
0,21,0,2,2,8,2,1,1,
2,9,21,2,2,2,0,2,2,
0,0,0,0,0,0,0,0,0,
0,0,0,0,0,0,0,0,0,
0,0,0,0,0,0,0,0,0.
[layer]
type=Tile Layer 2
data=
223,223,223,223,223,223,223,0,223,
233,233,233,233,233,0,0,0,0,
231,231,231,231,231,0,231,231,231,
174,174,174,174,174,0,174,174,0,
152,152,152,152,152,0,152,152,152,
199,199,0,199,0,0,0,0,199,
175,175,175,175,175,175,175,0,175,
169,0,0,0,169,0,169,0,169,
155,155,155,0,155,0,155,0,155,
193,193,193,193,0,0,0,0,0,
179,179,179,179,0,179,179,0,0,
165,165,165,165,0,165,0,165,0,
150,150,150,0,0,150,150,150,0,
0,0,0,0,188,188,0,188,0,
0,174,174,0,174,174,0,0,0,
0,160,160,160,160,160,160,160,0,
146,0,146,0,146,146,0,146,0,
182,0,0,0,0,0,0,0,0,
168,0,0,0,168,168,168,168,168,
148,148,148,0,148,148,148,148,148,
142,142,142,0,0,0,0,0,0,
177,177,177,177,177,177,177,0,177,
163,163,163,0,163,163,163,0,163,
150,150,150,0,150,150,150,0,150,
0,0,137,0,137,0,137,0,0,
163,163,163,0,163,163,163,163,163,
158,158,158,0,158,0,158,158,158,
145,0,145,0,145,0,145,145,145,
133,0,133,0,133,133,133,133,133,
165,0,165,165,165,165,165,165,165,
0,0,153,0,153,153,0,0,153,
141,141,141,141,141,0,141,0,141,
128,128,128,128,128,0,128,0,128,
152,152,152,152,152,0,152,152,152,
148,0,0,148,0,0,148,148,0,
129,129,129,0,129,129,129,129,129,
0,0,0,0,0,124,124,124,0,
0,0,154,154,154,154,154,154,0,
0,0,142,142,0,142,142,0,0,
0,131,131,131,0,131,131,131,0,
0,0,0,0,0,120,120,0,0,
119,119,119,119,119,0,0,119,0,
108,108,0,108,108,108,108,108,0,
107,107,0,0,0,0,0,0,0,
106,0,106,106,106,106,106,106,0,
0,95,95,95,95,95,0,95,95,
94,94,94,94,94,94,0,94,94,
93,93,93,93,93,0,0,93,93,
0,92,92,92,92,92,92,92,92,
0,0,0,91,91,91,91,91,91,
90,90,0,90,90,90,0,90,90,
0,0,0,0,0,0,0,0,0,
0,0,0,0,0,0,0,0,0,
0,0,0,0,0,0,0,0,0.