[layer]
type=Tile Layer 1
data=
4,1,1,21,0,0,0,0,1,
3,2,2,0,1,1,1,21,0,
1,10,0,0,21,0,0,0,0,
1,21,2,0,3,0,1,1,1,
1,21,6,0,1,1,1,1,1,
0,0,5,21,2,2,0,0,0,
1,21,1,2,10,2,1,6,1,
4,0,2,21,2,0,1,5,1,
1,2,8,21,1,1,1,4,1,
1,2,2,2,21,0,0,0,1,
1,1,1,1,4,21,1,1,1,
0,0,0,0,6,21,3,0,2,
0,21,2,2,2,2,2,2,9,
1,1,1,21,1,2,2,2,2,
2,2,0,0,0,21,8,2,6,
8,2,1,0,4,21,2,0,1,
0,21,1,0,1,0,1,0,1,
6,0,1,0,1,21,5,0,1,
0,21,1,0,5,0,1,0,0,
1,1,1,2,2,21,1,1,4,
0,0,0,21,10,2,0,0,1,
1,0,0,2,2,0,21,0,6,
21,1,1,6,1,1,1,1,1,
0,4,1,1,0,3,1,1,21,
0,1,1,1,0,5,3,1,21,
0,6,1,1,0,21,0,1,0,
0,5,1,1,0,1,1,1,21,
0,0,0,0,0,0,0,0,0,
0,0,0,0,0,0,0,0,0,
0,0,0,0,0,0,0,0,0.
[layer]
type=Tile Layer 2
data=
160,160,160,0,0,0,0,0,160,
158,158,158,0,158,158,158,0,0,
157,157,0,0,0,0,0,0,0,
117,0,117,0,117,0,117,117,117,
107,0,107,0,107,107,107,107,107,
0,0,133,0,133,133,0,0,0,
123,0,123,123,123,123,123,123,123,
113,0,113,0,113,0,113,113,113,
102,102,102,0,102,102,102,102,102,
128,128,128,128,0,0,0,0,128,
112,112,112,112,112,0,112,112,112,
0,0,0,0,108,0,108,0,108,
0,0,98,98,98,98,98,98,98,
116,116,116,0,116,116,116,116,116,
112,112,0,0,0,0,112,112,112,
103,103,103,0,103,0,103,0,103,
0,0,94,0,94,0,94,0,94,
93,0,93,0,93,0,93,0,93,
0,0,84,0,84,0,84,0,0,
79,79,79,79,79,0,79,79,79,
0,0,0,0,82,82,0,0,82,
73,0,0,73,73,0,0,0,73,
0,69,69,69,69,69,69,69,69,
0,71,71,71,0,71,71,71,0,
0,70,70,70,0,70,70,70,0,
0,69,69,69,0,0,0,69,0,
0,68,68,68,0,68,68,68,0,
0,0,0,0,0,0,0,0,0,
0,0,0,0,0,0,0,0,0,
0,0,0,0,0,0,0,0,0.