[layer]
type=Tile Layer 1
data=
0,1,21,1,0,1,1,1,1,
1,1,21,1,1,1,0,1,1,
0,0,0,1,0,0,21,1,1,
0,1,1,1,21,1,1,1,1,
0,0,21,1,0,1,0,1,0,
1,1,0,1,21,1,0,1,0,
1,1,1,0,21,0,1,0,1,
1,0,1,1,1,21,1,0,0,
1,0,1,1,1,0,21,1,0,
1,1,1,1,1,6,4,1,21,
0,21,1,1,0,0,0,0,0,
1,21,0,1,0,1,1,1,1,
0,0,0,0,0,0,0,0,0,
0,0,0,0,0,0,0,0,0,
0,0,0,0,0,0,0,0,0.
[layer]
type=Tile Layer 2
data=
0,88,0,88,0,88,88,88,88,
59,59,0,59,59,59,0,59,59,
0,0,0,62,0,0,0,62,62,
0,58,58,58,0,58,58,58,58,
0,0,0,54,0,54,0,54,0,
53,53,0,53,0,53,0,53,0,
52,52,52,0,0,0,52,0,52,
51,0,51,51,51,0,51,0,0,
50,0,50,50,50,0,0,50,0,
44,44,44,44,44,44,44,44,0,
0,0,48,48,0,0,0,0,0,
47,0,0,47,0,47,47,47,47,
0,0,0,0,0,0,0,0,0,
0,0,0,0,0,0,0,0,0,
0,0,0,0,0,0,0,0,0.