[layer]
type=Tile Layer 1
data=
1,1,1,21,1,1,1,1,1,
1,1,1,0,0,0,21,0,0,
1,1,1,21,1,1,1,1,1,
0,21,0,0,1,1,1,1,1,
1,21,1,0,1,1,1,1,1,
1,0,1,0,21,0,0,0,0,
1,21,1,1,1,0,1,1,1,
1,21,1,0,1,0,1,1,1,
1,1,1,21,1,0,1,1,1,
1,1,1,21,1,1,1,1,1,
0,21,0,0,1,1,1,1,1,
1,1,1,21,1,1,1,1,1,
1,1,1,0,21,0,0,0,0,
1,1,1,21,1,1,1,1,1,
0,0,0,21,1,0,0,0,1,
1,1,1,1,1,1,1,21,1,
1,0,0,0,21,0,1,0,0,
1,1,1,1,1,21,1,0,1,
1,21,1,0,1,0,1,0,1,
0,21,1,0,1,0,1,0,1,
1,1,1,0,1,21,1,0,1,
1,0,1,0,1,21,0,0,1,
1,21,1,0,1,0,1,1,1,
1,0,1,21,1,0,1,0,0,
1,0,1,0,1,21,1,0,1,
1,0,1,0,1,0,1,21,0,
1,21,1,0,1,1,1,1,1,
1,1,0,0,0,21,0,1,1,
1,1,1,1,1,21,0,1,1,
1,1,21,1,1,1,1,1,1,
1,1,21,1,1,0,1,1,1,
1,1,1,21,1,0,0,0,0,
1,1,1,1,1,21,1,1,0,
1,0,0,0,21,0,1,1,1,
0,21,1,1,0,1,1,1,1,
0,1,1,1,0,0,0,21,0,
1,1,1,1,0,0,21,0,1,
0,1,1,1,21,1,1,1,1,
0,1,1,1,21,1,1,1,1,
0,21,1,1,0,1,1,1,1,
1,21,1,1,0,1,1,1,1,
0,0,1,1,0,21,0,0,1,
0,0,0,0,0,0,0,0,0,
0,0,0,0,0,0,0,0,0,
0,0,0,0,0,0,0,0,0.
[layer]
type=Tile Layer 2
data=
193,193,193,0,193,193,193,193,193,
201,201,201,0,0,0,0,0,0,
190,190,190,0,190,190,190,190,190,
0,0,0,0,138,138,138,138,138,
173,0,173,0,173,173,173,173,173,
160,0,160,0,0,0,0,0,0,
147,0,147,147,147,0,147,147,147,
134,0,134,0,134,0,134,134,134,
167,167,167,0,167,0,167,167,167,
147,147,147,0,147,147,147,147,147,
0,0,0,0,142,142,142,142,142,
123,123,123,0,123,123,123,123,123,
162,162,162,0,0,0,0,0,0,
142,142,142,0,142,142,142,142,142,
0,0,0,0,137,0,0,0,137,
119,119,119,119,119,119,119,0,119,
156,0,0,0,0,0,156,0,0,
144,144,144,144,144,0,144,0,144,
132,0,132,0,132,0,132,0,132,
0,0,121,0,121,0,121,0,121,
150,150,150,0,150,0,150,0,150,
139,0,139,0,139,0,0,0,139,
128,0,128,0,128,0,128,128,128,
116,0,116,0,116,0,116,0,0,
145,0,145,0,145,0,145,0,145,
134,0,134,0,134,0,134,0,0,
123,0,123,0,123,123,123,123,123,
112,112,0,0,0,0,0,112,112,
139,139,139,139,139,0,0,139,139,
122,122,0,122,122,122,122,122,122,
118,118,0,118,118,0,118,118,118,
108,108,108,0,108,0,0,0,0,
107,107,107,107,107,0,107,107,0,
97,0,0,0,0,0,97,97,97,
0,0,96,96,0,96,96,96,96,
0,95,95,95,0,0,0,0,0,
85,85,85,85,0,0,0,0,85,
0,84,84,84,0,84,84,84,84,
0,83,83,83,0,83,83,83,83,
0,0,82,82,0,82,82,82,82,
81,0,81,81,0,81,81,81,81,
0,0,80,80,0,0,0,0,80,
0,0,0,0,0,0,0,0,0,
0,0,0,0,0,0,0,0,0,
0,0,0,0,0,0,0,0,0.