[layer]
type=Tile Layer 1
data=
0,0,0,0,0,21,1,1,1,
0,0,1,0,0,0,21,0,0,
1,21,0,0,1,1,1,1,1,
0,1,21,1,1,1,1,1,1,
0,1,21,1,1,1,1,1,1,
0,0,21,1,1,1,1,1,1,
1,1,1,1,1,0,21,0,0,
1,1,1,1,1,21,1,0,1,
1,1,1,1,1,0,1,21,0,
1,0,0,0,0,21,1,1,0,
1,21,1,1,1,1,1,1,0,
1,1,1,0,0,0,21,0,0,
1,1,1,21,0,0,1,0,0,
1,1,1,1,1,0,21,0,1,
1,1,1,1,0,21,0,1,1,
1,21,1,1,1,0,1,0,1,
0,0,1,0,21,0,1,0,1,
1,1,1,0,1,21,1,0,1,
1,0,0,0,1,21,1,0,1,
1,21,1,0,1,1,1,0,1,
1,0,1,21,0,0,1,0,1,
1,21,1,1,1,0,1,0,1,
0,0,1,21,1,0,0,0,1,
1,1,1,21,1,1,1,1,1,
1,21,1,1,1,1,1,1,1,
0,0,21,0,0,0,1,0,0,
1,1,1,1,1,1,1,21,1,
1,1,1,1,1,0,21,0,1,
1,1,1,1,1,1,1,21,1,
1,1,1,1,1,0,1,21,0,
1,1,1,1,1,21,1,1,1,
0,0,0,21,0,0,1,0,0,
1,1,1,1,1,1,1,21,1,
0,1,1,1,21,1,1,1,1,
0,1,1,1,21,1,1,1,0,
1,1,1,1,1,1,1,1,21,
0,0,0,0,21,1,1,1,0,
1,1,1,1,1,1,1,1,21,
0,0,0,1,0,0,0,0,21,
0,0,0,0,0,0,0,0,0,
0,0,0,0,0,0,0,0,0,
0,0,0,0,0,0,0,0,0.
[layer]
type=Tile Layer 2
data=
0,0,0,0,0,0,197,197,197,
0,0,195,0,0,0,0,0,0,
194,0,0,0,194,194,194,194,194,
0,146,0,146,146,146,146,146,146,
0,133,0,133,133,133,133,133,133,
0,0,0,166,166,166,166,166,166,
153,153,153,153,153,0,0,0,0,
141,141,141,141,141,0,141,0,141,
129,129,129,129,129,0,129,0,0,
161,0,0,0,0,0,161,161,0,
148,0,148,148,148,148,148,148,0,
136,136,136,0,0,0,0,0,0,
124,124,124,0,0,0,124,0,0,
155,155,155,155,155,0,0,0,155,
143,143,143,143,0,0,0,143,143,
131,0,131,131,131,0,131,0,131,
0,0,120,0,0,0,120,0,120,
149,149,149,0,149,0,149,0,149,
138,0,0,0,138,0,138,0,138,
127,0,127,0,127,127,127,0,127,
115,0,115,0,0,0,115,0,115,
144,0,144,144,144,0,144,0,144,
0,0,133,0,133,0,0,0,133,
116,116,116,0,116,116,116,116,116,
106,0,106,106,106,106,106,106,106,
0,0,0,0,0,0,138,0,0,
121,121,121,121,121,121,121,0,121,
117,117,117,117,117,0,0,0,117,
102,102,102,102,102,102,102,0,102,
106,106,106,106,106,0,106,0,0,
91,91,91,91,91,0,91,91,91,
0,0,0,0,0,0,95,0,0,
89,89,89,89,89,89,89,0,89,
0,84,84,84,0,84,84,84,84,
0,83,83,83,0,83,83,83,0,
78,78,78,78,78,78,78,78,0,
0,0,0,0,0,81,81,81,0,
77,77,77,77,77,77,77,77,0,
0,0,0,79,0,0,0,0,0,
0,0,0,0,0,0,0,0,0,
0,0,0,0,0,0,0,0,0,
0,0,0,0,0,0,0,0,0.