[layer]
type=Tile Layer 1
data=
0,1,21,1,1,1,1,1,1,
0,1,0,21,0,0,1,1,1,
0,1,1,1,1,0,0,0,21,
1,1,1,21,0,1,1,1,1,
0,0,0,1,1,21,1,1,1,
0,0,0,0,0,21,1,1,1,
1,1,1,1,21,1,1,0,0,
1,1,0,0,21,1,1,1,0,
1,1,0,21,1,1,1,1,0,
1,21,1,0,1,1,1,1,0,
1,0,21,0,1,1,1,0,0,
1,1,1,21,1,1,1,0,1,
1,1,1,0,0,21,0,1,1,
1,1,0,0,1,1,21,0,0,
1,1,0,1,1,21,0,0,0,
1,1,1,0,1,21,1,0,1,
0,21,1,0,1,0,1,0,0,
1,21,1,0,1,1,1,0,1,
1,0,1,0,21,0,1,0,1,
1,21,1,1,1,0,1,0,1,
1,0,1,21,0,0,1,0,1,
1,21,1,1,1,0,1,0,1,
1,0,21,0,1,0,1,0,1,
1,0,1,21,1,0,1,0,1,
1,1,1,21,1,0,0,0,1,
1,1,1,21,1,1,1,0,1,
1,1,1,0,0,21,1,0,0,
1,1,1,21,1,1,1,1,1,
0,21,0,0,1,0,1,1,1,
1,1,1,1,1,21,1,1,1,
1,21,0,0,1,0,1,1,1,
1,1,1,21,1,0,1,1,1,
1,1,1,21,1,0,0,0,1,
1,1,21,1,0,1,1,1,0,
0,0,21,1,0,0,0,1,0,
1,1,21,1,0,1,1,1,1,
0,0,0,1,21,1,1,1,1,
1,1,1,1,21,1,1,1,1,
0,0,21,0,0,1,1,1,1,
0,0,0,0,0,0,0,0,0,
0,0,0,0,0,0,0,0,0,
0,0,0,0,0,0,0,0,0.
[layer]
type=Tile Layer 2
data=
0,197,0,197,197,197,197,197,197,
0,195,0,0,0,0,195,195,195,
0,194,194,194,194,0,0,0,0,
146,146,146,0,0,146,146,146,146,
0,0,0,133,133,0,133,133,133,
0,0,0,0,0,0,166,166,166,
153,153,153,153,0,153,153,0,0,
141,141,0,0,0,141,141,141,0,
129,129,0,0,129,129,129,129,0,
161,0,161,0,161,161,161,161,0,
148,0,0,0,148,148,148,0,0,
136,136,136,0,136,136,136,0,136,
124,124,124,0,0,0,0,124,124,
155,155,0,0,155,155,0,0,0,
143,143,0,143,143,0,0,0,0,
131,131,131,0,131,0,131,0,131,
0,0,120,0,120,0,120,0,0,
149,0,149,0,149,149,149,0,149,
138,0,138,0,0,0,138,0,138,
127,0,127,127,127,0,127,0,127,
115,0,115,0,0,0,115,0,115,
144,0,144,144,144,0,144,0,144,
133,0,0,0,133,0,133,0,133,
122,0,122,0,122,0,122,0,122,
111,111,111,0,111,0,0,0,111,
138,138,138,0,138,138,138,0,138,
127,127,127,0,0,0,127,0,0,
111,111,111,0,111,111,111,111,111,
0,0,0,0,107,0,107,107,107,
101,101,101,101,101,0,101,101,101,
96,0,0,0,96,0,96,96,96,
95,95,95,0,95,0,95,95,95,
94,94,94,0,94,0,0,0,94,
84,84,0,84,0,84,84,84,0,
0,0,0,83,0,0,0,83,0,
82,82,0,82,0,82,82,82,82,
0,0,0,81,0,81,81,81,81,
77,77,77,77,0,77,77,77,77,
0,0,0,0,0,79,79,79,79,
0,0,0,0,0,0,0,0,0,
0,0,0,0,0,0,0,0,0,
0,0,0,0,0,0,0,0,0.