[layer]
type=Tile Layer 1
data=
1,0,21,1,1,1,1,1,0,
1,1,0,0,21,0,0,0,0,
1,1,1,0,0,21,0,1,1,
1,1,1,21,1,1,0,1,1,
1,1,1,1,0,0,1,21,0,
1,1,1,0,21,1,0,1,0,
1,0,21,0,1,1,0,1,1,
1,21,1,1,1,0,1,1,1,
1,0,0,21,0,0,0,0,0,
1,1,21,1,1,1,1,1,0,
0,0,1,21,0,0,0,0,0,
0,1,1,1,21,0,0,0,1,
1,21,1,1,1,21,0,1,1,
1,1,1,1,1,21,0,1,1,
0,1,1,1,0,0,0,0,1,
0,0,0,0,0,0,0,0,0,
0,0,0,0,0,0,0,0,0,
0,0,0,0,0,0,0,0,0.
[layer]
type=Tile Layer 2
data=
108,0,0,108,108,108,108,108,0,
84,84,0,0,0,0,0,0,0,
83,83,83,0,0,0,0,83,83,
78,78,78,0,78,78,0,78,78,
74,74,74,74,0,0,74,0,0,
73,73,73,0,0,73,0,73,0,
72,0,0,0,72,72,0,72,72,
61,0,61,61,61,0,61,61,61,
63,0,0,0,0,0,0,0,0,
59,59,0,59,59,59,59,59,0,
0,0,61,0,0,0,0,0,0,
0,60,60,60,0,0,0,0,60,
59,0,59,59,59,0,0,59,59,
55,55,55,55,55,0,0,55,55,
0,57,57,57,0,0,0,0,57,
0,0,0,0,0,0,0,0,0,
0,0,0,0,0,0,0,0,0,
0,0,0,0,0,0,0,0,0.