[layer]
type=Tile Layer 1
data=
1,1,21,6,0,0,0,0,0,
1,0,21,1,0,1,1,1,1,
4,21,6,3,0,1,1,1,1,
1,0,21,1,0,1,1,5,4,
1,6,21,1,0,1,5,6,1,
1,1,0,21,0,1,1,1,1,
6,1,21,1,3,1,1,1,0,
5,1,21,1,1,1,6,1,1,
1,0,0,0,0,21,0,1,0,
1,5,1,1,21,5,1,3,0,
0,0,0,1,0,4,1,1,21,
1,1,4,1,1,1,1,1,21,
0,0,21,0,0,5,4,6,0,
1,1,1,1,21,1,1,1,0,
0,0,21,1,0,0,0,1,0,
0,0,0,0,5,21,1,0,1,
4,1,1,21,1,0,1,1,1,
0,0,3,21,1,0,1,0,0,
1,0,1,21,1,0,1,0,1,
3,21,1,0,1,0,1,0,5,
1,6,1,21,3,0,1,0,1,
1,0,0,0,1,21,1,0,1,
4,0,5,1,1,21,1,0,1,
1,0,3,0,0,21,1,0,0,
0,6,0,0,0,4,21,1,1,
0,1,21,1,1,3,0,1,1,
0,1,0,1,1,1,21,6,1,
0,1,21,1,1,1,1,5,1,
0,1,21,0,0,0,0,1,0,
0,4,3,1,1,1,1,4,21,
0,0,0,0,0,0,0,0,0,
0,0,0,0,0,0,0,0,0,
0,0,0,0,0,0,0,0,0.
[layer]
type=Tile Layer 2
data=
166,166,0,166,0,0,0,0,0,
164,0,0,164,0,164,164,164,164,
162,0,162,162,0,162,162,162,162,
112,0,0,112,0,112,112,112,112,
140,140,0,140,0,140,140,140,140,
129,129,0,0,0,129,129,129,129,
118,118,0,118,118,118,118,118,0,
103,103,0,103,103,103,103,103,103,
134,0,0,0,0,0,0,134,0,
124,124,124,124,0,124,124,124,0,
0,0,0,114,0,114,114,114,0,
99,99,99,99,99,99,99,99,0,
0,0,0,0,0,129,129,129,0,
119,119,119,119,0,119,119,119,0,
0,0,0,109,0,0,0,109,0,
0,0,0,0,99,0,99,0,99,
123,123,123,0,123,0,123,123,123,
0,0,113,0,113,0,113,0,0,
104,0,104,0,104,0,104,0,104,
95,0,95,0,95,0,95,0,95,
94,94,94,0,94,0,94,0,94,
85,0,0,0,85,0,85,0,85,
84,0,84,84,84,0,84,0,84,
83,0,83,0,0,0,83,0,0,
0,74,0,0,0,74,0,74,74,
0,73,0,73,73,73,0,73,73,
0,72,0,72,72,72,0,72,72,
0,71,0,71,71,71,71,71,71,
0,70,0,0,0,0,0,70,0,
0,69,69,69,69,69,69,69,0,
0,0,0,0,0,0,0,0,0,
0,0,0,0,0,0,0,0,0,
0,0,0,0,0,0,0,0,0.