[layer]
type=Tile Layer 1
data=
1,1,1,21,6,1,1,0,1,
0,21,0,0,4,1,1,0,0,
1,1,1,1,3,1,4,21,1,
1,0,21,0,0,0,0,0,1,
1,6,1,1,1,21,1,1,5,
1,5,1,1,1,21,0,0,4,
1,1,1,1,5,21,1,1,1,
1,1,1,1,3,21,1,1,4,
1,5,1,1,1,21,1,3,4,
3,1,0,1,1,21,0,0,0,
1,1,21,1,1,0,3,1,1,
6,21,0,1,1,1,1,5,0,
1,0,0,0,21,0,0,1,0,
1,21,1,1,0,5,6,0,0,
0,0,1,21,0,1,1,4,0,
1,0,1,1,21,0,0,0,0,
1,1,0,1,0,21,1,1,0,
6,3,21,0,1,4,0,0,0,
1,1,1,1,21,3,1,1,6,
1,1,1,1,21,4,3,1,1,
1,1,4,6,21,1,1,1,1,
0,1,21,0,0,1,0,0,0,
1,1,21,1,1,3,1,1,1,
0,3,4,6,0,0,0,21,1,
1,5,1,1,1,6,5,21,1,
0,0,0,1,1,1,0,21,3,
1,1,1,1,3,1,1,21,1,
6,1,21,1,0,6,1,1,1,
1,1,0,1,21,1,5,1,0,
1,3,21,1,1,1,3,1,0,
1,1,0,0,21,0,0,0,0,
1,4,21,5,1,6,0,1,1,
0,1,21,1,1,1,0,5,0,
1,1,4,1,1,1,21,1,1,
1,0,4,1,1,21,0,1,6,
1,6,21,1,3,1,1,3,1,
1,1,4,0,21,1,1,0,4,
1,3,0,0,5,1,21,0,1,
1,1,0,0,21,0,1,0,1,
1,1,1,4,6,21,0,0,0,
4,0,21,1,1,5,0,1,0,
1,21,1,1,1,1,0,1,0,
0,0,0,5,4,21,1,1,0,
0,3,0,0,21,0,0,0,0,
0,0,21,1,1,1,1,1,1,
1,1,1,21,5,0,1,4,1,
1,21,0,0,1,0,0,0,0,
5,1,6,1,1,1,1,21,1,
3,21,1,1,4,3,1,0,1,
1,21,1,1,5,1,1,0,1,
1,0,1,0,0,0,0,21,0,
0,0,0,0,0,0,0,0,0,
0,0,0,0,0,0,0,0,0,
0,0,0,0,0,0,0,0,0.
[layer]
type=Tile Layer 2
data=
234,234,234,0,234,234,234,0,234,
0,0,0,0,233,233,233,0,0,
220,220,220,220,220,220,220,0,220,
174,0,0,0,0,0,0,0,174,
152,152,152,152,152,0,152,152,152,
199,199,199,199,199,0,0,0,199,
175,175,175,175,175,0,175,175,175,
161,161,161,161,161,0,161,161,161,
147,147,147,147,147,0,147,147,147,
193,193,0,193,193,0,0,0,0,
179,179,0,179,179,0,179,179,179,
165,0,0,165,165,165,165,165,0,
150,0,0,0,0,0,0,150,0,
188,0,188,188,0,188,188,0,0,
0,0,174,0,0,174,174,174,0,
160,0,160,160,0,0,0,0,0,
146,146,0,146,0,0,146,146,0,
182,182,0,0,182,182,0,0,0,
160,160,160,160,0,160,160,160,160,
148,148,148,148,0,148,148,148,148,
135,135,135,135,0,135,135,135,135,
0,177,0,0,0,177,0,0,0,
155,155,0,155,155,155,155,155,155,
0,150,150,150,0,0,0,0,150,
131,131,131,131,131,131,131,0,131,
0,0,0,171,171,171,0,0,171,
151,151,151,151,151,151,151,0,151,
145,145,0,145,0,145,145,145,145,
133,133,0,133,0,133,133,133,0,
165,165,0,165,165,165,165,165,0,
153,153,0,0,0,0,0,0,0,
141,141,0,141,141,141,0,141,141,
0,128,0,128,128,128,0,128,0,
152,152,152,152,152,152,0,152,152,
148,0,148,148,148,0,0,148,148,
129,129,0,129,129,129,129,129,129,
124,124,124,0,0,124,124,0,124,
154,154,0,0,154,154,0,0,154,
142,142,0,0,0,0,142,0,142,
131,131,131,131,131,0,0,0,0,
120,0,0,120,120,120,0,120,0,
119,0,119,119,119,119,0,119,0,
0,0,0,108,108,0,108,108,0,
0,107,0,0,0,0,0,0,0,
0,0,0,106,106,106,106,106,106,
95,95,95,0,95,0,95,95,95,
94,0,0,0,94,0,0,0,0,
89,89,89,89,89,89,89,0,89,
92,0,92,92,92,92,92,0,92,
91,0,91,91,91,91,91,0,91,
90,0,90,0,0,0,0,0,0,
0,0,0,0,0,0,0,0,0,
0,0,0,0,0,0,0,0,0,
0,0,0,0,0,0,0,0,0.