[layer]
type=Tile Layer 1
data=
1,1,21,1,0,1,1,1,0,
1,1,0,1,21,1,1,1,0,
0,1,0,21,0,0,0,1,0,
1,1,1,0,0,1,21,0,0,
1,1,1,1,0,21,0,1,1,
1,1,1,1,1,1,1,21,0,
1,1,1,1,21,1,1,1,1,
1,1,1,1,0,1,21,0,0,
1,1,1,21,1,1,1,1,0,
0,0,1,0,0,0,21,0,1,
0,0,21,0,1,1,1,1,1,
1,1,0,0,21,0,0,0,1,
1,1,1,1,1,1,1,1,21,
0,0,1,0,0,0,21,0,1,
1,1,1,1,1,1,1,21,1,
1,1,1,1,1,1,1,21,1,
0,0,1,0,1,0,21,0,1,
1,1,1,21,1,0,1,1,1,
1,1,1,21,1,0,1,0,0,
1,1,1,21,1,0,1,1,1,
1,1,1,0,1,0,21,0,1,
1,1,1,1,1,0,0,21,0,
1,1,1,1,1,21,1,1,0,
1,1,1,21,0,0,0,0,1,
1,1,1,0,1,1,1,21,0,
0,0,1,1,1,1,1,1,21,
0,0,21,0,0,0,0,1,0,
0,0,0,0,0,0,0,0,0,
0,0,0,0,0,0,0,0,0,
0,0,0,0,0,0,0,0,0.
[layer]
type=Tile Layer 2
data=
160,160,0,160,0,160,160,160,0,
158,158,0,158,0,158,158,158,0,
0,157,0,0,0,0,0,157,0,
117,117,117,0,0,117,0,0,0,
107,107,107,107,0,0,0,107,107,
133,133,133,133,133,133,133,0,0,
117,117,117,117,0,117,117,117,117,
113,113,113,113,0,113,0,0,0,
102,102,102,0,102,102,102,102,0,
0,0,128,0,0,0,0,0,128,
0,0,0,0,118,118,118,118,118,
108,108,0,0,0,0,0,0,108,
93,93,93,93,93,93,93,93,0,
0,0,122,0,0,0,0,0,122,
107,107,107,107,107,107,107,0,107,
98,98,98,98,98,98,98,0,98,
0,0,94,0,94,0,0,0,94,
93,93,93,0,93,0,93,93,93,
84,84,84,0,84,0,84,0,0,
83,83,83,0,83,0,83,83,83,
82,82,82,0,82,0,0,0,82,
73,73,73,73,73,0,0,0,0,
72,72,72,72,72,0,72,72,0,
71,71,71,0,0,0,0,0,71,
70,70,70,0,70,70,70,0,0,
0,0,69,69,69,69,69,69,0,
0,0,0,0,0,0,0,68,0,
0,0,0,0,0,0,0,0,0,
0,0,0,0,0,0,0,0,0,
0,0,0,0,0,0,0,0,0.