[layer]
type=Tile Layer 1
data=
1,1,1,1,1,1,1,1,21,
1,1,0,0,0,0,0,21,0,
1,1,21,0,1,1,1,1,0,
1,1,21,1,1,1,1,1,1,
0,1,0,1,1,1,0,21,0,
0,1,21,1,1,1,0,1,0,
0,1,0,1,1,1,0,1,21,
0,1,0,1,1,1,21,1,1,
0,1,0,1,0,0,0,1,21,
0,1,1,1,1,1,1,1,21,
0,21,0,1,1,1,1,1,0,
0,1,1,1,1,1,1,1,21,
1,21,1,1,1,0,1,0,1,
0,21,1,0,0,0,1,0,1,
1,1,1,21,1,0,1,0,1,
1,0,21,0,1,0,1,0,1,
1,0,1,21,1,1,1,0,1,
1,21,1,0,0,0,1,0,1,
1,21,1,1,1,0,1,0,1,
0,0,1,21,1,0,0,0,1,
1,1,1,21,1,1,1,1,1,
1,1,1,1,0,0,21,0,0,
1,1,1,1,21,1,1,1,1,
0,0,21,0,0,0,0,1,0,
1,1,1,1,1,1,1,1,21,
0,0,1,0,0,21,1,0,1,
0,1,1,1,0,1,1,1,21,
0,0,0,0,0,0,0,0,0,
0,0,0,0,0,0,0,0,0,
0,0,0,0,0,0,0,0,0.
[layer]
type=Tile Layer 2
data=
152,152,152,152,152,152,152,152,0,
158,158,0,0,0,0,0,0,0,
157,157,0,0,157,157,157,157,0,
112,112,0,112,112,112,112,112,112,
0,107,0,107,107,107,0,0,0,
0,133,0,133,133,133,0,133,0,
0,123,0,123,123,123,0,123,0,
0,113,0,113,113,113,0,113,113,
0,102,0,102,0,0,0,102,0,
0,128,128,128,128,128,128,128,0,
0,0,0,118,118,118,118,118,0,
0,108,108,108,108,108,108,108,0,
98,0,98,98,98,0,98,0,98,
0,0,122,0,0,0,122,0,122,
112,112,112,0,112,0,112,0,112,
103,0,0,0,103,0,103,0,103,
94,0,94,0,94,94,94,0,94,
93,0,93,0,0,0,93,0,93,
84,0,84,84,84,0,84,0,84,
0,0,83,0,83,0,0,0,83,
78,78,78,0,78,78,78,78,78,
73,73,73,73,0,0,0,0,0,
69,69,69,69,0,69,69,69,69,
0,0,0,0,0,0,0,71,0,
67,67,67,67,67,67,67,67,0,
0,0,69,0,0,0,69,0,69,
0,68,68,68,0,68,68,68,0,
0,0,0,0,0,0,0,0,0,
0,0,0,0,0,0,0,0,0,
0,0,0,0,0,0,0,0,0.