[layer]
type=Tile Layer 1
data=
1,1,1,0,1,2,19,21,0,
1,1,1,0,21,2,2,2,0,
1,1,1,1,21,0,1,1,0,
1,1,1,1,1,21,1,1,0,
1,2,2,1,1,21,1,0,0,
2,9,2,2,2,21,2,18,2,
1,2,2,19,2,0,21,0,0,
2,7,2,2,21,2,2,2,0,
2,2,2,2,0,2,20,21,0,
1,1,0,0,21,0,0,2,1,
1,1,21,1,1,0,1,1,1,
2,21,2,2,2,2,0,7,2,
0,0,1,1,1,1,21,1,1,
0,1,1,1,1,1,2,21,1,
0,0,0,0,0,0,21,24,1,
2,21,2,18,2,2,9,2,2,
2,2,2,2,2,21,2,2,9,
1,21,1,2,10,2,2,0,2,
1,0,0,2,21,0,2,24,1,
2,2,1,1,1,21,1,0,1,
19,0,1,0,0,0,1,21,0,
2,21,1,0,1,1,1,1,1,
1,21,1,0,1,0,0,0,1,
1,0,1,1,1,21,1,0,1,
1,21,1,0,1,1,1,1,1,
0,0,1,0,1,0,21,0,1,
1,1,1,21,1,1,1,0,1,
1,1,1,21,1,1,1,0,0,
2,2,2,21,2,2,2,7,2,
1,1,1,21,10,2,1,0,1,
1,1,1,2,2,2,2,21,1,
0,2,0,21,0,19,0,0,1,
9,21,2,2,2,2,2,2,2,
2,2,1,1,1,1,21,1,1,
1,1,0,21,0,2,0,1,1,
1,1,21,2,10,2,0,2,1,
0,0,21,2,8,2,0,19,0,
1,1,21,2,2,2,0,2,1,
0,21,2,2,2,7,2,2,2,
0,0,0,0,0,0,0,0,0,
0,0,0,0,0,0,0,0,0,
0,0,0,0,0,0,0,0,0.
[layer]
type=Tile Layer 2
data=
197,197,197,0,197,197,0,0,0,
195,195,195,0,0,195,195,195,0,
194,194,194,194,0,0,194,194,0,
146,146,146,146,146,0,146,146,0,
133,133,133,133,133,0,133,0,0,
166,166,166,166,166,0,166,0,166,
153,153,153,0,153,0,0,0,0,
141,141,141,141,0,141,141,141,0,
129,129,129,129,0,129,0,0,0,
161,161,0,0,0,0,0,161,161,
148,148,0,148,148,0,148,148,148,
136,0,136,136,136,136,0,136,136,
0,0,124,124,124,124,0,124,124,
0,155,155,155,155,155,155,0,155,
0,0,0,0,0,0,0,0,143,
131,0,131,0,131,131,131,131,131,
120,120,120,120,120,0,120,120,120,
149,0,149,149,149,149,149,0,149,
138,0,0,138,0,0,138,0,138,
127,127,127,127,127,0,127,0,127,
0,0,115,0,0,0,115,0,0,
144,0,144,0,144,144,144,144,144,
133,0,133,0,133,0,0,0,133,
122,0,122,122,122,0,122,0,122,
111,0,111,0,111,111,111,111,111,
0,0,138,0,138,0,0,0,138,
127,127,127,0,127,127,127,0,127,
117,117,117,0,117,117,117,0,0,
107,107,107,0,107,107,107,107,107,
106,106,106,0,106,106,106,0,106,
91,91,91,91,91,91,91,0,91,
0,95,0,0,0,0,0,0,95,
94,0,94,94,94,94,94,94,94,
80,80,80,80,80,80,0,80,80,
83,83,0,0,0,83,0,83,83,
82,82,0,82,82,82,0,82,82,
0,0,0,81,81,81,0,0,0,
80,80,0,80,80,80,0,80,80,
0,0,79,79,79,79,79,79,79,
0,0,0,0,0,0,0,0,0,
0,0,0,0,0,0,0,0,0,
0,0,0,0,0,0,0,0,0.