[layer]
type=Tile Layer 1
data=
2,2,21,9,2,2,0,2,2,
0,9,20,2,2,2,21,2,2,
0,2,21,2,0,0,0,1,0,
1,1,1,1,1,21,1,1,0,
1,1,21,1,0,0,0,0,0,
1,1,0,1,2,2,21,1,1,
0,1,0,0,21,8,2,0,0,
0,2,2,1,0,2,2,2,21,
0,8,2,7,21,2,20,2,2,
0,0,2,21,2,0,0,2,1,
1,21,0,2,24,2,2,19,0,
0,1,0,1,1,21,2,2,0,
0,1,21,1,1,0,1,1,0,
2,21,0,2,0,2,2,0,18,
0,0,1,0,1,21,0,1,1,
0,0,0,0,0,0,0,0,0,
0,0,0,0,0,0,0,0,0,
0,0,0,0,0,0,0,0,0.
[layer]
type=Tile Layer 2
data=
108,108,0,108,108,108,0,108,108,
0,84,0,84,84,84,0,84,84,
0,83,0,83,0,0,0,83,0,
78,78,78,78,78,0,78,78,0,
74,74,0,74,0,0,0,0,0,
69,69,0,69,69,69,0,69,69,
0,72,0,0,0,72,72,0,0,
0,64,64,64,0,64,64,64,0,
0,63,63,63,0,63,0,63,63,
0,0,62,0,62,0,0,62,62,
61,0,0,61,0,61,61,0,0,
0,60,0,60,60,0,60,60,0,
0,59,0,59,59,0,59,59,0,
58,0,0,58,0,58,58,0,0,
0,0,57,0,57,0,0,57,57,
0,0,0,0,0,0,0,0,0,
0,0,0,0,0,0,0,0,0,
0,0,0,0,0,0,0,0,0.