[layer]
type=Tile Layer 1
data=
1,1,1,21,1,0,1,0,1,
1,1,1,1,1,21,1,0,1,
1,1,1,21,1,0,1,0,1,
1,1,1,21,1,1,1,0,1,
0,1,0,1,0,0,21,0,0,
1,1,1,1,21,1,1,1,1,
1,1,1,1,21,1,1,1,1,
1,1,1,1,21,1,0,1,0,
1,1,1,1,21,1,0,1,0,
0,1,21,1,0,0,1,1,1,
0,1,0,1,21,1,1,1,1,
0,1,1,0,21,0,0,1,1,
0,1,1,21,1,1,0,0,1,
0,0,21,1,1,1,1,0,0,
1,21,1,1,1,0,1,1,0,
1,21,0,1,0,0,0,0,0,
0,1,21,0,1,0,0,1,0,
0,21,0,1,1,0,1,1,1,
0,0,0,1,0,0,21,1,0,
0,1,1,1,1,1,21,1,1,
0,1,1,1,1,1,21,0,0,
0,1,1,1,1,1,21,1,1,
0,1,1,1,1,1,21,1,1,
1,1,1,1,1,1,21,1,1,
0,0,0,1,21,1,0,1,1,
1,1,1,1,21,1,0,1,1,
0,0,0,0,0,0,0,1,21,
1,1,1,1,1,21,1,1,1,
1,0,1,0,0,21,1,0,0,
1,1,1,1,1,21,1,1,1,
1,21,1,1,1,0,1,1,1,
1,0,0,21,1,0,1,1,1,
1,21,1,1,1,1,1,1,1,
1,21,1,0,0,0,1,1,1,
1,21,1,0,1,1,1,1,1,
1,0,1,0,0,0,0,21,0,
1,0,0,0,1,1,1,21,0,
1,21,0,0,1,1,1,0,0,
1,21,1,1,1,1,1,0,1,
0,0,1,1,1,0,21,1,1,
0,1,0,0,21,0,1,1,1,
0,1,0,0,0,0,0,21,1,
0,1,1,1,1,1,1,21,1,
0,1,0,21,0,1,0,1,1,
0,0,0,0,21,0,0,1,1,
1,1,1,21,1,0,0,0,1,
1,1,1,21,1,1,1,0,1,
1,1,1,21,0,0,1,0,0,
1,1,1,21,1,1,1,1,1,
0,21,0,0,1,0,1,1,1,
1,1,1,1,1,21,1,1,1,
0,0,0,0,0,0,0,0,0,
0,0,0,0,0,0,0,0,0,
0,0,0,0,0,0,0,0,0.
[layer]
type=Tile Layer 2
data=
234,234,234,0,234,0,234,0,234,
233,233,233,233,233,0,233,0,233,
231,231,231,0,231,0,231,0,231,
174,174,174,0,174,174,174,0,174,
0,159,0,159,0,0,0,0,0,
189,189,189,189,0,189,189,189,189,
175,175,175,175,0,175,175,175,175,
169,169,169,169,0,169,0,169,0,
155,155,155,155,0,155,0,155,0,
0,193,0,193,0,0,193,193,193,
0,179,0,179,0,179,179,179,179,
0,165,165,0,0,0,0,165,165,
0,150,150,0,150,150,0,0,150,
0,0,0,188,188,188,188,0,0,
174,0,174,174,174,0,174,174,0,
160,0,0,160,0,0,0,0,0,
0,146,0,0,146,0,0,146,0,
0,0,0,182,182,0,182,182,182,
0,0,0,168,0,0,0,168,0,
0,155,155,155,155,155,0,155,155,
0,142,142,142,142,142,0,0,0,
0,177,177,177,177,177,0,177,177,
0,163,163,163,163,163,0,163,163,
143,143,143,143,143,143,0,143,143,
0,0,0,137,0,137,0,137,137,
171,171,171,171,0,171,0,171,171,
0,0,0,0,0,0,0,158,0,
138,138,138,138,138,0,138,138,138,
133,0,133,0,0,0,133,0,0,
157,157,157,157,157,0,157,157,157,
153,0,153,153,153,0,153,153,153,
141,0,0,0,141,0,141,141,141,
122,0,122,122,122,122,122,122,122,
160,0,160,0,0,0,160,160,160,
148,0,148,0,148,148,148,148,148,
136,0,136,0,0,0,0,0,0,
124,0,0,0,124,124,124,0,0,
154,0,0,0,154,154,154,0,0,
142,0,142,142,142,142,142,0,142,
0,0,131,131,131,0,0,131,131,
0,120,0,0,0,0,120,120,120,
0,119,0,0,0,0,0,0,119,
0,108,108,108,108,108,108,0,108,
0,107,0,0,0,107,0,107,107,
0,0,0,0,0,0,0,106,106,
95,95,95,0,95,0,0,0,95,
94,94,94,0,94,94,94,0,94,
93,93,93,0,0,0,93,0,0,
88,88,88,0,88,88,88,88,88,
0,0,0,0,91,0,91,91,91,
86,86,86,86,86,0,86,86,86,
0,0,0,0,0,0,0,0,0,
0,0,0,0,0,0,0,0,0,
0,0,0,0,0,0,0,0,0.