[layer]
type=Tile Layer 1
data=
0,1,0,1,1,1,0,21,1,
0,1,21,1,1,1,1,1,1,
0,0,21,1,0,1,0,1,0,
0,21,0,0,0,1,0,0,1,
1,1,1,6,4,1,1,21,1,
1,1,6,4,1,1,1,21,1,
0,21,0,0,0,1,1,0,1,
1,3,5,1,0,1,1,21,0,
1,1,3,5,0,21,0,0,0,
0,0,0,0,0,0,0,0,0,
0,0,0,0,0,0,0,0,0,
0,0,0,0,0,0,0,0,0.
[layer]
type=Tile Layer 2
data=
0,79,0,79,79,79,0,0,79,
0,48,0,48,48,48,48,48,48,
0,0,0,49,0,49,0,49,0,
0,0,0,0,0,48,0,0,48,
43,43,43,43,43,43,43,0,43,
42,42,42,42,42,42,42,0,42,
0,0,0,0,0,46,46,0,46,
45,45,45,45,0,45,45,0,0,
44,44,44,44,0,0,0,0,0,
0,0,0,0,0,0,0,0,0,
0,0,0,0,0,0,0,0,0,
0,0,0,0,0,0,0,0,0.