[layer]
type=Tile Layer 1
data=
1,1,1,1,21,0,0,0,1,
1,1,0,21,0,1,1,0,0,
1,1,0,1,21,1,1,1,0,
1,1,21,0,0,1,1,1,0,
2,2,21,1,1,1,1,1,0,
10,2,0,0,0,0,21,0,0,
0,2,2,2,21,7,2,2,2,
0,21,2,2,2,2,2,2,7,
21,2,10,2,1,1,1,1,1,
1,2,2,2,1,1,1,21,2,
0,21,0,0,0,0,0,0,8,
1,1,1,1,1,21,1,2,2,
2,2,1,1,1,21,1,0,0,
10,2,1,1,1,21,1,1,1,
2,0,21,1,0,0,0,0,0,
1,1,1,1,1,21,1,0,1,
0,0,1,0,0,0,1,21,0,
1,21,1,0,1,1,1,1,1,
1,21,1,0,1,0,0,0,1,
1,21,1,0,1,0,1,0,1,
1,0,1,0,1,21,1,0,1,
1,0,1,21,1,0,1,1,1,
1,0,1,0,1,0,21,0,1,
1,21,1,0,1,0,1,0,1,
1,21,1,0,1,1,1,1,1,
2,2,7,2,2,21,2,0,2,
2,21,2,2,2,9,2,0,2,
2,0,2,21,2,2,2,2,9,
1,0,1,21,1,1,1,2,2,
1,21,1,0,1,1,1,0,0,
0,0,0,0,0,0,0,0,0,
0,0,0,0,0,0,0,0,0,
0,0,0,0,0,0,0,0,0.
[layer]
type=Tile Layer 2
data=
166,166,166,166,0,0,0,0,166,
164,164,0,0,0,164,164,0,0,
162,162,0,162,0,162,162,162,0,
112,112,0,0,0,112,112,112,0,
140,140,0,140,140,140,140,140,0,
129,129,0,0,0,0,0,0,0,
0,118,118,118,0,118,118,118,118,
0,0,108,108,108,108,108,108,108,
0,134,134,134,134,134,134,134,134,
118,118,118,118,118,118,118,0,118,
0,0,0,0,0,0,0,0,114,
99,99,99,99,99,0,99,99,99,
129,129,129,129,129,0,129,0,0,
119,119,119,119,119,0,119,119,119,
109,0,0,109,0,0,0,0,0,
99,99,99,99,99,0,99,0,99,
0,0,123,0,0,0,123,0,0,
113,0,113,0,113,113,113,113,113,
104,0,104,0,104,0,0,0,104,
95,0,95,0,95,0,95,0,95,
94,0,94,0,94,0,94,0,94,
85,0,85,0,85,0,85,85,85,
84,0,84,0,84,0,0,0,84,
83,0,83,0,83,0,83,0,83,
74,0,74,0,74,74,74,74,74,
73,73,73,73,73,0,73,0,73,
72,0,72,72,72,72,72,0,72,
71,0,71,0,71,71,71,71,71,
70,0,70,0,70,70,70,70,70,
69,0,69,0,69,69,69,0,0,
0,0,0,0,0,0,0,0,0,
0,0,0,0,0,0,0,0,0,
0,0,0,0,0,0,0,0,0.