[layer]
type=Tile Layer 1
data=
0,5,0,21,0,6,1,1,0,
2,2,2,2,2,2,2,7,21,
0,1,1,1,0,0,21,0,0,
0,2,0,21,1,3,1,1,4,
20,2,21,2,2,2,2,2,2,
0,2,1,21,0,1,1,1,1,
0,1,0,21,1,1,1,1,3,
21,2,2,7,2,2,2,2,2,
0,24,0,21,0,2,10,2,4,
0,24,2,1,21,0,2,2,1,
0,21,1,0,1,0,0,0,0,
0,0,21,0,0,1,3,4,1,
1,21,0,0,1,1,4,0,1,
4,3,1,21,1,5,1,0,1,
1,1,1,0,0,21,1,0,1,
1,5,1,21,1,1,1,0,2,
2,7,2,2,2,2,0,21,19,
1,1,1,21,1,4,3,2,2,
0,0,0,0,0,0,21,0,1,
21,2,2,2,1,1,1,1,5,
0,21,8,0,1,1,6,4,1,
8,21,2,2,3,1,1,1,0,
2,21,2,1,1,4,1,1,0,
2,24,0,21,1,1,6,2,0,
9,2,21,2,2,2,2,0,24,
2,2,2,2,2,21,7,2,0,
1,1,21,0,0,0,5,0,0,
0,0,0,0,0,0,0,0,0,
0,0,0,0,0,0,0,0,0,
0,0,0,0,0,0,0,0,0.
[layer]
type=Tile Layer 2
data=
0,160,0,0,0,160,160,160,0,
158,158,158,158,158,158,158,158,0,
0,157,157,157,0,0,0,0,0,
0,117,0,0,117,117,117,117,117,
0,107,0,107,107,107,107,107,107,
0,133,133,0,0,133,133,133,133,
0,123,0,0,123,123,123,123,123,
0,113,113,113,113,113,113,113,113,
0,0,0,0,0,102,102,102,102,
0,0,128,128,0,0,128,128,128,
0,0,118,0,118,0,0,0,0,
0,0,0,0,0,108,108,108,108,
98,0,0,0,98,98,98,0,98,
122,122,122,0,122,122,122,0,122,
112,112,112,0,0,0,112,0,112,
103,103,103,0,103,103,103,0,103,
94,94,94,94,94,94,0,0,0,
88,88,88,0,88,88,88,88,88,
0,0,0,0,0,0,0,0,84,
0,79,79,79,79,79,79,79,79,
0,0,82,0,82,82,82,82,82,
73,0,73,73,73,73,73,73,0,
72,0,72,72,72,72,72,72,0,
71,0,0,0,71,71,71,71,0,
70,70,0,70,70,70,70,0,0,
69,69,69,69,69,0,69,69,0,
68,68,0,0,0,0,68,0,0,
0,0,0,0,0,0,0,0,0,
0,0,0,0,0,0,0,0,0,
0,0,0,0,0,0,0,0,0.