[layer]
type=Tile Layer 1
data=
1,1,1,1,2,24,21,0,1,
1,1,1,1,2,2,2,21,0,
2,2,2,2,2,20,0,21,0,
1,0,0,21,0,0,2,1,1,
1,21,2,2,2,1,1,1,1,
1,21,0,24,0,0,1,1,1,
1,1,1,1,1,0,21,0,0,
1,1,0,0,21,0,0,0,0,
1,1,21,1,1,1,1,1,1,
1,1,21,1,1,1,1,1,0,
1,1,0,1,0,0,21,0,0,
1,1,21,1,0,1,1,1,1,
0,0,0,1,0,1,0,0,21,
1,1,1,1,21,1,0,1,1,
0,0,0,0,21,0,0,1,1,
1,1,1,1,1,1,21,1,1,
0,0,0,1,1,1,21,0,1,
1,2,2,1,1,1,1,21,1,
0,19,0,0,0,0,0,21,1,
0,2,2,1,1,1,1,21,1,
0,2,1,1,1,1,1,21,1,
24,21,0,0,0,1,1,0,1,
1,1,1,1,0,1,1,21,0,
1,1,1,1,21,0,0,0,0,
0,0,0,0,0,0,0,0,0,
0,0,0,0,0,0,0,0,0,
0,0,0,0,0,0,0,0,0.
[layer]
type=Tile Layer 2
data=
139,139,139,139,139,0,0,0,139,
131,131,131,131,131,131,131,0,0,
136,136,136,136,136,0,0,0,0,
110,0,0,0,0,0,110,110,110,
91,0,91,91,91,91,91,91,91,
91,0,0,0,0,0,91,91,91,
114,114,114,114,114,0,0,0,0,
105,105,0,0,0,0,0,0,0,
87,87,0,87,87,87,87,87,87,
83,83,0,83,83,83,83,83,0,
108,108,0,108,0,0,0,0,0,
95,95,0,95,0,95,95,95,95,
0,0,0,91,0,91,0,0,0,
79,79,79,79,0,79,0,79,79,
0,0,0,0,0,0,0,82,82,
67,67,67,67,67,67,0,67,67,
0,0,0,73,73,73,0,0,73,
65,65,65,65,65,65,65,0,65,
0,0,0,0,0,0,0,0,64,
0,60,60,60,60,60,60,0,60,
0,59,59,59,59,59,59,0,59,
0,0,0,0,0,61,61,0,61,
60,60,60,60,0,60,60,0,0,
59,59,59,59,0,0,0,0,0,
0,0,0,0,0,0,0,0,0,
0,0,0,0,0,0,0,0,0,
0,0,0,0,0,0,0,0,0.