[layer]
type=Tile Layer 1
data=
1,21,0,0,0,0,3,5,0,
1,5,21,6,1,1,1,1,1,
0,1,21,0,1,1,0,0,0,
1,1,0,21,4,1,3,0,0,
1,4,1,21,1,3,1,1,0,
1,1,1,21,1,1,1,5,0,
3,1,1,21,1,1,1,4,0,
1,3,0,0,1,1,0,21,0,
1,1,21,1,6,1,0,1,1,
1,1,21,0,0,0,0,4,6,
0,21,1,1,0,0,0,1,1,
0,21,0,0,5,1,1,1,1,
1,1,1,6,1,1,1,1,21,
0,0,21,1,1,4,1,1,0,
1,1,21,1,4,1,3,1,6,
1,1,0,0,0,3,0,21,0,
1,1,21,1,3,1,5,4,0,
1,1,0,1,0,21,0,1,0,
3,1,0,1,0,1,21,6,0,
0,1,0,1,21,1,0,1,0,
0,1,1,5,21,6,1,1,0,
1,1,4,1,0,21,0,6,1,
1,1,1,0,21,3,0,0,0,
1,1,1,21,0,0,1,4,0,
4,1,1,3,1,21,3,0,0,
1,1,1,6,1,21,1,1,0,
1,1,21,0,0,0,0,0,0,
0,0,0,0,0,0,0,0,0,
0,0,0,0,0,0,0,0,0,
0,0,0,0,0,0,0,0,0.
[layer]
type=Tile Layer 2
data=
160,0,0,0,0,0,160,160,0,
150,150,0,150,150,150,150,150,150,
0,157,0,0,157,157,0,0,0,
117,117,0,0,117,117,117,0,0,
107,107,107,0,107,107,107,107,0,
133,133,133,0,133,133,133,133,0,
123,123,123,0,123,123,123,123,0,
113,113,0,0,113,113,0,0,0,
102,102,0,102,102,102,0,102,102,
128,128,0,0,0,0,0,128,128,
0,0,118,118,0,0,0,118,118,
0,0,0,0,108,108,108,108,108,
93,93,93,93,93,93,93,93,0,
0,0,0,122,122,122,122,122,0,
107,107,0,107,107,107,107,107,107,
103,103,0,0,0,103,0,0,0,
94,94,0,94,94,94,94,94,0,
93,93,0,93,0,0,0,93,0,
84,84,0,84,0,84,0,84,0,
0,83,0,83,0,83,0,83,0,
0,82,82,82,0,82,82,82,0,
73,73,73,73,0,0,0,73,73,
72,72,72,0,0,72,0,0,0,
71,71,71,0,0,0,71,71,0,
70,70,70,70,70,0,70,0,0,
69,69,69,69,69,0,69,69,0,
68,68,0,0,0,0,0,0,0,
0,0,0,0,0,0,0,0,0,
0,0,0,0,0,0,0,0,0,
0,0,0,0,0,0,0,0,0.