[layer]
type=Tile Layer 1
data=
0,1,0,0,0,21,0,1,1,
21,1,1,1,1,1,1,1,1,
0,1,1,0,21,1,1,1,1,
1,0,1,1,0,21,0,0,0,
1,1,1,21,1,1,1,0,0,
1,0,21,0,1,1,0,0,1,
1,21,1,1,1,0,1,1,1,
1,21,1,1,1,0,1,0,0,
1,1,1,1,1,21,1,1,1,
0,0,0,0,0,21,1,1,1,
1,21,1,1,1,0,1,1,1,
1,0,1,0,21,0,0,0,0,
1,21,1,1,1,1,1,1,1,
1,0,0,0,1,0,21,0,0,
1,1,1,1,1,21,1,1,1,
1,21,1,0,1,0,1,0,1,
0,1,1,1,21,1,1,1,0,
1,1,21,1,1,1,0,1,1,
1,0,0,21,1,0,0,0,1,
0,0,1,0,21,0,1,0,0,
0,1,1,1,21,1,1,1,0,
0,0,0,0,0,0,0,0,0,
0,0,0,0,0,0,0,0,0,
0,0,0,0,0,0,0,0,0.
[layer]
type=Tile Layer 2
data=
0,133,0,0,0,0,0,133,133,
0,119,119,119,119,119,119,119,119,
0,130,130,0,0,130,130,130,130,
113,0,113,113,0,0,0,0,0,
104,104,104,0,104,104,104,0,0,
95,0,0,0,95,95,0,0,95,
82,0,82,82,82,0,82,82,82,
107,0,107,107,107,0,107,0,0,
89,89,89,89,89,0,89,89,89,
0,0,0,0,0,0,90,90,90,
78,0,78,78,78,0,78,78,78,
81,0,81,0,0,0,0,0,0,
66,0,66,66,66,66,66,66,66,
72,0,0,0,72,0,0,0,0,
64,64,64,64,64,0,64,64,64,
63,0,63,0,63,0,63,0,63,
0,62,62,62,0,62,62,62,0,
58,58,0,58,58,58,0,58,58,
60,0,0,0,60,0,0,0,60,
0,0,59,0,0,0,59,0,0,
0,58,58,58,0,58,58,58,0,
0,0,0,0,0,0,0,0,0,
0,0,0,0,0,0,0,0,0,
0,0,0,0,0,0,0,0,0.