[layer]
type=Tile Layer 1
data=
1,1,21,1,1,0,1,1,0,
1,1,21,1,1,1,1,1,1,
1,0,0,0,1,1,0,21,0,
1,21,1,1,0,1,1,0,1,
0,0,1,1,0,1,1,0,21,
0,1,1,1,1,1,1,21,0,
0,1,21,1,0,1,1,1,1,
0,1,0,6,0,21,0,1,0,
1,1,6,4,1,6,0,1,21,
0,1,0,21,0,4,0,0,0,
0,1,0,1,21,1,6,4,1,
0,1,0,1,0,1,0,0,21,
0,0,0,0,0,0,0,0,0,
0,0,0,0,0,0,0,0,0,
0,0,0,0,0,0,0,0,0.
[layer]
type=Tile Layer 2
data=
88,88,0,88,88,0,88,88,0,
56,56,0,56,56,56,56,56,56,
62,0,0,0,62,62,0,0,0,
61,0,61,61,0,61,61,0,61,
0,0,54,54,0,54,54,0,0,
0,53,53,53,53,53,53,0,0,
0,52,0,52,0,52,52,52,52,
0,51,0,51,0,0,0,51,0,
48,48,48,48,48,48,0,48,0,
0,49,0,0,0,49,0,0,0,
0,48,0,48,0,48,48,48,48,
0,47,0,47,0,47,0,0,0,
0,0,0,0,0,0,0,0,0,
0,0,0,0,0,0,0,0,0,
0,0,0,0,0,0,0,0,0.