[layer]
type=Tile Layer 1
data=
4,1,1,21,1,1,6,1,5,
1,1,1,21,4,1,1,1,1,
0,0,1,0,0,0,0,0,21,
4,1,0,1,1,1,4,21,0,
1,1,1,1,1,3,21,1,0,
0,0,0,0,0,21,0,6,0,
1,5,1,0,0,0,21,1,0,
3,1,1,4,1,1,1,1,21,
1,5,21,0,0,0,0,1,0,
0,21,1,1,1,1,1,1,0,
0,21,0,0,1,0,1,5,0,
3,1,4,0,1,21,0,0,0,
1,1,1,1,1,21,5,6,1,
1,1,1,3,1,21,1,1,1,
6,1,5,1,3,21,1,1,1,
0,0,0,21,0,0,0,0,1,
6,1,1,21,5,1,1,1,1,
5,1,1,21,1,0,0,0,4,
1,1,3,1,1,21,1,1,1,
1,21,0,0,0,0,1,1,1,
4,1,1,1,4,21,5,5,1,
1,21,1,6,1,3,1,0,1,
5,21,1,1,1,1,6,1,5,
1,21,1,1,1,1,1,0,3,
1,21,1,1,4,1,4,0,1,
0,0,0,0,0,0,21,0,1,
1,1,1,6,1,21,1,1,3,
1,0,1,4,6,0,1,21,0,
1,21,1,5,1,0,1,1,1,
0,0,6,1,1,21,1,1,1,
1,4,21,0,3,1,1,0,0,
1,1,1,21,0,1,0,0,1,
1,4,6,21,0,1,1,0,0,
1,4,1,0,0,21,0,1,1,
0,21,0,0,1,0,0,0,0,
0,0,1,6,1,1,5,1,21,
1,0,0,0,0,1,21,1,0,
1,1,0,1,0,21,0,0,0,
4,1,21,1,0,5,1,1,3,
1,1,1,21,1,0,1,0,0,
1,1,6,21,3,0,1,1,3,
1,5,1,21,1,0,5,1,1,
1,1,1,21,6,0,1,1,1,
0,0,0,0,1,21,6,1,4,
4,1,1,3,1,21,1,1,1,
0,0,0,0,0,0,0,0,0,
0,0,0,0,0,0,0,0,0,
0,0,0,0,0,0,0,0,0.
[layer]
type=Tile Layer 2
data=
198,198,198,0,198,198,198,198,198,
196,196,196,0,196,196,196,196,196,
0,0,204,0,0,0,0,0,0,
178,178,0,178,178,178,178,0,0,
165,165,165,165,165,165,0,165,0,
0,0,0,0,0,0,0,152,0,
138,138,138,0,0,0,0,138,0,
164,164,164,164,164,164,164,164,0,
160,160,0,0,0,0,0,160,0,
0,0,147,147,147,147,147,147,0,
0,0,0,0,134,0,134,134,0,
167,167,167,0,167,0,0,0,0,
147,147,147,147,147,0,147,147,147,
135,135,135,135,135,0,135,135,135,
123,123,123,123,123,0,123,123,123,
0,0,0,0,0,0,0,0,162,
142,142,142,0,142,142,142,142,142,
137,137,137,0,137,0,0,0,137,
119,119,119,119,119,0,119,119,119,
156,0,0,0,0,0,156,156,156,
137,137,137,137,137,0,137,137,137,
132,0,132,132,132,132,132,0,132,
115,0,115,115,115,115,115,115,115,
150,0,150,150,150,150,150,0,150,
139,0,139,139,139,139,139,0,139,
0,0,0,0,0,0,0,0,128,
111,111,111,111,111,0,111,111,111,
145,0,145,145,145,0,145,0,0,
134,0,134,134,134,0,134,134,134,
0,0,123,123,123,0,123,123,123,
112,112,0,0,112,112,112,0,0,
139,139,139,0,0,139,0,0,139,
128,128,128,0,0,128,128,0,0,
118,118,118,0,0,0,0,118,118,
0,0,0,0,108,0,0,0,0,
0,0,107,107,107,107,107,107,0,
97,0,0,0,0,97,0,97,0,
96,96,0,96,0,0,0,0,0,
95,95,0,95,0,95,95,95,95,
85,85,85,0,85,0,85,0,0,
84,84,84,0,84,0,84,84,84,
83,83,83,0,83,0,83,83,83,
82,82,82,0,82,0,82,82,82,
0,0,0,0,81,0,81,81,81,
77,77,77,77,77,0,77,77,77,
0,0,0,0,0,0,0,0,0,
0,0,0,0,0,0,0,0,0,
0,0,0,0,0,0,0,0,0.