[layer]
type=Tile Layer 1
data=
1,1,1,1,1,1,21,1,1,
1,1,1,1,1,1,21,0,1,
1,1,1,1,1,1,1,21,1,
0,1,1,1,0,1,21,1,0,
0,1,1,1,0,1,21,1,0,
0,1,0,1,0,1,0,1,21,
1,1,1,1,21,1,0,1,0,
0,0,0,0,0,1,21,1,0,
1,1,1,1,1,1,1,1,21,
1,1,1,21,1,1,1,1,1,
0,0,1,21,1,0,1,1,1,
1,21,1,1,1,0,1,1,1,
1,1,1,1,21,1,1,1,1,
0,21,0,1,0,1,1,1,1,
1,1,21,1,1,1,1,1,1,
1,1,21,1,0,0,0,0,0,
1,1,21,1,1,1,1,1,1,
0,1,0,1,21,1,1,1,1,
1,1,1,1,21,1,1,1,1,
0,1,21,0,1,1,1,0,1,
1,1,1,1,21,1,1,1,1,
0,1,1,1,0,1,21,1,0,
0,1,1,1,21,1,1,1,1,
0,1,0,21,0,1,1,1,1,
1,1,1,1,21,1,1,1,1,
1,1,1,1,21,1,1,1,1,
1,1,1,1,21,1,1,1,1,
1,1,1,1,0,0,21,1,0,
1,1,1,1,21,1,1,1,0,
0,0,0,1,0,1,21,0,0,
1,1,1,21,1,0,1,0,0,
1,1,1,21,1,0,1,1,1,
0,0,1,0,1,21,0,0,0,
1,1,1,21,1,1,1,1,1,
1,0,21,0,1,0,0,0,0,
1,21,1,1,1,1,1,1,1,
1,21,1,0,1,1,1,1,1,
1,21,1,1,1,1,1,1,1,
1,0,1,0,0,0,0,21,0,
1,1,1,1,1,1,0,21,0,
1,1,1,1,1,0,21,1,0,
1,1,1,1,1,21,1,1,0,
1,1,1,1,21,1,1,1,0,
1,1,1,1,21,0,1,1,0,
1,1,1,1,1,1,1,1,21,
1,1,21,0,0,0,1,1,0,
1,1,0,1,0,0,21,0,0,
1,21,0,1,0,1,1,1,1,
1,1,0,0,21,0,1,1,1,
0,1,1,21,0,0,1,1,1,
0,1,0,21,1,1,1,1,1,
0,0,21,1,1,1,1,1,1,
0,0,0,21,0,1,1,1,1,
0,21,0,0,1,1,1,1,1,
0,0,0,0,0,0,0,0,0,
0,0,0,0,0,0,0,0,0,
0,0,0,0,0,0,0,0,0.
[layer]
type=Tile Layer 2
data=
227,227,227,227,227,227,0,227,227,
237,237,237,237,237,237,0,0,237,
224,224,224,224,224,224,224,0,224,
0,164,164,164,0,164,0,164,0,
0,205,205,205,0,205,0,205,0,
0,189,0,189,0,189,0,189,0,
174,174,174,174,0,174,0,174,0,
0,0,0,0,0,159,0,159,0,
189,189,189,189,189,189,189,189,0,
175,175,175,0,175,175,175,175,175,
0,0,169,0,169,0,169,169,169,
155,0,155,155,155,0,155,155,155,
184,184,184,184,0,184,184,184,184,
0,0,0,179,0,179,179,179,179,
157,157,0,157,157,157,157,157,157,
150,150,0,150,0,0,0,0,0,
179,179,0,179,179,179,179,179,179,
0,174,0,174,0,174,174,174,174,
152,152,152,152,0,152,152,152,152,
0,146,0,0,146,146,146,0,146,
173,173,173,173,0,173,173,173,173,
0,168,168,168,0,168,0,168,0,
0,155,155,155,0,155,155,155,155,
0,142,0,0,0,142,142,142,142,
168,168,168,168,0,168,168,168,168,
155,155,155,155,0,155,155,155,155,
143,143,143,143,0,143,143,143,143,
137,137,137,137,0,0,0,137,0,
171,171,171,171,0,171,171,171,0,
0,0,0,158,0,158,0,0,0,
145,145,145,0,145,0,145,0,0,
133,133,133,0,133,0,133,133,133,
0,0,165,0,165,0,0,0,0,
146,146,146,0,146,146,146,146,146,
141,0,0,0,141,0,0,0,0,
122,0,122,122,122,122,122,122,122,
160,0,160,0,160,160,160,160,160,
141,0,141,141,141,141,141,141,141,
136,0,136,0,0,0,0,0,0,
124,124,124,124,124,124,0,0,0,
154,154,154,154,154,0,0,154,0,
142,142,142,142,142,0,142,142,0,
131,131,131,131,0,131,131,131,0,
120,120,120,120,0,0,120,120,0,
113,113,113,113,113,113,113,113,0,
108,108,0,0,0,0,108,108,0,
107,107,0,107,0,0,0,0,0,
106,0,0,106,0,106,106,106,106,
95,95,0,0,0,0,95,95,95,
0,94,94,0,0,0,94,94,94,
0,93,0,0,93,93,93,93,93,
0,0,0,92,92,92,92,92,92,
0,0,0,0,0,91,91,91,91,
0,0,0,0,90,90,90,90,90,
0,0,0,0,0,0,0,0,0,
0,0,0,0,0,0,0,0,0,
0,0,0,0,0,0,0,0,0.