[layer]
type=Tile Layer 1
data=
1,1,21,1,1,1,0,1,1,
0,1,0,1,1,1,21,0,0,
0,1,1,1,1,1,1,1,21,
0,1,1,1,1,1,0,0,21,
0,0,21,5,1,0,0,1,1,
0,1,3,21,0,4,0,1,0,
3,5,1,1,21,1,1,1,0,
1,3,5,1,1,1,1,1,21,
1,21,0,0,0,0,1,1,0,
0,0,0,0,0,0,0,0,0,
0,0,0,0,0,0,0,0,0,
0,0,0,0,0,0,0,0,0.
[layer]
type=Tile Layer 2
data=
75,75,0,75,75,75,0,75,75,
0,50,0,50,50,50,0,0,0,
0,47,47,47,47,47,47,47,0,
0,48,48,48,48,48,0,0,0,
0,0,0,48,48,0,0,48,48,
0,47,47,0,0,47,0,47,0,
44,44,44,44,0,44,44,44,0,
41,41,41,41,41,41,41,41,0,
44,0,0,0,0,0,44,44,0,
0,0,0,0,0,0,0,0,0,
0,0,0,0,0,0,0,0,0,
0,0,0,0,0,0,0,0,0.