[layer]
type=Tile Layer 1
data=
1,1,4,0,1,21,1,0,5,
1,1,1,0,1,21,1,0,1,
1,1,1,0,4,0,6,21,0,
3,1,1,21,1,0,1,1,1,
0,21,6,0,6,0,1,0,0,
1,21,5,0,1,0,1,0,1,
4,3,1,1,21,1,0,1,1,
1,1,1,1,0,5,0,21,0,
2,2,2,2,21,2,2,20,0,
1,1,1,21,0,24,0,2,5,
1,5,6,21,1,1,0,1,1,
1,2,2,21,0,3,0,1,1,
2,20,0,0,0,2,0,21,0,
1,21,0,1,1,1,5,2,24,
6,1,21,1,3,1,1,1,0,
0,0,4,0,0,0,0,21,0,
1,6,1,6,21,1,1,5,1,
0,1,1,1,0,1,1,1,21,
21,1,1,3,1,2,2,2,5,
0,0,0,21,0,2,19,0,0,
1,1,1,1,21,2,0,2,0,
1,1,1,1,0,5,21,2,19,
6,1,1,4,21,1,0,2,2,
0,0,0,2,0,1,21,0,0,
0,0,24,21,1,1,1,1,6,
0,0,1,21,0,2,2,2,4,
2,0,0,2,21,0,20,2,2,
1,1,0,0,0,2,0,21,0,
1,1,4,1,21,2,2,2,0,
1,1,3,1,0,2,24,21,0,
0,0,0,0,0,0,0,0,0,
0,0,0,0,0,0,0,0,0,
0,0,0,0,0,0,0,0,0.
[layer]
type=Tile Layer 2
data=
166,166,166,0,166,0,166,0,166,
164,164,164,0,164,0,164,0,164,
162,162,162,0,162,0,162,0,0,
112,112,112,0,112,0,112,112,112,
0,0,140,0,140,0,140,0,0,
129,0,129,0,129,0,129,0,129,
118,118,118,118,0,118,0,118,118,
108,108,108,108,0,108,0,0,0,
134,134,134,134,0,134,134,0,0,
124,124,124,0,0,0,0,124,124,
114,114,114,0,114,114,0,114,114,
103,103,103,0,0,103,0,103,103,
129,0,0,0,0,129,0,0,0,
119,0,0,119,119,119,119,119,0,
109,109,0,109,109,109,109,109,0,
0,0,99,0,0,0,0,0,0,
117,117,117,117,0,117,117,117,117,
0,113,113,113,0,113,113,113,0,
0,99,99,99,99,99,99,99,99,
0,0,0,0,0,95,0,0,0,
94,94,94,94,0,94,0,94,0,
85,85,85,85,0,85,0,85,0,
84,84,84,84,0,84,0,84,84,
0,0,0,83,0,83,0,0,0,
0,0,0,0,74,74,74,74,74,
0,0,73,0,0,73,73,73,73,
72,0,0,72,0,0,0,72,72,
71,71,0,0,0,71,0,0,0,
70,70,70,70,0,70,70,70,0,
69,69,69,69,0,69,0,0,0,
0,0,0,0,0,0,0,0,0,
0,0,0,0,0,0,0,0,0,
0,0,0,0,0,0,0,0,0.