[layer]
type=Tile Layer 1
data=
3,6,6,1,1,1,21,0,6,
5,3,3,3,5,5,1,21,3,
6,5,1,6,5,1,21,0,5,
4,1,3,3,4,5,0,21,0,
3,0,0,0,0,21,0,0,1,
1,21,0,0,0,4,5,1,5,
4,3,4,1,0,21,1,1,3,
3,5,5,4,4,3,21,1,1,
5,5,1,4,1,5,3,1,21,
4,4,5,5,21,1,1,1,1,
1,5,4,5,1,3,21,3,1,
0,0,0,0,0,4,0,3,21,
5,4,6,6,5,4,21,5,0,
0,0,0,0,21,0,0,1,0,
1,1,5,4,1,6,4,6,21,
0,0,0,0,0,0,1,21,5,
6,1,6,4,6,1,4,1,21,
0,0,21,5,6,5,4,4,0,
5,4,6,4,4,5,1,21,0,
4,1,5,0,0,0,21,0,5,
1,6,21,0,6,6,1,6,4,
4,1,0,21,0,0,5,5,4,
6,0,0,21,0,0,1,6,6,
5,0,21,0,0,4,6,1,1,
5,6,3,3,0,21,0,6,3,
6,1,5,5,1,6,21,0,0,
1,3,1,6,3,5,1,5,21,
6,6,5,0,21,0,0,0,5,
5,1,6,0,21,3,5,0,0,
3,3,5,1,1,1,3,6,21,
5,4,3,4,0,1,5,21,0,
1,5,1,21,1,4,3,0,5,
4,3,3,21,5,1,3,5,4,
5,4,4,3,0,3,4,21,0,
0,0,0,1,0,0,0,21,0,
0,0,0,0,21,1,5,3,0,
0,0,4,0,21,0,4,0,5,
1,0,1,21,3,3,1,0,5,
5,0,3,1,21,1,0,0,4,
4,21,1,1,3,3,3,0,3,
3,21,6,1,1,4,6,1,1,
1,21,6,0,6,1,6,4,4,
1,1,1,1,1,1,1,21,1,
6,5,3,5,1,6,3,21,5,
0,0,21,0,3,0,0,6,6,
5,0,21,6,4,4,0,6,5,
4,21,5,6,1,4,0,0,1,
1,21,5,6,5,4,1,0,0,
3,5,6,3,21,0,0,6,0,
1,3,1,6,1,1,1,5,21,
6,3,5,6,3,21,0,0,5,
0,0,0,0,0,0,0,0,0,
0,0,0,0,0,0,0,0,0,
0,0,0,0,0,0,0,0,0.
[layer]
type=Tile Layer 2
data=
234,234,234,234,234,234,0,0,234,
221,221,221,221,221,221,221,0,221,
231,231,231,231,231,231,0,0,231,
174,174,174,174,174,174,0,0,0,
127,0,0,0,0,0,0,0,7,
159,0,0,0,0,199,199,159,159,
147,147,147,184,0,0,9,147,147,
135,135,135,135,169,135,0,8,8,
118,118,118,118,118,118,118,118,0,
155,155,155,155,0,9,9,155,9,
170,170,170,170,170,170,0,170,170,
0,0,0,0,0,165,0,165,0,
150,150,150,150,150,150,0,150,0,
0,0,0,0,0,0,0,188,0,
165,165,165,165,165,165,165,165,0,
0,0,0,0,0,0,160,0,160,
139,139,139,139,139,139,139,139,0,
0,0,0,182,182,182,182,182,0,
168,168,168,168,168,168,168,0,0,
155,155,155,0,0,0,0,0,155,
142,142,0,0,142,142,142,142,142,
177,177,0,0,0,0,177,177,177,
163,0,0,0,0,0,163,163,163,
150,0,0,0,0,150,150,150,150,
137,137,137,137,0,0,0,137,137,
171,171,171,171,171,171,0,0,0,
151,151,151,151,151,151,151,151,0,
145,145,145,0,0,0,0,0,145,
133,133,133,0,0,133,133,0,0,
157,157,157,157,157,157,157,157,0,
153,153,153,153,0,153,153,0,0,
141,141,141,0,141,141,141,0,141,
122,122,122,0,122,122,122,122,122,
160,160,160,160,0,160,160,0,0,
0,0,0,148,0,0,0,0,0,
0,0,0,0,0,136,136,136,0,
0,0,124,0,0,0,124,0,124,
154,0,154,0,154,123,154,0,154,
142,0,142,7,0,7,0,0,142,
131,0,105,6,105,105,105,0,131,
96,0,96,6,120,96,96,6,6,
119,0,95,0,119,119,95,119,119,
5,5,86,5,108,5,5,0,86,
102,102,102,102,102,102,102,0,102,
0,0,0,0,106,0,0,106,106,
95,0,0,95,95,95,0,95,95,
94,0,94,94,94,94,0,0,94,
93,0,93,93,93,93,93,0,0,
92,92,92,92,0,0,0,92,0,
87,87,87,87,87,87,87,87,0,
90,90,90,90,90,0,0,0,90,
0,0,0,0,0,0,0,0,0,
0,0,0,0,0,0,0,0,0,
0,0,0,0,0,0,0,0,0.