[layer]
type=Tile Layer 1
data=
0,21,18,2,2,2,2,2,2,
0,21,0,1,1,1,1,1,1,
21,1,1,1,1,1,1,1,1,
2,2,21,2,2,2,2,2,18,
1,1,1,1,1,1,1,1,21,
0,21,0,1,1,1,1,1,0,
2,2,1,1,1,1,1,1,21,
20,21,0,0,0,0,0,2,0,
0,2,1,1,1,1,1,1,21,
0,1,0,0,0,0,0,21,0,
0,1,21,1,1,1,1,1,1,
0,1,21,1,1,1,1,1,0,
0,1,1,1,1,21,1,1,1,
0,1,1,1,1,21,2,2,1,
21,1,1,1,1,1,2,19,1,
0,0,0,21,0,0,2,2,1,
1,1,1,21,1,0,1,1,1,
1,1,1,0,1,0,1,21,0,
1,1,1,1,1,21,1,1,1,
1,1,1,21,1,0,1,1,1,
1,1,1,21,1,0,1,1,1,
1,0,1,1,1,1,1,21,0,
1,21,1,1,1,1,2,2,1,
1,21,1,1,1,1,2,24,1,
1,1,1,1,1,1,1,21,1,
0,21,0,0,1,0,0,0,0,
1,1,1,1,1,21,1,1,1,
1,1,1,1,1,21,1,1,1,
1,1,1,1,1,21,1,1,1,
1,0,21,0,0,0,2,2,1,
2,2,2,0,0,21,0,20,2,
2,2,1,21,1,1,2,2,1,
20,21,0,0,2,0,0,0,2,
2,2,1,21,1,1,1,1,1,
0,0,1,21,1,1,1,1,1,
1,21,1,1,1,1,1,1,1,
0,0,0,18,0,0,2,21,0,
1,1,1,1,1,21,2,19,1,
1,1,1,1,1,0,2,21,0,
0,0,21,1,1,1,1,1,1,
0,21,0,1,1,1,1,1,1,
0,21,0,0,1,1,1,1,1,
1,0,21,0,1,1,1,1,1,
1,21,0,0,1,1,0,1,1,
1,21,1,2,2,2,0,1,1,
0,0,1,2,19,2,0,21,0,
0,21,1,2,2,2,1,0,0,
2,21,2,2,2,2,2,0,18,
2,2,21,0,0,0,0,0,18,
1,1,0,1,0,0,21,1,0,
1,1,0,1,1,1,1,21,0,
1,1,21,0,0,1,1,0,0,
1,1,1,1,21,1,1,0,0,
1,1,1,1,1,0,21,1,0,
0,0,0,0,0,0,0,0,0,
0,0,0,0,0,0,0,0,0,
0,0,0,0,0,0,0,0,0.
[layer]
type=Tile Layer 2
data=
0,0,0,239,239,239,239,239,239,
0,0,0,237,237,237,237,237,237,
0,224,224,224,224,224,224,224,224,
164,164,0,164,164,164,164,164,0,
195,195,195,195,195,195,195,195,0,
0,0,0,189,189,189,189,189,0,
166,166,166,166,166,166,166,166,0,
0,0,0,0,0,0,0,159,0,
0,199,199,199,199,199,199,199,0,
0,184,0,0,0,0,0,0,0,
0,169,0,169,169,169,169,169,169,
0,155,0,155,155,155,155,155,0,
0,193,193,193,193,0,193,193,193,
0,179,179,179,179,0,179,179,179,
0,165,165,165,165,165,165,0,165,
0,0,0,0,0,0,150,150,150,
188,188,188,0,188,0,188,188,188,
174,174,174,0,174,0,174,0,0,
152,152,152,152,152,0,152,152,152,
146,146,146,0,146,0,146,146,146,
182,182,182,0,182,0,182,182,182,
168,0,168,168,168,168,168,0,0,
148,0,148,148,148,148,148,148,148,
142,0,142,142,142,142,142,0,142,
168,168,168,168,168,168,168,0,168,
0,0,0,0,163,0,0,0,0,
143,143,143,143,143,0,143,143,143,
131,131,131,131,131,0,131,131,131,
163,163,163,163,163,0,163,163,163,
158,0,0,0,0,0,158,158,158,
145,145,145,0,0,0,0,0,145,
127,127,127,0,127,127,127,127,127,
0,0,0,0,165,0,0,0,165,
146,146,146,0,146,146,146,146,146,
0,0,141,0,141,141,141,141,141,
122,0,122,122,122,122,122,122,122,
0,0,0,0,0,0,160,0,0,
148,148,148,148,148,0,148,0,148,
136,136,136,136,136,0,136,0,0,
0,0,0,124,124,124,124,124,124,
0,0,0,154,154,154,154,154,154,
0,0,0,0,142,142,142,142,142,
131,0,0,0,131,131,131,131,131,
120,0,0,0,120,120,0,120,120,
119,0,119,119,119,119,0,119,119,
0,0,108,108,0,108,0,0,0,
0,0,107,107,107,107,107,0,0,
106,0,106,106,106,106,106,0,0,
95,95,0,0,0,0,0,0,0,
94,94,0,94,0,0,0,94,0,
93,93,0,93,93,93,93,0,0,
92,92,0,0,0,92,92,0,0,
91,91,91,91,0,91,91,0,0,
90,90,90,90,90,0,0,90,0,
0,0,0,0,0,0,0,0,0,
0,0,0,0,0,0,0,0,0,
0,0,0,0,0,0,0,0,0.