[layer]
type=Tile Layer 1
data=
0,21,1,1,1,1,1,5,1,
0,0,0,21,0,0,0,1,1,
5,1,1,1,4,21,0,3,1,
1,4,6,1,6,0,21,0,0,
1,1,1,1,1,0,21,0,0,
1,1,1,0,21,0,1,1,5,
1,1,5,21,1,3,4,4,1,
1,1,1,21,0,5,1,1,1,
1,1,1,3,21,1,1,1,1,
0,0,0,21,1,0,3,0,1,
1,1,1,21,5,1,1,0,1,
0,0,6,0,0,21,0,0,0,
1,21,6,1,1,1,1,6,1,
1,21,1,0,1,3,1,1,4,
1,21,1,0,1,4,1,3,1,
0,21,1,0,0,0,0,0,0,
1,21,1,1,1,0,6,4,1,
1,0,0,0,1,0,0,21,0,
1,1,1,21,0,1,1,1,1,
1,1,4,1,21,0,1,1,1,
1,6,4,5,1,21,1,6,5,
4,1,1,1,1,21,0,0,0,
1,1,3,1,1,1,1,21,0,
4,0,0,0,0,21,0,0,6,
1,21,0,0,0,1,1,1,1,
1,6,1,4,21,0,0,0,6,
1,1,1,1,1,3,1,21,1,
1,21,1,1,1,0,3,6,1,
0,21,1,1,1,0,0,5,1,
0,21,1,1,1,1,0,3,1,
3,0,1,4,1,1,21,0,1,
6,0,0,0,1,1,1,21,0,
1,0,1,21,1,1,1,6,0,
0,1,5,1,21,1,6,1,1,
0,0,1,1,21,1,1,1,3,
3,21,0,0,0,0,1,1,1,
0,21,1,1,1,0,1,0,5,
5,1,3,4,1,21,1,0,1,
1,21,0,0,1,0,1,0,0,
1,0,6,1,1,21,1,0,1,
1,0,4,0,0,21,1,0,1,
1,21,4,0,1,1,1,0,5,
0,0,1,0,0,0,1,21,5,
1,1,1,21,1,1,1,1,1,
5,21,1,0,1,1,3,1,4,
5,1,0,0,0,21,1,0,0,
1,1,1,1,5,0,21,0,0,
1,1,6,1,1,1,4,1,21,
1,4,6,1,1,1,21,0,0,
1,1,1,21,0,0,0,4,3,
1,1,3,21,1,1,1,1,1,
0,0,0,0,0,0,0,0,0,
0,0,0,0,0,0,0,0,0,
0,0,0,0,0,0,0,0,0.
[layer]
type=Tile Layer 2
data=
0,0,234,234,234,234,234,234,234,
0,0,0,0,0,0,0,233,233,
231,231,231,231,231,0,0,231,231,
174,174,174,174,174,0,0,0,0,
159,159,159,159,159,0,0,0,0,
199,199,199,0,0,0,199,199,199,
175,175,175,0,175,175,175,175,175,
169,169,169,0,0,169,169,169,169,
147,147,147,147,0,147,147,147,147,
0,0,0,0,193,0,193,0,193,
179,179,179,0,179,179,179,0,179,
0,0,165,0,0,0,0,0,0,
143,0,143,143,143,143,143,143,143,
188,0,188,0,188,188,188,188,188,
174,0,174,0,174,174,174,174,174,
0,0,160,0,0,0,0,0,0,
146,0,146,146,146,0,146,146,146,
182,0,0,0,182,0,0,0,0,
168,168,168,0,0,168,168,168,168,
155,155,155,155,0,0,155,155,155,
135,135,135,135,135,0,135,135,135,
177,177,177,177,177,0,0,0,0,
163,163,163,163,163,163,163,0,0,
150,0,0,0,0,0,0,0,150,
137,0,0,0,0,137,137,137,137,
171,171,171,171,0,0,0,0,171,
151,151,151,151,151,151,151,0,151,
145,0,145,145,145,0,145,145,145,
0,0,133,133,133,0,0,133,133,
0,0,165,165,165,165,0,165,165,
153,0,153,153,153,153,0,0,153,
141,0,0,0,141,141,141,0,0,
128,0,128,0,128,128,128,128,0,
0,160,160,160,0,160,160,160,160,
0,0,148,148,0,148,148,148,148,
136,0,0,0,0,0,136,136,136,
0,0,124,124,124,0,124,0,124,
154,154,154,154,154,0,154,0,154,
142,0,0,0,142,0,142,0,0,
131,0,131,131,131,0,131,0,131,
120,0,120,0,0,0,120,0,120,
119,0,119,0,119,119,119,0,119,
0,0,108,0,0,0,108,0,108,
102,102,102,0,102,102,102,102,102,
106,0,106,0,106,106,106,106,106,
95,95,0,0,0,0,95,0,0,
94,94,94,94,94,0,0,0,0,
89,89,89,89,89,89,89,89,0,
92,92,92,92,92,92,0,0,0,
91,91,91,0,0,0,0,91,91,
86,86,86,0,86,86,86,86,86,
0,0,0,0,0,0,0,0,0,
0,0,0,0,0,0,0,0,0,
0,0,0,0,0,0,0,0,0.