[layer]
type=Tile Layer 1
data=
0,3,0,0,0,0,0,21,0,
1,1,21,1,1,1,3,1,0,
0,1,21,1,1,1,6,5,0,
1,1,4,1,1,1,1,1,21,
0,0,0,0,0,0,0,1,21,
1,1,0,5,21,3,3,1,0,
1,1,21,1,0,1,6,1,0,
1,6,1,1,1,3,1,1,21,
1,5,0,0,0,21,0,1,0,
0,0,21,0,1,1,0,1,4,
0,0,1,1,3,1,21,6,3,
0,21,1,1,1,1,0,0,1,
0,1,4,1,1,1,1,0,21,
0,21,1,1,1,3,3,5,0,
0,0,1,1,1,1,1,21,0,
0,0,0,1,1,6,4,21,0,
1,1,0,0,0,21,0,0,1,
1,1,1,3,1,0,0,21,0,
1,6,5,1,1,6,1,21,1,
1,4,1,0,1,0,21,0,0,
1,1,5,21,1,0,1,1,1,
0,0,0,21,3,0,3,1,4,
1,1,1,6,1,21,1,1,1,
0,0,1,21,0,0,1,1,1,
1,4,1,21,1,6,1,1,1,
0,21,0,0,1,0,0,0,0,
1,21,3,1,1,1,1,1,6,
1,6,21,0,0,0,0,1,1,
1,1,0,0,21,3,0,0,0,
1,1,6,1,1,21,1,5,0,
1,5,1,6,5,21,1,1,0,
1,1,1,0,21,4,1,1,0,
0,0,0,0,1,1,0,1,21,
0,0,0,0,0,0,0,0,0,
0,0,0,0,0,0,0,0,0,
0,0,0,0,0,0,0,0,0.
[layer]
type=Tile Layer 2
data=
0,171,0,0,0,0,0,0,0,
170,170,0,170,170,170,170,170,0,
0,168,0,168,168,168,168,168,0,
140,140,140,140,140,140,140,140,0,
0,0,0,0,0,0,0,135,0,
124,124,0,124,0,124,124,124,0,
113,113,0,113,0,113,113,113,0,
134,134,134,134,134,134,134,134,0,
130,130,0,0,0,0,0,130,0,
0,0,0,0,119,119,0,119,119,
0,0,109,109,109,109,0,109,109,
0,0,135,135,135,135,0,0,135,
0,125,125,125,125,125,125,0,0,
0,0,115,115,115,115,115,115,0,
0,0,104,104,104,104,104,0,0,
0,0,0,130,130,130,130,0,0,
120,120,0,0,0,0,0,0,120,
110,110,110,110,110,0,0,0,0,
95,95,95,95,95,95,95,0,95,
124,124,124,0,124,0,0,0,0,
114,114,114,0,114,0,114,114,114,
0,0,0,0,105,0,105,105,105,
91,91,91,91,91,0,91,91,91,
0,0,95,0,0,0,95,95,95,
82,82,82,0,82,82,82,82,82,
0,0,0,0,85,0,0,0,0,
80,0,80,80,80,80,80,80,80,
75,75,0,0,0,0,0,75,75,
74,74,0,0,0,74,0,0,0,
73,73,73,73,73,0,73,73,0,
72,72,72,72,72,0,72,72,0,
71,71,71,0,0,71,71,71,0,
0,0,0,0,70,70,0,70,0,
0,0,0,0,0,0,0,0,0,
0,0,0,0,0,0,0,0,0,
0,0,0,0,0,0,0,0,0.