[layer]
type=Tile Layer 1
data=
1,1,1,0,1,1,1,21,0,
1,1,1,0,0,0,0,21,0,
1,1,1,1,1,1,0,21,0,
1,1,1,0,1,1,1,21,0,
1,1,1,21,0,1,1,1,0,
1,1,1,1,21,0,1,1,0,
1,1,1,1,1,0,0,21,0,
1,1,1,1,1,21,0,0,0,
1,1,1,1,1,21,0,1,1,
1,1,21,1,1,1,1,1,1,
0,21,0,0,0,1,0,1,1,
1,1,21,1,1,1,0,1,1,
0,1,0,21,0,0,0,0,0,
0,1,0,1,1,1,1,1,21,
0,1,0,1,1,1,1,1,21,
0,1,1,1,1,1,1,1,21,
0,0,21,0,0,1,0,0,0,
0,1,1,1,21,1,0,1,1,
1,1,1,1,21,0,1,1,1,
1,1,1,1,1,0,21,0,0,
1,1,1,1,1,1,1,21,0,
1,1,1,0,0,21,0,0,1,
1,1,21,0,1,1,1,1,1,
1,1,21,0,0,0,1,1,1,
1,1,1,1,1,0,0,21,0,
1,1,1,1,1,21,0,0,0,
1,1,1,1,1,21,1,1,1,
1,1,1,1,1,1,0,21,0,
1,1,1,1,1,1,21,0,0,
1,1,1,1,1,1,21,0,0,
1,1,1,1,1,1,1,1,21,
1,1,21,0,0,0,0,0,0,
1,1,21,1,1,1,1,1,1,
1,1,0,0,21,0,0,0,0,
1,1,1,1,1,1,1,21,0,
1,1,1,1,1,1,1,21,1,
1,1,1,21,1,1,1,0,1,
0,21,1,0,1,1,1,0,1,
1,1,1,21,1,1,1,0,1,
0,0,0,0,21,0,1,0,0,
1,1,1,1,1,21,1,1,1,
1,0,21,0,1,0,1,1,1,
1,0,1,21,1,0,1,1,1,
1,21,1,0,1,0,0,0,0,
1,21,1,1,1,1,1,1,1,
0,0,21,0,1,1,0,1,1,
0,0,1,1,1,1,21,1,1,
0,21,1,1,1,1,0,0,1,
0,1,1,1,1,1,1,21,0,
0,21,1,1,1,1,1,1,0,
0,0,1,1,1,1,1,0,21,
0,0,0,0,0,0,0,0,0,
0,0,0,0,0,0,0,0,0,
0,0,0,0,0,0,0,0,0.
[layer]
type=Tile Layer 2
data=
234,234,234,0,234,234,234,0,0,
233,233,233,0,0,0,0,0,0,
231,231,231,231,231,231,0,0,0,
174,174,174,0,174,174,174,0,0,
159,159,159,0,0,159,159,159,0,
199,199,199,199,0,0,199,199,0,
184,184,184,184,184,0,0,0,0,
169,169,169,169,169,0,0,0,0,
155,155,155,155,155,0,0,155,155,
184,184,0,184,184,184,184,184,184,
0,0,0,0,0,179,0,179,179,
165,165,0,165,165,165,0,165,165,
0,150,0,0,0,0,0,0,0,
0,188,0,188,188,188,188,188,0,
0,174,0,174,174,174,174,174,0,
0,160,160,160,160,160,160,160,0,
0,0,0,0,0,146,0,0,0,
0,182,182,182,0,182,0,182,182,
168,168,168,168,0,0,168,168,168,
155,155,155,155,155,0,0,0,0,
142,142,142,142,142,142,142,0,0,
177,177,177,0,0,0,0,0,177,
163,163,0,0,163,163,163,163,163,
150,150,0,0,0,0,150,150,150,
137,137,137,137,137,0,0,0,0,
171,171,171,171,171,0,0,0,0,
151,151,151,151,151,0,151,151,151,
145,145,145,145,145,145,0,0,0,
133,133,133,133,133,133,0,0,0,
165,165,165,165,165,165,0,0,0,
146,146,146,146,146,146,146,146,0,
141,141,0,0,0,0,0,0,0,
122,122,0,122,122,122,122,122,122,
160,160,0,0,0,0,0,0,0,
148,148,148,148,148,148,148,0,0,
129,129,129,129,129,129,129,0,129,
124,124,124,0,124,124,124,0,124,
0,0,154,0,154,154,154,0,154,
142,142,142,0,142,142,142,0,142,
0,0,0,0,0,0,131,0,0,
114,114,114,114,114,0,114,114,114,
119,0,0,0,119,0,119,119,119,
108,0,108,0,108,0,108,108,108,
107,0,107,0,107,0,0,0,0,
101,0,101,101,101,101,101,101,101,
0,0,0,0,95,95,0,95,95,
0,0,94,94,94,94,0,94,94,
0,0,93,93,93,93,0,0,93,
0,92,92,92,92,92,92,0,0,
0,0,91,91,91,91,91,91,0,
0,0,90,90,90,90,90,0,0,
0,0,0,0,0,0,0,0,0,
0,0,0,0,0,0,0,0,0,
0,0,0,0,0,0,0,0,0.