[layer]
type=Tile Layer 1
data=
2,2,21,2,9,2,0,2,2,
0,0,0,2,2,0,21,1,1,
2,2,2,2,21,2,2,7,2,
0,2,18,2,2,9,2,2,21,
1,1,1,3,21,2,2,2,4,
0,0,0,1,21,2,10,2,0,
2,2,2,2,2,0,2,21,18,
1,1,0,1,1,1,21,6,0,
0,2,0,4,1,1,21,1,0,
19,2,21,2,2,2,1,6,1,
0,9,2,2,19,2,2,21,2,
0,2,21,2,2,2,1,2,2,
0,2,21,2,2,2,2,2,20,
0,1,1,1,4,5,1,2,21,
0,7,21,2,2,2,2,2,2,
3,1,6,1,1,6,2,21,1,
0,0,4,0,21,0,2,24,1,
1,0,1,0,1,21,1,0,1,
0,0,6,21,5,0,0,2,1,
1,1,1,21,1,1,2,8,1,
2,2,2,21,2,0,2,2,7,
7,2,2,2,2,21,2,0,2,
0,0,0,0,3,0,1,0,21,
5,2,2,21,1,0,1,1,1,
1,19,2,1,1,1,21,0,0,
1,2,2,0,0,0,21,0,0,
0,0,0,21,1,4,1,6,1,
0,21,1,1,5,5,6,1,1,
2,21,0,1,1,1,1,1,1,
10,2,0,0,21,0,2,4,1,
2,2,1,1,2,24,21,0,1,
1,6,4,0,0,0,21,0,1,
2,2,1,21,1,1,1,5,1,
24,0,0,21,5,6,1,1,1,
0,0,1,0,21,1,3,1,1,
2,21,0,2,0,0,0,1,1,
8,2,21,20,0,2,0,0,0,
2,2,2,2,21,2,2,1,0,
2,2,2,2,21,9,2,2,0,
0,0,0,0,0,0,0,0,0,
0,0,0,0,0,0,0,0,0,
0,0,0,0,0,0,0,0,0.
[layer]
type=Tile Layer 2
data=
197,197,0,197,197,197,0,197,197,
0,0,0,195,195,0,0,195,195,
194,194,194,194,0,194,194,194,194,
0,146,0,146,146,146,146,146,0,
127,127,127,127,0,127,127,127,127,
0,0,0,166,0,166,166,166,0,
153,153,153,153,153,0,153,0,0,
141,141,0,141,141,141,0,141,0,
0,129,0,129,129,129,0,129,0,
0,161,0,161,161,161,161,161,161,
0,148,148,148,0,148,148,0,148,
0,136,0,136,136,136,136,136,136,
0,124,0,124,124,124,124,124,0,
0,155,155,155,155,155,155,155,0,
0,143,0,143,143,143,143,143,143,
125,125,125,125,125,125,125,0,125,
0,0,120,0,0,0,120,0,120,
149,0,149,0,149,0,149,0,149,
0,0,138,0,138,0,0,138,138,
127,127,127,0,127,127,127,127,127,
115,115,115,0,115,0,115,115,115,
144,144,144,144,144,0,144,0,144,
0,0,0,0,133,0,133,0,0,
122,122,122,0,122,0,122,122,122,
111,0,111,111,111,111,0,0,0,
138,138,138,0,0,0,0,0,0,
0,0,0,0,127,127,127,127,127,
0,0,117,117,117,117,117,117,117,
107,0,0,107,107,107,107,107,107,
106,106,0,0,0,0,106,106,106,
96,96,96,96,96,0,0,0,96,
95,95,95,0,0,0,0,0,95,
89,89,89,0,89,89,89,89,89,
0,0,0,0,84,84,84,84,84,
0,0,83,0,0,83,83,83,83,
82,0,0,82,0,0,0,82,82,
81,81,0,0,0,81,0,0,0,
80,80,80,80,0,80,80,80,0,
79,79,79,79,0,79,79,79,0,
0,0,0,0,0,0,0,0,0,
0,0,0,0,0,0,0,0,0,
0,0,0,0,0,0,0,0,0.