[layer]
type=Tile Layer 1
data=
1,6,1,4,21,0,0,1,0,
1,1,1,5,21,8,2,1,0,
0,2,21,1,2,2,0,0,0,
10,2,21,0,0,0,0,0,0,
2,2,1,1,1,1,1,1,21,
3,1,4,0,21,0,0,1,0,
1,0,0,21,1,6,1,1,0,
0,0,2,2,2,0,21,0,0,
0,2,2,9,2,2,2,21,2,
4,1,2,2,0,21,3,0,1,
2,2,1,1,1,0,21,0,6,
8,2,1,1,1,21,0,2,2,
2,0,0,0,0,0,21,2,10,
5,21,1,6,1,1,1,0,2,
3,21,1,1,1,1,1,0,0,
1,21,1,1,1,1,3,0,1,
1,0,4,0,0,21,1,0,0,
1,21,6,0,1,1,4,1,1,
1,21,1,0,1,3,1,1,1,
2,21,2,7,2,2,2,2,2,
1,0,21,0,1,1,1,6,4,
4,1,5,1,1,1,21,1,1,
0,1,1,1,1,4,0,0,21,
1,1,1,3,1,3,21,1,1,
0,1,1,1,3,1,21,1,1,
0,2,2,2,2,2,21,7,2,
0,21,0,0,0,5,0,0,0,
1,1,1,1,21,1,0,1,1,
0,1,5,1,0,1,21,1,4,
0,3,1,5,1,1,21,3,1,
0,1,1,1,0,2,2,3,21,
0,2,2,2,2,9,2,2,21,
9,2,2,2,2,2,21,2,0,
2,2,2,8,2,21,1,3,1,
0,2,8,2,2,21,1,1,6,
0,7,2,2,21,2,2,2,2,
0,0,21,10,2,1,0,6,3,
0,1,2,2,0,1,21,2,1,
0,0,0,0,0,21,2,8,1,
1,0,6,1,0,21,2,0,1,
1,4,1,1,1,1,1,21,5,
0,0,0,0,21,0,5,0,1,
1,1,1,1,1,21,1,4,1,
1,0,0,6,4,6,21,0,1,
1,1,21,1,1,1,3,1,1,
0,0,0,0,0,0,0,0,0,
0,0,0,0,0,0,0,0,0,
0,0,0,0,0,0,0,0,0.
[layer]
type=Tile Layer 2
data=
208,208,208,208,0,0,0,208,0,
206,206,206,206,0,206,206,206,0,
0,204,0,204,204,204,0,0,0,
178,178,0,0,0,0,0,0,0,
157,157,157,157,157,157,157,157,0,
152,152,152,0,0,0,0,152,0,
138,0,0,0,138,138,138,138,0,
0,0,173,173,173,0,0,0,0,
0,160,160,160,160,160,160,0,160,
147,147,147,147,0,0,147,0,147,
134,134,134,134,134,0,0,0,134,
167,167,167,167,167,0,0,167,167,
154,0,0,0,0,0,0,154,154,
142,0,142,142,142,142,142,0,142,
130,0,130,130,130,130,130,0,0,
162,0,162,162,162,162,162,0,162,
149,0,149,0,0,0,149,0,0,
137,0,137,0,137,137,137,137,137,
125,0,125,0,125,125,125,125,125,
156,0,156,156,156,156,156,156,156,
144,0,0,0,144,144,144,144,144,
126,126,126,126,126,126,0,126,126,
0,121,121,121,121,121,0,0,0,
143,143,143,143,143,143,0,143,143,
0,139,139,139,139,139,0,139,139,
0,128,128,128,128,128,0,128,128,
0,0,0,0,0,116,0,0,0,
145,145,145,145,0,145,0,145,145,
0,134,134,134,0,134,0,134,134,
0,123,123,123,123,123,0,123,123,
0,112,112,112,0,112,112,112,0,
0,139,139,139,139,139,139,139,0,
128,128,128,128,128,128,0,128,0,
118,118,118,118,118,0,118,118,118,
0,108,108,108,108,0,108,108,108,
0,107,107,107,0,107,107,107,107,
0,0,0,97,97,97,0,97,97,
0,96,96,96,0,96,0,96,96,
0,0,0,0,0,0,95,95,95,
85,0,85,85,0,0,85,0,85,
80,80,80,80,80,80,80,0,80,
0,0,0,0,0,0,83,0,83,
78,78,78,78,78,0,78,78,78,
81,0,0,81,81,81,0,0,81,
77,77,0,77,77,77,77,77,77,
0,0,0,0,0,0,0,0,0,
0,0,0,0,0,0,0,0,0,
0,0,0,0,0,0,0,0,0.