[layer]
type=Tile Layer 1
data=
1,1,1,5,1,21,0,1,6,
0,0,0,21,0,0,0,1,1,
0,0,0,0,0,21,4,1,1,
1,1,1,6,21,0,1,1,5,
1,1,1,4,21,1,1,5,1,
1,1,1,4,21,1,1,1,6,
1,0,0,0,0,0,0,21,0,
1,21,1,1,1,1,4,6,5,
1,0,0,0,1,21,1,0,0,
1,5,1,0,5,21,1,0,1,
1,1,1,21,1,0,1,0,1,
1,6,3,0,1,21,1,0,1,
0,0,1,0,21,0,3,0,1,
5,1,1,1,1,21,4,0,1,
0,0,1,0,1,0,1,0,21,
1,5,1,1,1,1,21,0,1,
6,1,1,1,4,1,21,1,1,
1,6,4,1,1,1,0,21,0,
1,1,1,1,1,6,1,1,21,
1,1,0,21,0,0,0,0,0,
3,3,0,0,21,0,1,1,5,
1,1,1,1,1,21,0,0,4,
1,1,0,0,0,0,21,0,1,
5,1,21,1,4,1,3,1,1,
1,1,1,0,21,0,0,0,0,
1,1,21,0,5,0,0,0,0,
1,1,0,3,1,6,0,21,0,
4,3,21,0,0,0,0,1,1,
1,1,1,1,0,0,0,21,0,
1,1,4,1,1,1,5,21,0,
1,3,1,6,1,1,0,21,0,
1,4,1,1,1,1,21,0,0,
1,1,1,1,4,6,1,21,0,
5,21,1,1,1,1,1,0,1,
1,0,1,0,21,0,1,0,4,
1,21,1,0,1,1,3,0,5,
0,0,6,0,1,21,0,0,1,
5,0,1,21,1,0,1,0,4,
0,0,1,0,1,21,1,0,1,
1,0,1,21,1,1,1,0,4,
1,0,6,21,1,1,1,0,1,
6,21,1,0,5,1,4,1,1,
1,3,0,0,0,0,21,0,0,
1,0,0,21,0,1,1,1,1,
1,0,1,6,21,0,5,1,1,
1,1,21,5,1,0,1,4,1,
1,1,21,0,0,0,0,4,3,
1,5,1,1,1,1,1,21,1,
0,0,0,0,0,0,0,0,0,
0,0,0,0,0,0,0,0,0,
0,0,0,0,0,0,0,0,0.
[layer]
type=Tile Layer 2
data=
228,228,228,228,228,0,0,228,228,
0,0,0,0,0,0,0,227,227,
0,0,0,0,0,0,225,225,225,
183,183,183,183,0,0,183,183,183,
160,160,160,160,0,160,160,160,160,
146,146,146,146,0,146,146,146,146,
192,0,0,0,0,0,0,0,0,
169,0,169,169,169,169,169,169,169,
164,0,0,0,164,0,164,0,0,
149,149,149,0,149,0,149,0,149,
187,187,187,0,187,0,187,0,187,
173,173,173,0,173,0,173,0,173,
0,0,159,0,0,0,159,0,159,
145,145,145,145,145,0,145,0,145,
0,0,181,0,181,0,181,0,0,
167,167,167,167,167,167,0,0,167,
147,147,147,147,147,147,0,147,147,
141,141,141,141,141,141,0,0,0,
167,167,167,167,167,167,167,167,0,
162,162,0,0,0,0,0,0,0,
149,149,0,0,0,0,149,149,149,
136,136,136,136,136,0,0,0,136,
170,170,0,0,0,0,0,0,170,
150,150,0,150,150,150,150,150,150,
144,144,144,0,0,0,0,0,0,
132,132,0,0,132,0,0,0,0,
164,164,0,164,164,164,0,0,0,
152,152,0,0,0,0,0,152,152,
140,140,140,140,0,0,0,0,0,
127,127,127,127,127,127,127,0,0,
159,159,159,159,159,159,0,0,0,
147,147,147,147,147,147,0,0,0,
135,135,135,135,135,135,135,0,0,
123,0,123,123,123,123,123,0,123,
153,0,153,0,0,0,153,0,153,
141,0,141,0,141,141,141,0,141,
0,0,130,0,130,0,0,0,130,
119,0,119,0,119,0,119,0,119,
0,0,118,0,118,0,118,0,118,
107,0,107,0,107,107,107,0,107,
106,0,106,0,106,106,106,0,106,
105,0,105,0,105,105,105,105,105,
94,94,0,0,0,0,0,0,0,
93,0,0,0,0,93,93,93,93,
92,0,92,92,0,0,92,92,92,
91,91,0,91,91,0,91,91,91,
90,90,0,0,0,0,0,90,90,
85,85,85,85,85,85,85,0,85,
0,0,0,0,0,0,0,0,0,
0,0,0,0,0,0,0,0,0,
0,0,0,0,0,0,0,0,0.