[layer]
type=Tile Layer 1
data=
1,1,1,0,1,0,21,0,1,
1,1,1,21,1,1,1,0,1,
0,21,0,0,1,0,0,0,1,
1,1,1,1,1,21,1,1,1,
1,0,0,21,0,0,1,1,1,
1,21,1,1,1,1,1,1,1,
0,1,1,1,1,1,21,1,1,
21,1,1,1,1,1,1,1,1,
0,0,1,21,0,1,0,1,0,
21,1,1,1,1,1,1,1,1,
0,1,1,1,21,0,0,0,0,
0,1,1,1,21,1,1,1,1,
0,0,0,1,0,0,21,1,0,
1,1,21,1,1,1,1,1,0,
0,1,21,1,1,1,1,1,0,
1,21,0,0,1,0,0,0,1,
1,21,1,0,1,1,1,1,1,
0,0,1,0,1,0,0,21,1,
1,1,1,21,1,0,1,0,1,
0,0,1,21,0,0,1,0,1,
1,21,1,1,1,1,1,0,1,
0,0,0,0,0,0,1,21,0,
1,1,1,1,1,21,1,1,1,
0,0,1,0,0,21,1,0,1,
1,0,21,1,1,1,1,0,0,
1,1,0,21,0,1,1,0,0,
1,1,1,1,21,1,1,0,0,
1,1,1,0,21,1,1,1,0,
0,0,21,0,1,1,1,1,1,
1,0,21,1,1,1,1,0,1,
1,0,1,1,1,1,21,0,1,
1,0,0,1,1,21,0,1,1,
1,1,0,0,21,0,1,1,1,
0,1,1,21,0,1,1,1,1,
0,0,0,1,21,1,1,1,1,
1,1,21,0,0,0,1,1,1,
1,0,21,1,1,0,1,1,1,
1,21,1,1,1,0,0,1,1,
1,1,1,21,0,0,1,0,0,
0,0,0,0,0,0,0,0,0,
0,0,0,0,0,0,0,0,0,
0,0,0,0,0,0,0,0,0.
[layer]
type=Tile Layer 2
data=
198,198,198,0,198,0,0,0,198,
196,196,196,0,196,196,196,0,196,
0,0,0,0,195,0,0,0,195,
140,140,140,140,140,0,140,140,140,
134,0,0,0,0,0,134,134,134,
159,0,159,159,159,159,159,159,159,
0,154,154,154,154,154,0,154,154,
0,135,135,135,135,135,135,135,135,
0,0,130,0,0,130,0,130,0,
0,154,154,154,154,154,154,154,154,
0,149,149,149,0,0,0,0,0,
0,137,137,137,0,137,137,137,137,
0,0,0,125,0,0,0,125,0,
156,156,0,156,156,156,156,156,0,
0,144,0,144,144,144,144,144,0,
132,0,0,0,132,0,0,0,132,
121,0,121,0,121,121,121,121,121,
0,0,150,0,150,0,0,0,150,
139,139,139,0,139,0,139,0,139,
0,0,128,0,0,0,128,0,128,
116,0,116,116,116,116,116,0,116,
0,0,0,0,0,0,145,0,0,
127,127,127,127,127,0,127,127,127,
0,0,123,0,0,0,123,0,123,
112,0,0,112,112,112,112,0,0,
139,139,0,0,0,139,139,0,0,
128,128,128,128,0,128,128,0,0,
118,118,118,0,0,118,118,118,0,
0,0,0,0,108,108,108,108,108,
107,0,0,107,107,107,107,0,107,
97,0,97,97,97,97,0,0,97,
96,0,0,96,96,0,0,96,96,
95,95,0,0,0,0,95,95,95,
0,85,85,0,0,85,85,85,85,
0,0,0,84,0,84,84,84,84,
83,83,0,0,0,0,83,83,83,
82,0,0,82,82,0,82,82,82,
81,0,81,81,81,0,0,81,81,
80,80,80,0,0,0,80,0,0,
0,0,0,0,0,0,0,0,0,
0,0,0,0,0,0,0,0,0,
0,0,0,0,0,0,0,0,0.