[layer]
type=Tile Layer 1
data=
1,1,1,21,0,1,1,1,1,
0,0,0,1,1,21,1,1,1,
0,0,21,0,0,0,1,1,1,
1,1,1,1,1,21,1,0,1,
1,1,1,1,1,21,1,0,1,
0,21,0,0,1,0,1,0,1,
1,1,1,21,1,1,1,0,1,
1,21,0,0,0,0,1,0,0,
1,1,21,1,1,1,1,1,1,
1,1,21,1,1,1,1,1,1,
1,1,0,0,0,21,0,0,0,
1,1,21,1,1,1,1,1,1,
0,0,1,0,1,21,0,0,0,
1,0,1,21,1,0,1,1,1,
1,0,1,0,21,0,1,0,0,
1,21,1,1,1,1,1,0,1,
1,21,1,0,0,0,0,0,1,
1,21,1,1,1,1,1,0,1,
1,0,0,0,0,21,1,0,1,
1,1,1,1,1,21,1,0,1,
1,0,0,0,1,0,21,0,1,
1,1,1,21,1,1,1,1,1,
1,1,1,0,21,0,1,1,1,
1,1,1,1,1,21,1,1,1,
0,0,0,0,1,0,0,0,21,
1,1,1,1,1,1,1,21,1,
0,0,0,0,0,21,1,0,1,
0,0,0,0,0,0,0,0,0,
0,0,0,0,0,0,0,0,0,
0,0,0,0,0,0,0,0,0.
[layer]
type=Tile Layer 2
data=
160,160,160,0,0,160,160,160,160,
0,0,0,158,158,0,158,158,158,
0,0,0,0,0,0,157,157,157,
117,117,117,117,117,0,117,0,117,
107,107,107,107,107,0,107,0,107,
0,0,0,0,133,0,133,0,133,
123,123,123,0,123,123,123,0,123,
113,0,0,0,0,0,113,0,0,
98,98,0,98,98,98,98,98,98,
122,122,0,122,122,122,122,122,122,
118,118,0,0,0,0,0,0,0,
103,103,0,103,103,103,103,103,103,
0,0,98,0,98,0,0,0,0,
122,0,122,0,122,0,122,122,122,
112,0,112,0,0,0,112,0,0,
103,0,103,103,103,103,103,0,103,
94,0,94,0,0,0,0,0,94,
93,0,93,93,93,93,93,0,93,
84,0,0,0,0,0,84,0,84,
83,83,83,83,83,0,83,0,83,
82,0,0,0,82,0,0,0,82,
69,69,69,0,69,69,69,69,69,
72,72,72,0,0,0,72,72,72,
68,68,68,68,68,0,68,68,68,
0,0,0,0,70,0,0,0,0,
66,66,66,66,66,66,66,0,66,
0,0,0,0,0,0,68,0,68,
0,0,0,0,0,0,0,0,0,
0,0,0,0,0,0,0,0,0,
0,0,0,0,0,0,0,0,0.