[layer]
type=Tile Layer 1
data=
0,0,0,0,21,1,1,1,1,
1,0,21,0,0,5,1,4,1,
5,21,1,1,3,1,1,1,1,
1,1,1,1,1,0,21,0,0,
4,6,1,4,1,0,21,1,0,
1,1,1,0,0,1,21,3,0,
1,1,1,0,1,6,21,0,0,
1,4,6,0,1,3,1,21,0,
0,1,0,0,0,0,1,1,21,
0,0,1,1,1,21,0,0,0,
1,21,0,1,5,2,2,2,0,
1,2,21,6,1,2,8,2,0,
2,9,21,0,2,2,2,2,2,
1,2,2,21,1,4,1,1,1,
1,1,6,0,21,0,0,0,0,
1,1,1,1,1,21,0,0,0,
0,0,2,21,0,0,1,1,1,
21,2,8,2,5,1,1,3,6,
0,21,2,2,6,1,1,6,1,
4,21,0,0,1,5,1,1,1,
1,1,1,21,1,1,5,1,1,
4,1,2,2,21,0,0,0,1,
2,2,2,9,2,2,2,21,2,
9,2,2,2,21,2,2,2,0,
2,2,1,1,21,1,1,1,0,
1,4,1,5,21,4,1,1,0,
6,1,1,1,21,1,5,1,0,
2,2,4,0,0,21,0,1,0,
9,2,2,21,2,2,2,2,0,
2,21,1,3,1,1,1,0,1,
5,2,2,21,1,1,1,6,3,
1,10,21,0,1,1,1,1,1,
1,10,0,0,0,21,0,0,0,
1,2,2,1,1,1,5,21,0,
5,0,21,0,0,0,0,0,1,
0,21,6,3,1,1,1,1,1,
21,1,1,6,4,1,1,2,2,
0,0,0,0,0,21,0,2,10,
2,7,2,2,2,2,21,2,2,
0,2,2,2,2,21,7,2,2,
1,3,1,1,1,21,5,1,1,
0,0,0,0,0,21,1,4,1,
1,1,1,1,1,21,5,1,6,
4,1,1,1,1,0,1,21,0,
5,4,1,1,6,21,1,1,1,
0,21,1,0,0,2,2,1,4,
21,2,2,2,2,9,2,2,2,
0,21,5,1,2,2,10,2,1,
1,1,1,5,4,21,2,0,2,
1,1,1,0,0,21,5,2,8,
6,1,1,21,1,1,1,2,2,
0,0,1,0,0,21,0,0,8,
1,21,1,1,3,2,2,2,2,
5,21,0,0,1,0,10,2,1,
0,0,0,0,0,0,0,0,0,
0,0,0,0,0,0,0,0,0,
0,0,0,0,0,0,0,0,0.
[layer]
type=Tile Layer 2
data=
0,0,0,0,0,239,239,239,239,
237,0,0,0,0,237,237,237,237,
224,0,224,224,224,224,224,224,224,
164,164,164,164,164,0,0,0,0,
205,205,205,205,205,0,0,205,0,
189,189,189,0,0,189,0,189,0,
174,174,174,0,174,174,0,0,0,
159,159,159,0,159,159,159,0,0,
0,199,0,0,0,0,199,199,0,
0,0,184,184,184,0,0,0,0,
169,0,0,169,169,169,169,169,0,
155,155,0,155,155,155,155,155,0,
193,193,0,0,193,193,193,193,193,
170,170,170,0,170,170,170,170,170,
165,165,165,0,0,0,0,0,0,
150,150,150,150,150,0,0,0,0,
0,0,188,0,0,0,188,188,188,
0,174,174,174,174,174,174,174,174,
0,0,160,160,160,160,160,160,160,
146,0,0,0,146,146,146,146,146,
173,173,173,0,173,173,173,173,173,
168,168,168,168,0,0,0,0,168,
155,155,155,155,155,155,155,0,155,
142,142,142,142,0,142,142,142,0,
177,177,177,177,0,177,177,177,0,
163,163,163,163,0,163,163,163,0,
150,150,150,150,0,150,150,150,0,
137,137,137,0,0,0,0,137,0,
171,171,171,0,171,171,171,171,0,
158,0,158,158,158,158,158,0,158,
138,138,138,0,138,138,138,138,138,
133,133,0,0,133,133,133,133,133,
165,165,0,0,0,0,0,0,0,
153,153,153,153,153,153,153,0,0,
141,0,0,0,0,0,0,0,141,
0,0,128,128,128,128,128,128,128,
0,152,152,152,152,152,152,152,152,
0,0,0,0,0,0,0,148,148,
136,136,136,136,136,136,0,136,136,
0,124,124,124,124,0,124,124,124,
147,147,147,147,147,0,147,147,147,
0,0,0,0,0,0,142,142,142,
125,125,125,125,125,0,125,125,125,
120,120,120,120,120,0,120,0,0,
113,113,113,113,113,0,113,113,113,
0,0,108,0,0,108,108,108,108,
0,107,107,107,107,107,107,107,107,
0,0,106,106,106,106,106,106,106,
95,95,95,95,95,0,95,0,95,
94,94,94,0,0,0,94,94,94,
89,89,89,0,89,89,89,89,89,
0,0,92,0,0,0,0,0,92,
87,0,87,87,87,87,87,87,87,
90,0,0,0,90,0,90,90,90,
0,0,0,0,0,0,0,0,0,
0,0,0,0,0,0,0,0,0,
0,0,0,0,0,0,0,0,0.