[layer]
type=Tile Layer 1
data=
3,21,5,0,1,0,5,3,1,
3,21,1,0,5,1,5,6,6,
0,0,6,21,0,0,0,0,0,
4,21,3,6,3,0,6,6,6,
1,0,0,21,4,0,1,1,3,
4,1,1,21,4,3,6,4,3,
3,5,4,21,0,0,0,0,1,
1,5,4,4,3,21,5,3,1,
0,21,0,0,5,0,3,0,1,
3,6,3,4,1,21,0,0,4,
6,3,1,6,3,0,0,21,0,
6,1,6,4,4,21,1,4,0,
1,5,1,0,21,0,5,6,0,
4,21,4,6,1,4,1,5,1,
4,1,21,5,5,6,1,6,1,
6,6,6,21,1,4,1,3,1,
3,1,3,0,0,3,1,21,0,
4,6,1,4,21,1,1,1,0,
5,1,21,4,0,1,5,1,0,
0,21,0,6,0,0,0,5,0,
4,1,21,6,0,4,6,6,5,
0,0,21,3,0,5,3,6,3,
5,5,3,5,21,3,1,6,1,
0,21,0,0,0,1,6,6,1,
6,6,3,5,21,6,5,5,3,
0,0,0,1,21,5,0,0,0,
6,3,21,1,1,3,1,6,5,
4,4,4,3,6,0,21,0,1,
3,4,1,1,1,21,6,0,4,
6,6,3,1,3,21,6,0,0,
6,5,4,1,0,0,21,0,0,
0,0,0,0,21,6,0,0,4,
0,0,6,5,1,1,5,21,4,
0,0,0,0,0,0,0,0,0,
0,0,0,0,0,0,0,0,0,
0,0,0,0,0,0,0,0,0.
[layer]
type=Tile Layer 2
data=
170,0,170,0,170,0,170,170,170,
169,0,169,0,169,169,169,169,169,
0,0,167,0,0,0,0,0,0,
146,0,146,146,146,0,146,146,146,
134,0,0,0,134,0,134,134,134,
117,117,117,0,117,117,117,117,117,
112,112,112,0,0,0,0,0,112,
133,133,133,133,133,0,133,133,133,
0,0,0,0,129,0,129,0,129,
118,118,118,118,118,0,0,0,118,
108,108,108,108,108,0,0,0,0,
134,134,134,134,134,0,134,134,0,
124,124,6,0,0,0,99,124,0,
114,0,91,91,114,91,5,91,114,
83,5,0,83,83,83,5,83,83,
129,103,103,0,129,103,6,103,129,
119,119,95,0,0,119,5,0,0,
109,87,87,87,0,5,5,5,0,
99,99,0,99,0,99,99,99,0,
0,0,0,123,0,0,0,123,0,
113,113,0,113,0,113,113,113,113,
0,0,0,104,0,104,104,104,104,
90,90,90,90,0,90,90,90,90,
0,0,0,0,0,94,94,94,94,
81,81,81,81,0,81,81,81,81,
0,0,0,84,0,84,0,0,0,
79,79,0,79,79,79,79,79,79,
74,74,74,74,74,0,0,0,74,
73,73,73,73,73,0,73,0,73,
72,72,72,72,72,0,72,0,0,
71,71,71,71,0,0,0,0,0,
0,0,0,0,0,70,0,0,70,
0,0,69,69,69,69,69,0,69,
0,0,0,0,0,0,0,0,0,
0,0,0,0,0,0,0,0,0,
0,0,0,0,0,0,0,0,0.