[layer]
type=Tile Layer 1
data=
0,3,1,1,1,21,0,0,1,
0,0,0,0,0,21,6,1,5,
5,1,1,21,1,0,1,1,1,
1,1,5,0,5,0,21,0,1,
1,1,1,21,0,3,4,0,1,
0,0,21,1,0,1,1,1,1,
1,1,21,1,1,5,3,1,0,
0,1,21,1,4,1,1,1,0,
1,1,21,1,5,1,1,3,0,
1,1,0,0,21,0,1,0,0,
1,1,21,1,1,3,1,6,4,
0,0,0,1,0,0,21,1,0,
1,1,0,1,21,3,6,4,0,
0,6,0,1,0,1,1,1,21,
0,1,21,1,0,1,1,1,0,
0,0,1,21,1,0,1,0,0,
1,6,1,0,1,21,1,0,3,
1,0,0,0,1,21,5,0,1,
1,0,1,0,1,21,3,0,6,
1,0,1,0,0,21,0,0,1,
5,21,1,6,1,1,1,1,1,
0,0,3,0,21,0,0,0,1,
1,1,1,21,6,4,1,0,1,
1,0,0,0,1,21,1,0,1,
0,21,0,1,1,3,4,1,0,
1,6,21,1,1,1,1,1,0,
0,0,0,1,0,0,21,0,0,
3,1,21,1,1,1,1,1,1,
0,3,21,1,0,1,0,0,0,
0,5,21,1,0,1,1,6,1,
0,0,0,0,0,0,0,0,0,
0,0,0,0,0,0,0,0,0,
0,0,0,0,0,0,0,0,0.
[layer]
type=Tile Layer 2
data=
0,166,166,166,166,0,0,0,166,
0,0,0,0,0,0,164,164,164,
162,162,162,0,162,0,162,162,162,
112,112,112,0,112,0,0,0,112,
140,140,140,0,0,140,140,0,140,
0,0,0,129,0,129,129,129,129,
118,118,0,118,118,118,118,118,0,
0,108,0,108,108,108,108,108,0,
134,134,0,134,134,134,134,134,0,
124,124,0,0,0,0,124,0,0,
108,108,0,108,108,108,108,108,108,
0,0,0,103,0,0,0,103,0,
129,129,0,129,0,129,129,129,0,
0,119,0,119,0,119,119,119,0,
0,109,0,109,0,109,109,109,0,
0,0,99,0,99,0,99,0,0,
123,123,123,0,123,0,123,0,123,
113,0,0,0,113,0,113,0,113,
104,0,104,0,104,0,104,0,104,
95,0,95,0,0,0,0,0,95,
89,0,89,89,89,89,89,89,89,
0,0,85,0,0,0,0,0,85,
84,84,84,0,84,84,84,0,84,
83,0,0,0,83,0,83,0,83,
0,0,0,74,74,74,74,74,0,
73,73,0,73,73,73,73,73,0,
0,0,0,72,0,0,0,0,0,
68,68,0,68,68,68,68,68,68,
0,70,0,70,0,70,0,0,0,
0,69,0,69,0,69,69,69,69,
0,0,0,0,0,0,0,0,0,
0,0,0,0,0,0,0,0,0,
0,0,0,0,0,0,0,0,0.