[layer]
type=Tile Layer 1
data=
1,1,1,1,1,21,1,0,1,
1,1,1,1,1,21,1,0,1,
0,0,21,0,1,0,1,0,1,
1,1,1,21,1,1,1,0,1,
1,0,21,0,0,0,1,0,0,
1,1,21,1,1,1,1,1,1,
1,1,21,1,1,1,1,1,1,
1,1,0,0,0,0,0,21,0,
1,1,21,1,1,1,1,1,1,
1,1,21,0,1,1,1,0,1,
0,21,0,1,1,1,1,1,1,
0,1,21,1,1,1,1,1,1,
0,1,1,1,1,0,0,21,1,
0,21,0,0,0,0,1,1,1,
1,1,0,0,0,0,1,21,0,
1,1,1,1,1,21,0,1,0,
1,1,1,1,1,1,21,1,0,
1,1,1,1,1,1,1,21,0,
1,1,1,1,1,1,21,1,1,
1,1,0,0,21,1,0,1,1,
1,1,21,1,1,1,0,1,1,
0,0,21,1,1,1,0,0,0,
1,1,21,1,1,1,0,1,1,
0,0,0,1,21,1,0,1,1,
1,1,1,1,21,1,0,1,1,
1,1,1,1,21,0,0,0,0,
1,1,1,1,1,1,21,1,1,
1,1,1,0,0,0,21,0,0,
1,1,1,0,21,0,1,1,0,
1,1,21,1,1,1,0,1,0,
1,1,0,21,0,0,1,1,0,
1,1,21,1,1,1,1,1,0,
1,1,0,1,1,21,0,1,0,
0,0,0,0,0,0,0,0,0,
0,0,0,0,0,0,0,0,0,
0,0,0,0,0,0,0,0,0.
[layer]
type=Tile Layer 2
data=
170,170,170,170,170,0,170,0,170,
169,169,169,169,169,0,169,0,169,
0,0,0,0,167,0,167,0,167,
146,146,146,0,146,146,146,0,146,
134,0,0,0,0,0,134,0,0,
117,117,0,117,117,117,117,117,117,
107,107,0,107,107,107,107,107,107,
140,140,0,0,0,0,0,0,0,
123,123,0,123,123,123,123,123,123,
118,118,0,0,118,118,118,0,118,
0,0,0,108,108,108,108,108,108,
0,134,0,134,134,134,134,134,134,
0,124,124,124,124,0,0,0,124,
0,0,0,0,0,0,114,114,114,
103,103,0,0,0,0,103,0,0,
129,129,129,129,129,0,0,129,0,
119,119,119,119,119,119,0,119,0,
109,109,109,109,109,109,109,0,0,
94,94,94,94,94,94,0,94,94,
123,123,0,0,0,123,0,123,123,
113,113,0,113,113,113,0,113,113,
0,0,0,104,104,104,0,0,0,
95,95,0,95,95,95,0,95,95,
0,0,0,94,0,94,0,94,94,
85,85,85,85,0,85,0,85,85,
84,84,84,84,0,0,0,0,0,
79,79,79,79,79,79,0,79,79,
74,74,74,0,0,0,0,0,0,
73,73,73,0,0,0,73,73,0,
72,72,0,72,72,72,0,72,0,
71,71,0,0,0,0,71,71,0,
70,70,0,70,70,70,70,70,0,
69,69,0,69,69,0,0,69,0,
0,0,0,0,0,0,0,0,0,
0,0,0,0,0,0,0,0,0,
0,0,0,0,0,0,0,0,0.