[layer]
type=Tile Layer 1
data=
1,1,1,1,1,1,1,21,1,
0,21,0,0,1,0,0,0,0,
1,1,1,1,1,21,1,1,1,
1,1,1,1,1,21,1,1,1,
1,1,1,1,1,21,1,1,1,
1,1,1,1,1,21,1,1,1,
1,1,1,1,1,21,1,1,1,
1,0,0,0,0,0,21,0,0,
1,1,1,21,1,1,1,1,1,
1,1,1,0,0,21,0,1,1,
0,0,0,0,1,21,1,1,1,
0,1,1,0,21,1,1,0,1,
0,0,21,0,1,1,1,0,0,
1,1,21,1,0,0,0,0,0,
1,1,21,1,1,1,1,1,1,
1,0,0,21,0,0,0,1,1,
1,21,1,1,1,1,0,1,1,
1,0,1,0,0,21,0,1,1,
1,1,1,1,1,1,21,1,1,
0,1,21,0,0,0,0,1,1,
21,1,1,1,1,1,1,1,1,
1,1,0,1,0,21,0,0,1,
21,1,1,1,1,1,1,1,1,
0,1,21,1,0,1,0,1,0,
0,1,1,1,1,1,21,1,1,
0,1,1,1,1,1,21,1,0,
21,1,1,1,1,1,1,1,1,
0,0,0,21,0,1,0,1,0,
1,1,1,1,1,1,21,1,0,
0,1,1,1,1,1,21,1,0,
0,1,1,1,1,1,21,1,1,
0,1,0,1,0,0,1,0,21,
1,1,21,1,1,1,1,1,0,
0,1,0,1,1,1,1,1,21,
1,1,21,1,1,1,1,1,1,
0,0,21,1,1,1,1,1,0,
1,1,1,1,1,21,0,0,0,
1,1,0,0,21,0,0,0,0,
1,21,0,1,1,0,1,1,1,
1,0,1,0,21,0,1,1,1,
1,21,1,1,0,1,0,0,0,
1,21,1,0,1,1,1,1,0,
1,21,1,0,1,1,0,0,0,
1,0,21,0,1,0,0,1,1,
1,1,1,0,1,21,0,1,1,
1,21,1,0,0,0,0,0,0,
1,1,21,1,1,1,1,1,0,
0,1,0,1,1,1,1,1,21,
0,1,21,1,1,1,1,1,1,
0,1,0,0,0,21,0,1,0,
0,1,21,1,1,1,0,1,1,
0,0,0,0,0,0,0,0,0,
0,0,0,0,0,0,0,0,0,
0,0,0,0,0,0,0,0,0.
[layer]
type=Tile Layer 2
data=
223,223,223,223,223,223,223,0,223,
0,0,0,0,233,0,0,0,0,
220,220,220,220,220,0,220,220,220,
166,166,166,166,166,0,166,166,166,
152,152,152,152,152,0,152,152,152,
189,189,189,189,189,0,189,189,189,
175,175,175,175,175,0,175,175,175,
169,0,0,0,0,0,0,0,0,
147,147,147,0,147,147,147,147,147,
193,193,193,0,0,0,0,193,193,
0,0,0,0,179,0,179,179,179,
0,165,165,0,0,165,165,0,165,
0,0,0,0,150,150,150,0,0,
188,188,0,188,0,0,0,0,0,
165,165,0,165,165,165,165,165,165,
160,0,0,0,0,0,0,160,160,
146,0,146,146,146,146,0,146,146,
182,0,182,0,0,0,0,182,182,
160,160,160,160,160,160,0,160,160,
0,155,0,0,0,0,0,155,155,
0,135,135,135,135,135,135,135,135,
177,177,0,177,0,0,0,0,177,
0,155,155,155,155,155,155,155,155,
0,150,0,150,0,150,0,150,0,
0,137,137,137,137,137,0,137,137,
0,171,171,171,171,171,0,171,0,
0,151,151,151,151,151,151,151,151,
0,0,0,0,0,145,0,145,0,
133,133,133,133,133,133,0,133,0,
0,165,165,165,165,165,0,165,0,
0,153,153,153,153,153,0,153,153,
0,141,0,141,0,0,141,0,0,
128,128,0,128,128,128,128,128,0,
0,160,0,160,160,160,160,160,0,
141,141,0,141,141,141,141,141,141,
0,0,0,136,136,136,136,136,0,
124,124,124,124,124,0,0,0,0,
154,154,0,0,0,0,0,0,0,
142,0,0,142,142,0,142,142,142,
131,0,131,0,0,0,131,131,131,
120,0,120,120,0,120,0,0,0,
119,0,119,0,119,119,119,119,0,
108,0,108,0,108,108,0,0,0,
107,0,0,0,107,0,0,107,107,
106,106,106,0,106,0,0,106,106,
95,0,95,0,0,0,0,0,0,
94,94,0,94,94,94,94,94,0,
0,93,0,93,93,93,93,93,0,
0,92,0,92,92,92,92,92,92,
0,91,0,0,0,0,0,91,0,
0,90,0,90,90,90,0,90,90,
0,0,0,0,0,0,0,0,0,
0,0,0,0,0,0,0,0,0,
0,0,0,0,0,0,0,0,0.