[layer]
type=Tile Layer 1
data=
1,0,0,21,0,0,1,0,6,
4,21,1,1,1,0,1,0,5,
1,21,1,1,1,0,1,0,4,
1,1,1,4,21,1,0,1,1,
1,1,1,1,21,1,0,0,0,
4,1,6,1,0,1,5,21,0,
1,1,3,21,0,0,0,1,1,
1,1,1,21,1,1,0,1,1,
1,1,4,21,0,3,0,1,6,
1,21,0,0,0,4,0,0,0,
1,0,21,1,1,1,1,1,0,
1,3,21,3,1,1,5,1,0,
0,1,6,1,0,1,5,1,21,
0,21,0,0,0,1,0,0,0,
0,5,1,1,1,1,1,4,21,
0,0,0,0,21,1,0,0,0,
1,1,3,1,21,1,0,6,0,
0,0,0,1,0,1,21,1,0,
0,0,0,0,0,0,0,0,0,
0,0,0,0,0,0,0,0,0,
0,0,0,0,0,0,0,0,0.
[layer]
type=Tile Layer 2
data=
128,0,0,0,0,0,128,0,128,
127,0,127,127,127,0,127,0,127,
125,0,125,125,125,0,125,0,125,
82,82,82,82,0,82,0,82,82,
107,107,107,107,0,107,0,0,0,
98,98,98,98,0,98,98,0,0,
90,90,90,0,0,0,0,90,90,
78,78,78,0,78,78,0,78,78,
81,81,81,0,0,81,0,81,81,
73,0,0,0,0,73,0,0,0,
72,0,0,72,72,72,72,72,0,
67,67,0,67,67,67,67,67,0,
0,63,63,63,0,63,63,63,0,
0,0,0,0,0,62,0,0,0,
0,58,58,58,58,58,58,58,0,
0,0,0,0,0,60,0,0,0,
59,59,59,59,0,59,0,59,0,
0,0,0,58,0,58,0,58,0,
0,0,0,0,0,0,0,0,0,
0,0,0,0,0,0,0,0,0,
0,0,0,0,0,0,0,0,0.