[layer]
type=Tile Layer 1
data=
1,1,4,3,3,21,1,1,0,
1,0,21,1,1,1,0,0,0,
1,0,21,1,6,1,0,1,1,
6,1,1,1,6,3,1,1,21,
0,0,21,1,1,1,3,1,0,
1,1,21,1,1,1,5,1,0,
0,1,0,0,21,6,0,1,0,
0,1,0,1,1,1,21,1,0,
0,1,0,3,0,5,21,1,0,
0,1,1,1,0,5,21,1,0,
0,21,0,0,0,1,0,6,0,
0,4,0,1,1,1,21,1,1,
1,1,21,1,1,1,1,6,0,
3,21,0,1,1,3,1,0,0,
0,0,1,1,1,1,0,21,4,
0,21,0,1,1,1,1,0,0,
1,3,0,1,0,0,21,1,0,
6,1,0,1,21,1,4,0,0,
0,0,0,0,0,0,0,0,0,
0,0,0,0,0,0,0,0,0,
0,0,0,0,0,0,0,0,0.
[layer]
type=Tile Layer 2
data=
122,122,122,122,122,0,122,122,0,
127,0,0,127,127,127,0,0,0,
125,0,0,125,125,125,0,125,125,
78,78,78,78,78,78,78,78,0,
0,0,0,107,107,107,107,107,0,
94,94,0,94,94,94,94,94,0,
0,90,0,0,0,90,0,90,0,
0,82,0,82,82,82,0,82,0,
0,81,0,81,0,81,0,81,0,
0,73,73,73,0,73,0,73,0,
0,0,0,0,0,72,0,72,0,
0,71,0,71,71,71,0,71,71,
60,60,0,60,60,60,60,60,0,
62,0,0,62,62,62,62,0,0,
0,0,61,61,61,61,0,0,61,
0,0,0,60,60,60,60,0,0,
59,59,0,59,0,0,0,59,0,
58,58,0,58,0,58,58,0,0,
0,0,0,0,0,0,0,0,0,
0,0,0,0,0,0,0,0,0,
0,0,0,0,0,0,0,0,0.