[layer]
type=Tile Layer 1
data=
1,1,0,21,0,1,1,0,4,
1,3,21,1,0,1,1,5,1,
1,4,0,21,0,1,1,1,1,
1,4,0,1,0,21,0,0,0,
1,1,0,21,0,1,0,1,0,
3,1,0,1,21,0,5,0,0,
6,1,0,0,0,0,21,0,1,
3,1,1,1,1,1,1,21,0,
1,5,1,1,1,6,0,21,0,
0,21,0,1,0,1,1,1,1,
1,3,1,1,21,6,1,5,6,
0,0,0,0,1,1,21,0,0,
0,1,1,1,21,1,1,1,0,
0,3,1,1,0,21,0,1,0,
0,5,1,1,5,6,1,1,21,
0,1,0,0,0,0,0,0,21,
21,1,4,1,1,1,1,1,1,
0,0,0,21,0,0,0,5,0,
0,1,6,1,3,5,0,21,0,
0,0,0,0,1,0,0,1,21,
1,1,1,0,0,1,21,1,0,
1,1,3,1,21,3,1,5,0,
1,1,1,1,1,1,6,1,21,
1,0,0,0,21,0,1,1,0,
0,0,0,0,0,0,0,0,0,
0,0,0,0,0,0,0,0,0,
0,0,0,0,0,0,0,0,0.
[layer]
type=Tile Layer 2
data=
139,139,0,0,0,139,139,0,139,
131,131,0,131,0,131,131,131,131,
136,136,0,0,0,136,136,136,136,
110,110,0,110,0,0,0,0,0,
101,101,0,0,0,101,0,101,0,
91,91,0,91,0,0,91,0,0,
114,114,0,0,0,0,0,0,114,
100,100,100,100,100,100,100,0,0,
96,96,96,96,96,96,0,0,0,
0,0,0,87,0,87,87,87,87,
98,98,98,98,0,98,98,98,98,
0,0,0,0,99,99,0,0,0,
0,91,91,91,0,91,91,91,0,
0,83,83,83,0,0,0,83,0,
0,78,78,78,78,78,78,78,0,
0,74,0,0,0,0,0,0,0,
0,66,66,66,66,66,66,66,66,
0,0,0,0,0,0,0,72,0,
0,64,64,64,64,64,0,0,0,
0,0,0,0,63,0,0,63,0,
62,62,62,0,0,62,0,62,0,
58,58,58,58,0,58,58,58,0,
55,55,55,55,55,55,55,55,0,
59,0,0,0,0,0,59,59,0,
0,0,0,0,0,0,0,0,0,
0,0,0,0,0,0,0,0,0,
0,0,0,0,0,0,0,0,0.