[layer]
type=Tile Layer 1
data=
0,1,1,1,1,21,0,0,5,
0,21,0,0,0,0,1,4,6,
1,1,0,0,0,21,1,0,0,
3,1,4,1,1,0,21,1,0,
1,1,1,6,1,1,21,1,0,
1,1,1,3,1,1,6,21,0,
1,5,1,1,3,21,0,0,0,
1,1,1,1,1,21,4,3,0,
1,1,1,0,0,0,21,0,1,
1,6,1,21,1,1,1,0,0,
0,0,4,1,1,1,1,3,21,
0,0,0,0,0,0,0,1,21,
1,1,1,1,1,0,21,5,0,
6,1,1,3,1,0,0,21,0,
1,5,1,1,1,1,1,21,0,
1,0,0,21,6,0,1,0,1,
1,0,3,1,1,21,1,0,4,
1,0,1,0,21,0,0,0,1,
1,21,6,0,1,1,1,1,1,
1,0,6,0,1,21,0,0,0,
1,21,1,1,4,0,1,5,1,
0,21,3,0,0,0,1,0,0,
6,1,1,21,1,1,4,0,1,
1,0,0,0,1,21,1,0,1,
1,21,1,6,1,1,1,0,6,
0,0,1,3,1,1,3,21,1,
1,1,1,1,1,5,1,21,1,
0,0,0,21,0,0,0,0,1,
1,1,1,21,1,1,3,5,1,
0,0,1,21,0,0,0,0,0,
5,4,1,21,1,1,1,1,1,
1,4,1,21,3,1,1,3,1,
1,1,1,21,1,1,1,1,5,
6,21,1,0,0,0,3,4,1,
1,0,4,21,1,0,1,1,1,
0,0,1,0,1,21,1,0,0,
1,1,1,21,1,1,1,1,1,
1,5,1,0,3,21,0,0,0,
6,1,1,21,1,1,6,3,1,
0,0,0,0,0,0,0,0,0,
0,0,0,0,0,0,0,0,0,
0,0,0,0,0,0,0,0,0.
[layer]
type=Tile Layer 2
data=
0,197,197,197,197,0,0,0,197,
0,0,0,0,0,0,195,195,195,
194,194,0,0,0,0,194,0,0,
146,146,146,146,146,0,0,146,0,
133,133,133,133,133,133,0,133,0,
166,166,166,166,166,166,166,0,0,
153,153,153,153,153,0,0,0,0,
141,141,141,141,141,0,141,141,0,
129,129,129,0,0,0,0,0,129,
161,161,161,0,161,161,161,0,0,
0,0,148,148,148,148,148,148,0,
0,0,0,0,0,0,0,136,0,
124,124,124,124,124,0,0,124,0,
155,155,155,155,155,0,0,0,0,
143,143,143,143,143,143,143,0,0,
131,0,0,0,131,0,131,0,131,
120,0,120,120,120,0,120,0,120,
149,0,149,0,0,0,0,0,149,
138,0,138,0,138,138,138,138,138,
127,0,127,0,127,0,0,0,0,
115,0,115,115,115,0,115,115,115,
0,0,144,0,0,0,144,0,0,
133,133,133,0,133,133,133,0,133,
122,0,0,0,122,0,122,0,122,
111,0,111,111,111,111,111,0,111,
0,0,138,138,138,138,138,0,138,
121,121,121,121,121,121,121,0,121,
0,0,0,0,0,0,0,0,117,
102,102,102,0,102,102,102,102,102,
0,0,106,0,0,0,0,0,0,
91,91,91,0,91,91,91,91,91,
90,90,90,0,90,90,90,90,90,
89,89,89,0,89,89,89,89,89,
84,0,84,0,0,0,84,84,84,
83,0,83,0,83,0,83,83,83,
0,0,82,0,82,0,82,0,0,
77,77,77,0,77,77,77,77,77,
80,80,80,0,80,0,0,0,0,
76,76,76,0,76,76,76,76,76,
0,0,0,0,0,0,0,0,0,
0,0,0,0,0,0,0,0,0,
0,0,0,0,0,0,0,0,0.