[layer]
type=Tile Layer 1
data=
1,1,1,1,21,1,1,1,1,
1,0,24,21,0,1,1,1,1,
2,21,9,2,2,2,2,2,2,
1,2,2,2,21,1,0,2,2,
1,1,1,1,21,1,0,2,19,
2,2,1,1,21,1,0,2,10,
8,0,0,0,21,0,0,0,2,
2,21,1,1,1,1,1,0,1,
7,21,2,2,2,2,2,18,2,
1,21,0,0,1,1,0,1,1,
1,2,2,21,1,1,0,0,0,
1,10,2,0,0,21,0,0,0,
2,2,2,21,0,18,0,0,2,
19,2,1,0,1,1,1,21,0,
2,2,0,21,1,1,1,2,0,
1,2,2,21,1,1,1,2,24,
2,2,9,21,2,2,2,2,0,
1,2,2,2,0,21,0,0,0,
1,1,1,1,1,0,21,0,0,
1,1,1,1,1,0,21,0,0,
1,1,1,1,1,2,21,0,0,
2,2,2,2,2,21,20,0,2,
1,8,2,1,2,2,2,21,1,
1,2,2,1,2,8,2,21,1,
1,1,1,1,21,0,24,0,2,
1,1,2,2,2,0,21,0,24,
2,2,2,10,2,21,0,0,18,
1,1,2,2,0,0,21,0,1,
1,1,1,21,0,0,0,0,1,
1,1,1,21,1,1,1,1,1,
18,2,2,21,0,2,2,0,2,
1,1,1,21,1,2,2,2,10,
1,1,1,0,0,21,8,2,2,
0,0,0,21,1,2,2,0,1,
1,1,1,0,1,21,1,0,0,
1,1,1,21,1,1,1,2,0,
1,2,21,0,1,1,1,2,24,
2,9,2,2,2,2,2,2,21,
2,2,0,0,0,21,1,0,0,
10,2,21,1,0,1,1,1,1,
2,2,21,1,0,1,1,1,1,
1,1,21,1,0,1,0,2,0,
1,2,21,1,1,1,2,10,1,
0,19,0,0,0,0,2,2,21,
1,2,2,1,21,1,1,1,1,
1,1,1,1,21,1,1,1,1,
1,1,1,1,21,1,1,2,2,
1,1,1,1,21,1,1,2,8,
7,2,2,2,2,21,2,2,2,
1,0,1,0,21,0,2,1,1,
1,21,1,1,2,19,2,2,1,
1,21,1,1,2,2,8,2,0,
1,21,1,1,2,0,2,2,1,
1,21,1,1,2,24,2,1,1,
0,0,0,0,0,0,0,0,0,
0,0,0,0,0,0,0,0,0,
0,0,0,0,0,0,0,0,0.
[layer]
type=Tile Layer 2
data=
227,227,227,227,0,227,227,227,227,
237,0,0,0,0,237,237,237,237,
236,0,236,236,236,236,236,236,236,
164,164,164,164,0,164,0,164,164,
205,205,205,205,0,205,0,205,0,
189,189,189,189,0,189,0,189,189,
174,0,0,0,0,0,0,0,174,
159,0,159,159,159,159,159,0,159,
199,0,199,199,199,199,199,0,199,
184,0,0,0,184,184,0,184,184,
169,169,169,0,169,169,0,0,0,
155,155,155,0,0,0,0,0,0,
193,193,193,0,0,0,0,0,193,
0,179,179,0,179,179,179,0,0,
165,165,0,0,165,165,165,165,0,
150,150,150,0,150,150,150,150,0,
188,188,188,0,188,188,188,188,0,
174,174,174,174,0,0,0,0,0,
160,160,160,160,160,0,0,0,0,
146,146,146,146,146,0,0,0,0,
182,182,182,182,182,182,0,0,0,
168,168,168,168,168,0,0,0,168,
155,155,155,155,155,155,155,0,155,
142,142,142,142,142,142,142,0,142,
177,177,177,177,0,0,0,0,177,
163,163,163,163,163,0,0,0,0,
150,150,150,150,150,0,0,0,0,
137,137,137,137,0,0,0,0,137,
171,171,171,0,0,0,0,0,171,
151,151,151,0,151,151,151,151,151,
0,145,145,0,0,145,145,0,145,
133,133,133,0,133,133,133,133,133,
165,165,165,0,0,0,165,165,165,
0,0,0,0,153,153,153,0,153,
141,141,141,0,141,0,141,0,0,
128,128,128,0,128,128,128,128,0,
160,160,0,0,160,160,160,160,0,
148,148,148,148,148,148,148,148,0,
136,136,0,0,0,0,136,0,0,
124,124,0,124,0,124,124,124,124,
154,154,0,154,0,154,154,154,154,
142,142,0,142,0,142,0,142,0,
131,131,0,131,131,131,131,131,131,
0,0,0,0,0,0,120,120,0,
113,113,113,113,0,113,113,113,113,
103,103,103,103,0,103,103,103,103,
102,102,102,102,0,102,102,102,102,
106,106,106,106,0,106,106,106,106,
95,95,95,95,95,0,95,95,95,
94,0,94,0,0,0,94,94,94,
93,0,93,93,93,0,93,93,93,
92,0,92,92,92,92,92,92,0,
91,0,91,91,91,0,91,91,91,
90,0,90,90,90,0,90,90,90,
0,0,0,0,0,0,0,0,0,
0,0,0,0,0,0,0,0,0,
0,0,0,0,0,0,0,0,0.