[layer]
type=Tile Layer 1
data=
1,1,4,3,21,1,1,1,1,
0,0,0,0,21,1,0,0,0,
0,1,1,1,1,3,6,1,21,
0,1,0,21,0,0,0,1,0,
0,1,6,1,0,4,21,1,1,
0,0,21,1,0,1,0,0,0,
1,1,21,1,0,2,2,5,0,
0,0,0,1,0,19,21,3,0,
0,2,2,1,2,2,21,1,1,
0,19,0,0,21,0,0,1,4,
0,2,2,1,1,1,21,0,1,
0,1,1,5,1,3,1,21,0,
0,21,1,1,1,1,1,2,19,
2,18,21,0,0,0,0,0,0,
1,1,1,21,3,1,4,0,5,
0,0,0,0,0,0,0,0,0,
0,0,0,0,0,0,0,0,0,
0,0,0,0,0,0,0,0,0.
[layer]
type=Tile Layer 2
data=
111,111,111,111,0,111,111,111,111,
0,0,0,0,0,121,0,0,0,
0,113,113,113,113,113,113,113,0,
0,89,0,0,0,0,0,89,0,
0,81,81,81,0,81,0,81,81,
0,0,0,80,0,80,0,0,0,
72,72,0,72,0,72,72,72,0,
0,0,0,71,0,0,0,71,0,
0,66,66,66,66,66,0,66,66,
0,0,0,0,0,0,0,62,62,
0,61,61,61,61,61,0,0,61,
0,60,60,60,60,60,60,0,0,
0,0,59,59,59,59,59,59,0,
58,0,0,0,0,0,0,0,0,
55,55,55,0,55,55,55,0,55,
0,0,0,0,0,0,0,0,0,
0,0,0,0,0,0,0,0,0,
0,0,0,0,0,0,0,0,0.