[layer]
type=Tile Layer 1
data=
1,1,1,21,3,1,5,4,1,
1,1,1,0,1,0,21,0,1,
2,2,2,2,2,21,2,2,7,
0,2,21,2,2,2,2,2,7,
4,5,4,1,1,1,1,21,1,
3,1,1,1,1,21,0,0,1,
1,1,1,1,1,21,1,0,5,
1,0,21,0,0,0,1,0,4,
1,21,1,4,1,1,1,0,3,
2,2,2,2,2,2,7,21,0,
4,1,0,1,1,1,6,21,0,
0,21,1,3,1,1,1,0,1,
1,2,2,0,21,3,1,1,0,
1,8,2,1,21,2,2,1,4,
1,2,2,21,0,8,2,0,1,
1,1,1,1,2,2,2,5,21,
2,2,1,21,0,0,1,0,1,
8,2,21,0,3,1,1,1,0,
2,2,1,1,21,4,0,1,1,
9,2,2,2,2,21,2,2,0,
2,2,2,2,21,1,1,5,0,
1,1,2,10,0,1,21,0,0,
5,3,2,2,21,6,0,1,0,
0,1,0,1,21,1,0,1,0,
1,5,21,6,1,1,0,1,1,
0,2,0,0,0,4,21,0,0,
10,2,1,1,21,1,0,1,1,
2,2,0,21,0,0,5,1,1,
1,1,21,6,1,1,1,0,0,
4,21,0,1,1,1,4,1,0,
0,21,1,1,1,1,3,1,0,
0,21,0,1,1,1,0,0,0,
1,1,0,6,5,1,21,6,0,
0,0,0,0,0,0,0,0,0,
0,0,0,0,0,0,0,0,0,
0,0,0,0,0,0,0,0,0.
[layer]
type=Tile Layer 2
data=
162,162,162,0,162,162,162,162,162,
169,169,169,0,169,0,0,0,169,
167,167,167,167,167,0,167,167,167,
0,146,0,146,146,146,146,146,146,
128,128,128,128,128,128,128,0,128,
123,123,123,123,123,0,0,0,123,
112,112,112,112,112,0,112,0,112,
140,0,0,0,0,0,140,0,140,
129,0,129,129,129,129,129,0,129,
118,118,118,118,118,118,118,0,0,
108,108,0,108,108,108,108,0,0,
0,0,6,107,134,107,107,0,134,
124,99,99,0,0,124,6,6,0,
91,91,91,91,0,91,91,91,91,
83,103,83,0,0,103,83,0,83,
123,123,98,98,98,98,98,123,0,
95,119,5,0,0,0,5,0,5,
109,109,0,0,109,109,109,109,0,
99,99,99,99,0,99,0,99,99,
123,123,123,123,123,0,123,123,0,
113,113,113,113,0,113,113,113,0,
104,104,104,104,0,104,0,0,0,
95,95,95,95,0,95,0,95,0,
0,94,0,94,0,94,0,94,0,
85,85,0,85,85,85,0,85,85,
0,84,0,0,0,84,0,0,0,
83,83,83,83,0,83,0,83,83,
74,74,0,0,0,0,74,74,74,
73,73,0,73,73,73,73,0,0,
72,0,0,72,72,72,72,72,0,
0,0,71,71,71,71,71,71,0,
0,0,0,70,70,70,0,0,0,
69,69,0,69,69,69,0,69,0,
0,0,0,0,0,0,0,0,0,
0,0,0,0,0,0,0,0,0,
0,0,0,0,0,0,0,0,0.