[layer]
type=Tile Layer 1
data=
1,21,1,1,1,1,1,1,1,
1,0,21,0,1,1,1,1,1,
1,1,1,0,21,0,0,0,0,
1,1,1,1,1,1,1,21,0,
1,1,1,1,1,0,21,0,1,
1,1,1,1,1,0,0,21,0,
1,1,1,1,1,21,0,0,0,
1,1,1,1,1,21,0,1,1,
1,1,1,1,1,1,21,1,1,
0,1,1,1,1,1,21,1,0,
0,1,0,21,0,1,0,0,0,
0,1,21,1,0,1,1,1,0,
0,1,21,1,0,1,1,1,0,
0,1,1,1,1,1,1,1,21,
0,0,0,0,0,1,1,1,21,
1,1,21,1,1,1,1,1,0,
0,1,0,1,0,0,0,21,0,
1,1,21,1,0,1,1,1,1,
0,0,0,21,1,1,1,1,1,
0,1,1,1,21,1,1,1,1,
0,1,1,1,21,1,1,1,1,
21,1,1,1,1,1,1,1,1,
0,1,1,21,0,0,1,1,1,
0,21,1,1,1,0,1,1,1,
1,1,21,1,1,0,0,0,1,
1,1,0,21,0,0,1,0,0,
1,1,1,1,1,21,0,0,0,
1,1,0,0,0,0,0,21,0,
1,1,0,21,0,1,1,1,1,
1,1,1,1,21,0,1,1,1,
1,1,1,1,1,21,1,1,1,
1,0,21,0,0,0,1,1,1,
1,21,1,1,1,1,1,1,1,
1,0,0,21,0,0,1,1,1,
1,1,1,1,1,21,0,0,0,
1,1,1,1,1,1,1,1,21,
0,0,21,1,0,1,0,1,0,
1,1,1,1,21,1,0,1,0,
0,21,0,0,0,1,0,1,0,
1,1,1,1,1,1,21,1,0,
0,0,0,0,0,0,21,1,0,
1,1,1,1,1,1,1,1,21,
0,1,1,1,21,1,1,0,0,
0,1,1,1,21,1,1,1,1,
0,1,1,1,21,1,0,0,0,
0,21,1,1,1,1,1,0,0,
0,0,1,1,1,1,1,0,21,
1,21,0,0,1,1,1,0,0,
0,0,21,0,1,1,1,1,0,
0,1,1,1,1,1,1,1,21,
0,1,1,1,1,1,1,1,21,
0,0,0,0,0,0,0,0,0,
0,0,0,0,0,0,0,0,0,
0,0,0,0,0,0,0,0,0.
[layer]
type=Tile Layer 2
data=
223,0,223,223,223,223,223,223,223,
233,0,0,0,233,233,233,233,233,
231,231,231,0,0,0,0,0,0,
174,174,174,174,174,174,174,0,0,
159,159,159,159,159,0,0,0,159,
199,199,199,199,199,0,0,0,0,
184,184,184,184,184,0,0,0,0,
169,169,169,169,169,0,0,169,169,
147,147,147,147,147,147,0,147,147,
0,193,193,193,193,193,0,193,0,
0,179,0,0,0,179,0,0,0,
0,165,0,165,0,165,165,165,0,
0,150,0,150,0,150,150,150,0,
0,188,188,188,188,188,188,188,0,
0,0,0,0,0,174,174,174,0,
160,160,0,160,160,160,160,160,0,
0,146,0,146,0,0,0,0,0,
182,182,0,182,0,182,182,182,182,
0,0,0,0,168,168,168,168,168,
0,155,155,155,0,155,155,155,155,
0,142,142,142,0,142,142,142,142,
0,168,168,168,168,168,168,168,168,
0,163,163,0,0,0,163,163,163,
0,0,150,150,150,0,150,150,150,
137,137,0,137,137,0,0,0,137,
171,171,0,0,0,0,171,0,0,
158,158,158,158,158,0,0,0,0,
145,145,0,0,0,0,0,0,0,
133,133,0,0,0,133,133,133,133,
165,165,165,165,0,0,165,165,165,
146,146,146,146,146,0,146,146,146,
141,0,0,0,0,0,141,141,141,
122,0,122,122,122,122,122,122,122,
160,0,0,0,0,0,160,160,160,
148,148,148,148,148,0,0,0,0,
129,129,129,129,129,129,129,129,0,
0,0,0,124,0,124,0,124,0,
154,154,154,154,0,154,0,154,0,
0,0,0,0,0,142,0,142,0,
131,131,131,131,131,131,0,131,0,
0,0,0,0,0,0,0,120,0,
113,113,113,113,113,113,113,113,0,
0,108,108,108,0,108,108,0,0,
0,107,107,107,0,107,107,107,107,
0,106,106,106,0,106,0,0,0,
0,0,95,95,95,95,95,0,0,
0,0,94,94,94,94,94,0,0,
93,0,0,0,93,93,93,0,0,
0,0,0,0,92,92,92,92,0,
0,91,91,91,91,91,91,91,0,
0,90,90,90,90,90,90,90,0,
0,0,0,0,0,0,0,0,0,
0,0,0,0,0,0,0,0,0,
0,0,0,0,0,0,0,0,0.