[layer]
type=Tile Layer 1
data=
1,1,21,1,0,1,1,1,1,
1,1,21,1,0,1,1,1,1,
1,1,0,1,0,1,0,21,0,
1,1,21,1,1,1,1,1,1,
0,0,0,0,0,0,0,1,21,
1,1,1,1,21,1,1,1,1,
1,1,1,1,21,1,1,1,1,
1,1,1,1,21,1,1,1,1,
1,1,1,1,21,1,1,1,1,
1,1,1,0,0,0,0,21,0,
0,0,21,0,1,1,1,0,0,
0,1,1,1,1,1,1,21,1,
1,0,1,0,21,0,1,1,1,
1,21,1,1,1,1,0,0,1,
1,1,0,0,21,1,1,0,1,
1,1,0,1,1,0,21,0,0,
0,0,0,1,1,1,1,1,21,
0,1,1,1,1,1,1,21,0,
1,1,1,1,1,21,1,0,1,
1,1,1,0,21,0,1,0,1,
1,1,1,21,1,1,1,1,1,
0,0,1,0,0,0,0,21,1,
1,21,1,1,1,1,1,1,1,
1,21,0,0,1,0,1,1,1,
1,1,1,21,1,0,1,1,1,
1,1,1,21,1,0,1,1,1,
1,1,1,21,1,0,1,1,1,
1,1,1,1,21,1,1,1,1,
0,0,21,1,0,1,1,1,1,
1,1,1,1,21,1,1,1,1,
1,1,0,1,0,1,0,21,0,
1,1,21,1,0,1,1,1,1,
0,21,0,1,1,1,0,0,1,
1,1,21,1,1,1,1,1,0,
0,1,21,1,1,1,1,1,0,
1,1,21,1,1,1,1,1,1,
0,1,1,1,21,0,1,1,1,
0,1,1,1,1,21,0,1,0,
0,1,1,1,1,21,1,0,0,
0,0,0,0,0,0,0,21,1,
0,0,1,1,21,1,1,1,1,
1,0,21,0,0,1,1,1,1,
1,0,1,0,1,0,1,21,0,
1,0,1,21,1,0,1,1,0,
0,0,0,0,21,0,1,1,0,
1,21,1,0,1,1,1,1,1,
0,0,1,0,1,0,21,0,1,
1,1,1,21,1,1,1,0,1,
1,1,1,21,1,1,1,0,0,
1,1,1,21,1,1,1,1,1,
1,1,1,21,1,1,1,0,1,
0,0,0,0,0,0,0,0,0,
0,0,0,0,0,0,0,0,0,
0,0,0,0,0,0,0,0,0.
[layer]
type=Tile Layer 2
data=
234,234,0,234,0,234,234,234,234,
233,233,0,233,0,233,233,233,233,
231,231,0,231,0,231,0,0,0,
166,166,0,166,166,166,166,166,166,
0,0,0,0,0,0,0,159,0,
189,189,189,189,0,189,189,189,189,
175,175,175,175,0,175,175,175,175,
161,161,161,161,0,161,161,161,161,
147,147,147,147,0,147,147,147,147,
193,193,193,0,0,0,0,0,0,
0,0,0,0,179,179,179,0,0,
0,165,165,165,165,165,165,0,165,
150,0,150,0,0,0,150,150,150,
188,0,188,188,188,188,0,0,188,
174,174,0,0,0,174,174,0,174,
160,160,0,160,160,0,0,0,0,
0,0,0,146,146,146,146,146,0,
0,182,182,182,182,182,182,0,0,
168,168,168,168,168,0,168,0,168,
155,155,155,0,0,0,155,0,155,
135,135,135,0,135,135,135,135,135,
0,0,177,0,0,0,0,0,177,
155,0,155,155,155,155,155,155,155,
150,0,0,0,150,0,150,150,150,
137,137,137,0,137,0,137,137,137,
171,171,171,0,171,0,171,171,171,
158,158,158,0,158,0,158,158,158,
138,138,138,138,0,138,138,138,138,
0,0,0,133,0,133,133,133,133,
157,157,157,157,0,157,157,157,157,
153,153,0,153,0,153,0,0,0,
141,141,0,141,0,141,141,141,141,
0,0,0,128,128,128,0,0,128,
160,160,0,160,160,160,160,160,0,
0,148,0,148,148,148,148,148,0,
129,129,0,129,129,129,129,129,129,
0,124,124,124,0,0,124,124,124,
0,154,154,154,154,0,0,154,0,
0,142,142,142,142,0,142,0,0,
0,0,0,0,0,0,0,0,131,
0,0,120,120,0,120,120,120,120,
119,0,0,0,0,119,119,119,119,
108,0,108,0,108,0,108,0,0,
107,0,107,0,107,0,107,107,0,
0,0,0,0,0,0,106,106,0,
95,0,95,0,95,95,95,95,95,
0,0,94,0,94,0,0,0,94,
93,93,93,0,93,93,93,0,93,
92,92,92,0,92,92,92,0,0,
87,87,87,0,87,87,87,87,87,
90,90,90,0,90,90,90,0,90,
0,0,0,0,0,0,0,0,0,
0,0,0,0,0,0,0,0,0,
0,0,0,0,0,0,0,0,0.