[layer]
type=Tile Layer 1
data=
0,1,6,1,1,1,4,6,21,
0,0,0,3,0,1,0,0,21,
1,1,0,1,21,1,1,1,1,
0,1,0,1,0,0,1,1,21,
0,1,1,4,0,1,3,1,21,
0,21,0,1,0,0,1,0,0,
6,1,21,1,5,4,1,1,1,
0,0,0,1,0,0,0,1,21,
0,1,1,1,0,1,0,5,21,
0,0,0,0,5,0,0,1,21,
3,0,0,1,21,6,5,0,1,
1,1,1,1,3,21,4,0,1,
6,0,0,1,21,4,0,1,1,
0,0,1,21,4,0,5,1,0,
1,1,21,4,0,3,4,0,0,
0,0,0,0,0,0,0,0,0,
0,0,0,0,0,0,0,0,0,
0,0,0,0,0,0,0,0,0.
[layer]
type=Tile Layer 2
data=
0,89,89,89,89,89,89,89,0,
0,0,0,73,0,73,0,0,0,
68,68,0,68,0,68,68,68,68,
0,71,0,71,0,0,71,71,0,
0,64,64,64,0,64,64,64,0,
0,0,0,63,0,0,63,0,0,
56,56,0,56,56,56,56,56,56,
0,0,0,55,0,0,0,55,0,
0,54,54,54,0,54,0,54,0,
0,0,0,0,53,0,0,53,0,
52,0,0,52,0,52,52,0,52,
49,49,49,49,49,0,49,0,49,
50,0,0,50,0,50,0,50,50,
0,0,49,0,49,0,49,49,0,
48,48,0,48,0,48,48,0,0,
0,0,0,0,0,0,0,0,0,
0,0,0,0,0,0,0,0,0,
0,0,0,0,0,0,0,0,0.