[layer]
type=Tile Layer 1
data=
1,1,1,21,1,1,1,1,1,
0,0,1,0,1,1,1,0,21,
1,1,1,21,1,1,1,1,1,
1,0,0,0,0,21,0,0,1,
1,21,1,1,1,1,1,0,1,
1,0,1,21,0,0,1,0,0,
0,1,21,0,1,1,1,1,1,
0,21,1,0,0,1,1,1,1,
1,0,0,1,21,0,1,1,1,
1,1,21,1,1,0,0,1,1,
1,1,0,1,1,1,21,0,1,
0,21,0,1,1,1,1,0,0,
0,1,1,1,1,1,1,1,21,
1,1,1,1,1,1,21,1,0,
1,1,1,21,0,0,0,1,0,
0,1,0,1,21,1,0,1,0,
0,1,0,1,0,0,21,1,0,
0,1,0,1,1,1,21,1,1,
0,1,0,1,0,1,21,0,0,
0,1,0,1,0,1,21,1,1,
0,1,0,1,0,1,0,1,21,
0,0,0,0,0,0,0,0,0,
0,0,0,0,0,0,0,0,0,
0,0,0,0,0,0,0,0,0.
[layer]
type=Tile Layer 2
data=
120,120,120,0,120,120,120,120,120,
0,0,132,0,132,132,132,0,0,
117,117,117,0,117,117,117,117,117,
113,0,0,0,0,0,0,0,113,
99,0,99,99,99,99,99,0,99,
95,0,95,0,0,0,95,0,0,
0,86,0,0,86,86,86,86,86,
0,0,107,0,0,107,107,107,107,
98,0,0,98,0,0,98,98,98,
90,90,0,90,90,0,0,90,90,
82,82,0,82,82,82,0,0,82,
0,0,0,81,81,81,81,0,0,
0,69,69,69,69,69,69,69,0,
68,68,68,68,68,68,0,68,0,
71,71,71,0,0,0,0,71,0,
0,63,0,63,0,63,0,63,0,
0,62,0,62,0,0,0,62,0,
0,61,0,61,61,61,0,61,61,
0,60,0,60,0,60,0,0,0,
0,59,0,59,0,59,0,59,59,
0,58,0,58,0,58,0,58,0,
0,0,0,0,0,0,0,0,0,
0,0,0,0,0,0,0,0,0,
0,0,0,0,0,0,0,0,0.