[layer]
type=Tile Layer 1
data=
0,21,0,0,0,0,0,6,0,
0,1,1,1,1,1,21,1,0,
0,5,0,0,0,1,21,1,0,
0,1,0,1,21,5,1,1,0,
0,0,0,1,21,0,0,0,0,
21,1,5,3,1,1,1,6,1,
0,1,0,0,0,6,21,0,0,
0,4,0,1,21,1,0,1,1,
0,1,0,1,0,0,0,1,21,
1,1,1,3,21,1,5,1,1,
0,1,0,1,1,4,0,1,21,
0,0,1,5,1,1,1,0,21,
0,1,0,0,0,0,0,3,21,
0,1,21,1,0,1,0,1,0,
0,1,0,0,0,0,21,6,0,
0,0,0,0,0,0,0,0,0,
0,0,0,0,0,0,0,0,0,
0,0,0,0,0,0,0,0,0.
[layer]
type=Tile Layer 2
data=
0,0,0,0,0,0,0,123,0,
0,121,121,121,121,121,0,121,0,
0,119,0,0,0,119,0,119,0,
0,89,0,89,0,89,89,89,0,
0,0,0,81,0,0,0,0,0,
0,72,72,72,72,72,72,72,72,
0,72,0,0,0,72,0,0,0,
0,71,0,71,0,71,0,71,71,
0,70,0,70,0,0,0,70,0,
56,56,56,56,0,56,56,56,56,
0,61,0,61,61,61,0,61,0,
0,0,60,60,60,60,60,0,0,
0,59,0,0,0,0,0,59,0,
0,58,0,58,0,58,0,58,0,
0,57,0,0,0,0,0,57,0,
0,0,0,0,0,0,0,0,0,
0,0,0,0,0,0,0,0,0,
0,0,0,0,0,0,0,0,0.