[layer]
type=Tile Layer 1
data=
2,21,2,2,2,9,2,2,2,
1,21,1,1,2,2,2,0,1,
1,21,1,1,1,1,1,0,1,
1,2,0,0,0,21,0,0,0,
1,10,2,0,1,1,21,1,0,
1,2,2,21,1,1,1,1,0,
1,1,0,0,21,0,0,0,0,
1,1,0,0,1,21,0,1,0,
2,2,1,21,1,1,0,0,0,
10,2,0,2,2,1,1,21,0,
2,0,2,8,21,0,1,0,0,
1,0,2,2,2,21,0,0,1,
1,21,1,1,1,1,1,0,1,
1,0,2,2,2,0,1,21,0,
2,21,2,9,2,2,2,2,2,
1,0,2,0,21,2,8,2,1,
1,21,1,1,1,2,2,0,1,
1,21,1,1,1,1,1,0,0,
1,21,1,1,1,1,1,1,1,
1,21,2,2,1,1,1,0,1,
2,21,9,2,2,2,2,0,2,
1,2,21,2,1,1,0,1,1,
1,2,21,1,1,1,0,1,1,
0,8,21,0,0,1,0,1,1,
0,2,21,1,1,1,1,1,1,
0,1,0,21,0,0,0,0,0,
2,2,7,2,21,2,2,2,2,
1,1,1,1,21,1,1,2,2,
1,1,1,1,21,1,1,2,8,
0,1,0,21,0,1,1,2,2,
0,1,0,1,1,1,1,1,21,
0,1,1,1,1,0,0,21,0,
0,2,2,1,1,21,1,1,0,
1,10,2,1,1,0,21,1,0,
0,21,7,2,2,2,2,2,2,
0,1,1,0,0,0,21,1,0,
0,1,1,1,0,1,1,21,0,
0,1,1,0,21,0,1,0,0,
0,2,0,1,0,0,0,0,21,
10,21,1,0,1,1,1,1,1,
2,2,1,0,0,0,1,21,0,
1,21,1,0,1,1,1,1,1,
1,21,1,0,1,1,1,1,1,
1,1,1,21,1,1,1,1,1,
2,2,7,2,2,2,21,2,0,
0,0,0,0,0,0,0,0,0,
0,0,0,0,0,0,0,0,0,
0,0,0,0,0,0,0,0,0.
[layer]
type=Tile Layer 2
data=
208,0,208,208,208,208,208,208,208,
206,0,206,206,206,206,206,0,206,
204,0,204,204,204,204,204,0,204,
178,178,0,0,0,0,0,0,0,
165,165,165,0,165,165,0,165,0,
152,152,152,0,152,152,152,152,0,
138,138,0,0,0,0,0,0,0,
173,173,0,0,173,0,0,173,0,
160,160,160,0,160,160,0,0,0,
147,147,0,147,147,147,147,0,0,
134,0,134,134,0,0,134,0,0,
167,0,167,167,167,0,0,0,167,
154,0,154,154,154,154,154,0,154,
142,0,142,142,142,0,142,0,0,
130,0,130,130,130,130,130,130,130,
162,0,162,0,0,162,162,162,162,
149,0,149,149,149,149,149,0,149,
137,0,137,137,137,137,137,0,0,
119,0,119,119,119,119,119,119,119,
156,0,156,156,156,156,156,0,156,
144,0,144,144,144,144,144,0,144,
132,132,0,132,132,132,0,132,132,
121,121,0,121,121,121,0,121,121,
0,150,0,0,0,150,0,150,150,
0,139,0,139,139,139,139,139,139,
0,128,0,0,0,0,0,0,0,
116,116,116,116,0,116,116,116,116,
138,138,138,138,0,138,138,138,138,
134,134,134,134,0,134,134,134,134,
0,123,0,0,0,123,123,123,123,
0,112,0,112,112,112,112,112,0,
0,139,139,139,139,0,0,0,0,
0,128,128,128,128,0,128,128,0,
118,118,118,118,118,0,0,118,0,
0,0,108,108,108,108,108,108,108,
0,107,107,0,0,0,0,107,0,
0,97,97,97,0,97,97,0,0,
0,96,96,0,0,0,96,0,0,
0,95,0,95,0,0,0,0,0,
85,0,85,0,85,85,85,85,85,
84,84,84,0,0,0,84,0,0,
83,0,83,0,83,83,83,83,83,
82,0,82,0,82,82,82,82,82,
78,78,78,0,78,78,78,78,78,
80,80,80,80,80,80,0,80,0,
0,0,0,0,0,0,0,0,0,
0,0,0,0,0,0,0,0,0,
0,0,0,0,0,0,0,0,0.