[layer]
type=Tile Layer 1
data=
0,1,21,1,0,1,0,1,1,
1,1,0,6,0,6,21,1,0,
1,1,3,4,21,5,1,1,1,
1,1,0,1,0,3,0,1,21,
0,1,1,1,21,1,0,1,4,
1,1,0,0,21,1,0,5,0,
1,0,1,3,0,0,0,21,1,
0,3,0,0,1,6,21,0,6,
0,1,1,1,6,21,4,1,1,
0,0,1,1,1,0,21,1,6,
1,1,21,1,0,0,1,0,0,
1,1,0,1,3,0,21,4,0,
0,0,0,0,0,0,0,0,0,
0,0,0,0,0,0,0,0,0,
0,0,0,0,0,0,0,0,0.
[layer]
type=Tile Layer 2
data=
0,88,0,88,0,88,0,88,88,
63,63,0,63,0,63,0,63,0,
56,56,56,56,0,56,56,56,56,
61,61,0,61,0,61,0,61,0,
0,54,54,54,0,54,0,54,54,
53,53,0,0,0,53,0,53,0,
52,0,52,52,0,0,0,0,52,
0,51,0,0,51,51,0,0,51,
0,48,48,48,48,0,48,48,48,
0,0,49,49,49,0,0,49,49,
48,48,0,48,0,0,48,0,0,
47,47,0,47,47,0,0,47,0,
0,0,0,0,0,0,0,0,0,
0,0,0,0,0,0,0,0,0,
0,0,0,0,0,0,0,0,0.