[layer]
type=Tile Layer 1
data=
0,0,0,0,0,1,1,0,21,
0,1,0,21,0,0,0,0,1,
0,21,2,2,2,2,2,7,2,
1,1,1,2,10,21,0,0,0,
1,1,1,2,2,21,1,1,0,
1,1,2,2,2,1,0,21,0,
2,2,21,10,2,1,1,1,0,
10,0,2,21,0,0,0,0,0,
2,2,21,1,1,1,0,1,1,
2,7,2,2,2,2,2,21,0,
1,8,0,0,0,0,0,21,0,
1,2,21,2,1,0,1,1,1,
2,21,9,2,2,2,2,2,2,
1,2,2,0,21,2,10,2,0,
1,21,1,0,1,0,2,2,1,
1,0,1,0,1,0,0,21,0,
1,21,2,2,1,1,1,1,1,
0,2,9,2,2,21,2,2,2,
1,2,2,2,1,21,1,0,1,
1,0,0,21,1,0,0,0,1,
1,0,1,21,1,0,1,1,1,
0,0,1,0,0,21,1,0,1,
1,0,1,2,2,21,1,0,1,
2,2,2,2,9,21,2,2,0,
1,21,1,2,2,2,1,0,1,
1,21,1,1,1,1,1,0,1,
1,21,1,1,1,1,1,0,1,
1,21,1,1,1,1,1,0,1,
1,1,1,1,1,1,1,21,2,
2,2,2,2,2,21,2,0,9,
1,1,21,1,1,1,1,2,2,
0,21,0,0,0,1,0,0,0,
1,1,1,1,21,1,0,1,1,
1,1,0,0,21,1,0,0,0,
1,1,21,1,1,1,0,1,1,
0,0,0,1,0,0,21,1,1,
0,0,0,0,0,0,0,0,0,
0,0,0,0,0,0,0,0,0,
0,0,0,0,0,0,0,0,0.
[layer]
type=Tile Layer 2
data=
0,0,0,0,0,192,192,0,0,
0,191,0,0,0,0,0,0,191,
0,0,189,189,189,189,189,189,189,
153,153,153,153,153,0,0,0,0,
141,141,141,141,141,0,141,141,0,
129,129,129,129,129,129,0,0,0,
161,161,0,161,161,161,161,161,0,
148,0,148,0,0,0,0,0,0,
136,136,0,136,136,136,0,136,136,
124,124,124,124,124,124,124,0,0,
155,155,0,0,0,0,0,0,0,
143,143,0,143,143,0,143,143,143,
131,0,131,131,131,131,131,131,131,
120,120,120,0,0,120,120,120,0,
149,0,149,0,149,0,149,149,149,
138,0,138,0,138,0,0,0,0,
121,0,121,121,121,121,121,121,121,
0,115,115,115,115,0,115,115,115,
144,144,144,144,144,0,144,0,144,
133,0,0,0,133,0,0,0,133,
122,0,122,0,122,0,122,122,122,
0,0,111,0,0,0,111,0,111,
138,0,138,138,138,0,138,0,138,
127,127,127,127,127,0,127,127,0,
117,0,117,117,117,117,117,0,117,
107,0,107,107,107,107,107,0,107,
106,0,106,106,106,106,106,0,106,
96,0,96,96,96,96,96,0,96,
90,90,90,90,90,90,90,0,90,
94,94,94,94,94,0,94,0,94,
80,80,0,80,80,80,80,80,80,
0,0,0,0,0,83,0,0,0,
82,82,82,82,0,82,0,82,82,
81,81,0,0,0,81,0,0,0,
80,80,0,80,80,80,0,80,80,
0,0,0,79,0,0,0,79,79,
0,0,0,0,0,0,0,0,0,
0,0,0,0,0,0,0,0,0,
0,0,0,0,0,0,0,0,0.