[layer]
type=Tile Layer 1
data=
19,2,21,1,1,1,1,1,1,
0,2,21,2,2,7,2,2,2,
0,2,21,2,2,2,2,2,7,
1,1,1,0,0,21,0,0,1,
1,2,2,21,1,2,2,2,1,
0,2,9,2,2,2,8,21,2,
1,2,2,21,2,2,2,0,1,
0,19,0,21,8,2,1,0,1,
1,2,2,2,2,2,1,21,1,
1,1,1,0,21,0,0,0,1,
1,1,1,21,1,2,2,2,1,
0,21,1,0,1,0,24,0,0,
1,0,1,0,1,21,1,0,1,
1,1,1,21,1,0,1,1,1,
0,0,2,0,2,0,21,2,0,
1,21,2,24,2,2,8,2,1,
0,21,8,0,20,2,2,2,0,
1,2,2,21,2,0,1,1,1,
0,0,1,0,1,0,0,0,21,
1,21,1,0,1,1,1,2,2,
0,21,2,0,2,0,0,0,20,
1,0,1,0,1,1,1,21,0,
1,0,1,21,1,1,1,0,1,
2,0,1,0,21,0,0,0,1,
10,2,1,21,1,1,1,0,1,
2,21,0,0,1,0,0,0,1,
1,21,1,1,1,1,1,1,1,
0,0,0,0,0,0,0,0,0,
0,0,0,0,0,0,0,0,0,
0,0,0,0,0,0,0,0,0.
[layer]
type=Tile Layer 2
data=
0,160,0,160,160,160,160,160,160,
0,158,0,158,158,158,158,158,158,
0,157,0,157,157,157,157,157,157,
117,117,117,0,0,0,0,0,117,
102,102,102,0,102,102,102,102,102,
0,133,133,133,133,133,133,0,133,
123,123,123,0,123,123,123,0,123,
0,0,0,0,113,113,113,0,113,
98,98,98,98,98,98,98,0,98,
128,128,128,0,0,0,0,0,128,
112,112,112,0,112,112,112,112,112,
0,0,108,0,108,0,0,0,0,
98,0,98,0,98,0,98,0,98,
122,122,122,0,122,0,122,122,122,
0,0,112,0,112,0,0,112,0,
103,0,103,0,103,103,103,103,103,
0,0,94,0,0,94,94,94,0,
93,93,93,0,93,0,93,93,93,
0,0,84,0,84,0,0,0,0,
83,0,83,0,83,83,83,83,83,
0,0,82,0,82,0,0,0,0,
73,0,73,0,73,73,73,0,0,
72,0,72,0,72,72,72,0,72,
71,0,71,0,0,0,0,0,71,
70,70,70,0,70,70,70,0,70,
69,0,0,0,69,0,0,0,69,
65,0,65,65,65,65,65,65,65,
0,0,0,0,0,0,0,0,0,
0,0,0,0,0,0,0,0,0,
0,0,0,0,0,0,0,0,0.