[layer]
type=Tile Layer 1
data=
1,1,1,1,1,21,1,1,1,
1,1,1,1,1,21,0,0,0,
1,1,1,1,0,0,21,0,0,
0,0,0,0,21,1,1,1,1,
0,21,1,1,1,1,1,1,1,
1,21,1,1,1,1,1,1,1,
1,1,1,1,0,0,21,0,0,
1,1,1,1,21,1,1,1,0,
0,0,0,0,0,0,21,1,0,
21,1,1,1,1,1,1,1,1,
0,0,0,1,0,21,0,1,0,
1,1,1,1,21,1,1,1,1,
0,1,0,1,0,0,0,21,0,
1,1,21,1,1,1,1,1,1,
0,1,21,1,1,1,0,0,0,
1,1,1,21,1,1,1,1,1,
1,1,1,21,0,1,1,1,1,
0,21,0,0,0,1,1,1,1,
0,0,21,0,0,0,1,1,1,
1,0,0,21,0,0,1,1,1,
1,0,0,21,0,1,1,1,1,
1,1,1,1,21,0,0,1,1,
1,1,1,1,1,1,21,0,0,
1,1,1,1,1,1,1,1,21,
1,21,1,1,1,1,1,1,1,
0,21,1,1,1,1,1,1,1,
0,0,0,0,21,0,1,1,1,
1,1,1,1,1,21,1,1,1,
1,1,1,1,1,21,1,1,1,
1,1,1,1,1,0,21,0,1,
1,21,0,0,0,0,0,0,1,
1,0,21,0,0,0,1,1,1,
1,1,1,1,1,21,1,1,1,
1,0,1,21,1,0,1,0,1,
1,0,1,21,1,0,1,0,0,
1,0,1,21,1,0,1,1,1,
1,0,1,0,1,0,21,0,0,
1,1,1,1,1,21,1,1,1,
0,0,0,21,0,0,0,0,1,
1,1,1,21,1,1,1,1,1,
1,1,1,0,1,21,0,0,1,
1,1,1,21,1,0,1,1,1,
1,1,1,1,0,0,21,0,0,
0,0,1,1,1,21,0,1,0,
0,1,1,1,1,1,1,21,0,
0,1,1,1,1,1,1,21,1,
0,0,21,1,1,1,0,0,1,
1,1,21,1,1,1,0,1,1,
0,0,0,0,0,0,0,0,0,
0,0,0,0,0,0,0,0,0,
0,0,0,0,0,0,0,0,0.
[layer]
type=Tile Layer 2
data=
218,218,218,218,218,0,218,218,218,
228,228,228,228,228,0,0,0,0,
226,226,226,226,0,0,0,0,0,
0,0,0,0,0,184,184,184,184,
0,0,169,169,169,169,169,169,169,
147,0,147,147,147,147,147,147,147,
193,193,193,193,0,0,0,0,0,
179,179,179,179,0,179,179,179,0,
0,0,0,0,0,0,0,165,0,
0,143,143,143,143,143,143,143,143,
0,0,0,188,0,0,0,188,0,
165,165,165,165,0,165,165,165,165,
0,160,0,160,0,0,0,0,0,
139,139,0,139,139,139,139,139,139,
0,182,0,182,182,182,0,0,0,
160,160,160,0,160,160,160,160,160,
155,155,155,0,0,155,155,155,155,
0,0,0,0,0,142,142,142,142,
0,0,0,0,0,0,177,177,177,
163,0,0,0,0,0,163,163,163,
150,0,0,0,0,150,150,150,150,
137,137,137,137,0,0,0,137,137,
171,171,171,171,171,171,0,0,0,
151,151,151,151,151,151,151,151,0,
138,0,138,138,138,138,138,138,138,
0,0,133,133,133,133,133,133,133,
0,0,0,0,0,0,165,165,165,
146,146,146,146,146,0,146,146,146,
134,134,134,134,134,0,134,134,134,
128,128,128,128,128,0,0,0,128,
160,0,0,0,0,0,0,0,160,
148,0,0,0,0,0,148,148,148,
129,129,129,129,129,0,129,129,129,
124,0,124,0,124,0,124,0,124,
154,0,154,0,154,0,154,0,0,
142,0,142,0,142,0,142,142,142,
131,0,131,0,131,0,0,0,0,
114,114,114,114,114,0,114,114,114,
0,0,0,0,0,0,0,0,119,
103,103,103,0,103,103,103,103,103,
107,107,107,0,107,0,0,0,107,
106,106,106,0,106,0,106,106,106,
95,95,95,95,0,0,0,0,0,
0,0,94,94,94,0,0,94,0,
0,93,93,93,93,93,93,0,0,
0,92,92,92,92,92,92,0,92,
0,0,0,91,91,91,0,0,91,
90,90,0,90,90,90,0,90,90,
0,0,0,0,0,0,0,0,0,
0,0,0,0,0,0,0,0,0,
0,0,0,0,0,0,0,0,0.