[layer]
type=Tile Layer 1
data=
1,4,1,1,3,1,1,21,1,
1,1,3,1,1,21,2,0,1,
1,1,1,4,5,21,2,19,1,
0,5,21,0,1,1,0,2,0,
5,1,1,1,1,21,1,6,1,
4,21,0,0,1,0,1,1,1,
4,1,1,1,1,21,1,1,1,
6,1,1,0,1,21,0,0,1,
1,1,1,21,6,1,3,0,4,
1,0,4,1,21,1,1,0,0,
3,0,0,21,0,1,1,5,0,
1,1,0,1,1,0,21,0,0,
1,6,1,0,0,21,1,4,0,
0,0,1,4,1,3,1,1,21,
0,21,0,2,1,0,1,1,1,
2,2,20,0,2,21,2,2,0,
1,2,2,21,1,0,1,0,0,
0,0,0,0,21,0,5,0,1,
0,1,2,2,2,1,21,1,1,
0,4,2,19,2,5,21,1,1,
21,1,2,2,2,2,2,2,1,
0,0,21,2,0,0,20,2,2,
1,1,21,1,1,2,2,2,1,
5,3,0,1,0,0,21,0,0,
1,2,21,2,0,1,6,1,1,
2,2,20,2,21,2,0,2,2,
1,2,0,2,21,1,0,5,1,
1,0,0,0,0,21,3,0,0,
1,5,1,21,1,1,1,1,1,
0,18,2,21,2,2,2,0,2,
6,1,2,21,2,1,1,0,1,
2,2,0,20,0,21,2,0,0,
1,4,2,21,2,0,2,1,1,
1,1,4,21,2,19,2,1,1,
1,4,1,21,2,2,2,1,1,
3,0,1,21,6,0,1,1,1,
2,2,21,0,0,18,0,2,2,
1,1,4,1,21,2,0,2,6,
1,1,0,1,0,21,24,2,1,
0,21,6,1,1,2,24,2,1,
3,1,1,4,0,0,0,21,0,
0,21,1,0,1,1,0,2,0,
0,0,1,0,21,0,0,2,24,
1,0,1,1,5,1,21,3,0,
1,0,21,0,0,0,0,0,0,
1,0,21,0,0,0,0,0,1,
5,21,1,6,1,1,2,19,1,
2,21,2,2,2,2,2,18,2,
1,21,3,1,1,1,3,0,1,
0,0,1,1,1,1,4,21,4,
1,1,6,1,1,1,1,21,1,
0,0,0,0,0,0,0,0,0,
0,0,0,0,0,0,0,0,0,
0,0,0,0,0,0,0,0,0.
[layer]
type=Tile Layer 2
data=
223,223,223,223,223,223,223,0,223,
233,233,233,233,233,0,233,0,233,
231,231,231,231,231,0,231,0,231,
0,174,0,0,174,174,0,174,0,
152,152,152,152,152,0,152,152,152,
199,0,0,0,199,0,199,199,199,
175,175,175,175,175,0,175,175,175,
169,169,169,0,169,0,0,0,169,
155,155,155,0,155,155,155,0,155,
193,0,193,193,0,193,193,0,0,
179,0,0,0,0,179,179,179,0,
165,165,0,165,165,0,0,0,0,
150,150,150,0,0,0,150,150,0,
0,0,188,188,188,188,188,188,0,
0,0,0,174,174,0,174,174,174,
160,160,0,0,160,0,160,160,0,
146,146,146,0,146,0,146,0,0,
0,0,0,0,0,0,182,0,182,
0,168,168,168,168,168,0,168,168,
0,155,155,0,155,155,0,155,155,
0,135,135,135,135,135,135,135,135,
0,0,0,177,0,0,0,177,177,
155,155,0,155,155,155,155,155,155,
150,150,0,150,0,0,0,0,0,
137,137,0,137,0,137,137,137,137,
171,171,0,171,0,171,0,171,171,
158,158,0,158,0,158,0,158,158,
145,0,0,0,0,0,145,0,0,
127,127,127,0,127,127,127,127,127,
0,0,165,0,165,165,165,0,165,
153,153,153,0,153,153,153,0,153,
141,141,0,0,0,0,141,0,0,
128,128,128,0,128,0,128,128,128,
160,160,160,0,160,0,160,160,160,
141,141,141,0,141,141,141,141,141,
136,0,136,0,136,0,136,136,136,
124,124,0,0,0,0,0,124,124,
154,154,154,154,0,154,0,154,154,
142,142,0,142,0,0,0,142,142,
0,0,131,131,131,131,0,131,131,
120,120,120,120,0,0,0,0,0,
0,0,119,0,119,119,0,119,0,
0,0,108,0,0,0,0,108,0,
107,0,107,107,107,107,0,107,0,
106,0,0,0,0,0,0,0,0,
95,0,0,0,0,0,0,0,95,
94,0,94,94,94,94,94,0,94,
93,0,93,93,93,93,93,0,93,
92,0,92,92,92,92,92,0,92,
0,0,91,91,91,91,91,0,91,
86,86,86,86,86,86,86,0,86,
0,0,0,0,0,0,0,0,0,
0,0,0,0,0,0,0,0,0,
0,0,0,0,0,0,0,0,0.