[layer]
type=Tile Layer 1
data=
1,1,1,1,0,1,21,1,0,
0,1,1,1,0,1,0,1,21,
0,1,1,1,0,1,0,1,21,
0,1,1,1,1,1,1,1,21,
0,1,1,1,1,21,0,0,0,
0,1,1,1,0,21,1,1,1,
0,0,21,1,1,1,1,0,1,
0,1,0,0,0,1,1,21,0,
0,1,0,1,1,1,1,1,21,
1,1,0,0,1,1,1,21,0,
1,0,0,21,0,1,0,0,1,
0,0,21,1,0,1,1,1,1,
0,21,1,1,1,0,1,1,1,
1,21,1,1,1,0,1,1,1,
1,0,0,21,0,0,1,1,1,
1,1,1,21,1,1,1,1,1,
1,1,1,21,0,0,1,0,0,
1,1,1,21,1,1,1,1,1,
0,0,1,21,1,1,1,1,1,
1,1,1,21,1,1,1,1,1,
1,1,1,0,21,0,0,0,0,
1,1,1,1,21,1,0,1,1,
0,1,21,0,0,1,0,1,1,
0,1,1,1,0,1,21,1,1,
0,1,1,1,0,0,0,21,0,
1,1,1,1,21,1,1,1,1,
0,1,1,1,21,1,1,1,1,
0,1,1,1,21,1,1,1,1,
0,21,0,0,0,1,1,1,1,
21,1,1,1,1,1,1,1,1,
1,1,1,0,21,1,1,1,0,
1,1,0,21,1,1,1,1,0,
1,1,0,1,1,1,0,21,0,
1,21,0,1,1,0,1,1,0,
1,21,1,1,0,1,1,0,0,
1,0,1,1,0,21,0,1,1,
0,0,1,1,1,1,0,21,0,
0,21,0,0,0,0,0,1,1,
0,1,1,0,0,0,0,21,0,
1,1,1,1,1,21,1,1,1,
1,1,1,1,1,21,1,1,1,
1,1,1,1,1,21,1,1,1,
0,21,0,0,1,0,1,1,1,
1,1,1,21,1,0,1,1,1,
0,0,1,0,1,0,0,0,21,
0,0,0,0,0,0,0,0,0,
0,0,0,0,0,0,0,0,0,
0,0,0,0,0,0,0,0,0.
[layer]
type=Tile Layer 2
data=
208,208,208,208,0,208,0,208,0,
0,206,206,206,0,206,0,206,0,
0,204,204,204,0,204,0,204,0,
0,178,178,178,178,178,178,178,0,
0,165,165,165,165,0,0,0,0,
0,152,152,152,0,0,152,152,152,
0,0,0,138,138,138,138,0,138,
0,173,0,0,0,173,173,0,0,
0,160,0,160,160,160,160,160,0,
147,147,0,0,147,147,147,0,0,
134,0,0,0,0,134,0,0,134,
0,0,0,167,0,167,167,167,167,
0,0,154,154,154,0,154,154,154,
142,0,142,142,142,0,142,142,142,
130,0,0,0,0,0,130,130,130,
154,154,154,0,154,154,154,154,154,
149,149,149,0,0,0,149,0,0,
131,131,131,0,131,131,131,131,131,
0,0,125,0,125,125,125,125,125,
148,148,148,0,148,148,148,148,148,
144,144,144,0,0,0,0,0,0,
132,132,132,132,0,132,0,132,132,
0,121,0,0,0,121,0,121,121,
0,150,150,150,0,150,0,150,150,
0,139,139,139,0,0,0,0,0,
122,122,122,122,0,122,122,122,122,
0,116,116,116,0,116,116,116,116,
0,145,145,145,0,145,145,145,145,
0,0,0,0,0,134,134,134,134,
0,117,117,117,117,117,117,117,117,
112,112,112,0,0,112,112,112,0,
139,139,0,0,139,139,139,139,0,
128,128,0,128,128,128,0,0,0,
118,0,0,118,118,0,118,118,0,
108,0,108,108,0,108,108,0,0,
107,0,107,107,0,0,0,107,107,
0,0,97,97,97,97,0,0,0,
0,0,0,0,0,0,0,96,96,
0,95,95,0,0,0,0,0,0,
81,81,81,81,81,0,81,81,81,
80,80,80,80,80,0,80,80,80,
79,79,79,79,79,0,79,79,79,
0,0,0,0,82,0,82,82,82,
81,81,81,0,81,0,81,81,81,
0,0,80,0,80,0,0,0,0,
0,0,0,0,0,0,0,0,0,
0,0,0,0,0,0,0,0,0,
0,0,0,0,0,0,0,0,0.