[layer]
type=Tile Layer 1
data=
0,0,1,1,21,0,1,1,1,
1,0,0,0,21,1,0,1,1,
1,1,1,1,1,1,21,1,1,
0,21,0,0,1,1,0,1,1,
0,0,1,1,0,21,0,1,1,
1,1,21,0,1,1,1,1,1,
0,0,0,21,0,0,0,1,1,
0,0,1,1,21,1,1,1,1,
0,21,1,1,0,1,1,1,1,
0,0,1,1,1,0,21,0,1,
1,0,21,0,0,1,1,0,1,
1,1,1,1,1,1,1,21,1,
0,0,1,1,1,0,0,21,1,
0,1,1,1,21,1,1,1,1,
0,0,0,1,0,21,1,1,1,
1,21,1,1,1,0,1,0,1,
1,0,1,21,0,0,1,0,0,
1,1,1,21,1,1,1,1,1,
1,0,0,0,0,0,21,0,1,
1,21,1,1,1,1,1,1,1,
1,0,1,21,0,0,0,0,0,
1,21,1,0,1,1,1,1,1,
1,21,1,0,1,0,0,0,1,
1,0,1,0,1,21,1,0,1,
1,1,1,1,21,1,0,1,1,
0,1,1,1,0,1,21,0,0,
0,1,1,1,21,1,1,1,1,
0,0,1,1,1,1,1,0,21,
0,1,1,1,0,1,1,1,21,
0,0,0,1,21,1,1,1,0,
0,1,1,1,0,1,1,1,21,
0,1,0,1,21,1,1,1,0,
0,1,0,1,21,1,1,1,1,
0,21,1,0,1,0,1,1,1,
1,1,1,21,1,0,1,1,1,
1,0,0,0,21,0,0,0,1,
1,1,1,1,1,1,1,21,1,
0,0,0,0,21,0,1,0,1,
1,1,1,1,1,21,1,0,1,
0,0,0,0,0,0,0,0,0,
0,0,0,0,0,0,0,0,0,
0,0,0,0,0,0,0,0,0.
[layer]
type=Tile Layer 2
data=
0,0,197,197,0,0,197,197,197,
195,0,0,0,0,195,0,195,195,
184,184,184,184,184,184,0,184,184,
0,0,0,0,146,146,0,146,146,
0,0,133,133,0,0,0,133,133,
166,166,0,0,166,166,166,166,166,
0,0,0,0,0,0,0,153,153,
0,0,141,141,0,141,141,141,141,
0,0,129,129,0,129,129,129,129,
0,0,161,161,161,0,0,0,161,
148,0,0,0,0,148,148,0,148,
130,130,130,130,130,130,130,0,130,
0,0,124,124,124,0,0,0,124,
0,155,155,155,0,155,155,155,155,
0,0,0,143,0,0,143,143,143,
131,0,131,131,131,0,131,0,131,
120,0,120,0,0,0,120,0,0,
142,142,142,0,142,142,142,142,142,
138,0,0,0,0,0,0,0,138,
121,0,121,121,121,121,121,121,121,
115,0,115,0,0,0,0,0,0,
144,0,144,0,144,144,144,144,144,
133,0,133,0,133,0,0,0,133,
122,0,122,0,122,0,122,0,122,
111,111,111,111,0,111,0,111,111,
0,138,138,138,0,138,0,0,0,
0,127,127,127,0,127,127,127,127,
0,0,117,117,117,117,117,0,0,
0,107,107,107,0,107,107,107,0,
0,0,0,106,0,106,106,106,0,
0,96,96,96,0,96,96,96,0,
0,95,0,95,0,95,95,95,0,
0,94,0,94,0,94,94,94,94,
0,0,84,0,84,0,84,84,84,
83,83,83,0,83,0,83,83,83,
82,0,0,0,0,0,0,0,82,
77,77,77,77,77,77,77,0,77,
0,0,0,0,0,0,80,0,80,
79,79,79,79,79,0,79,0,79,
0,0,0,0,0,0,0,0,0,
0,0,0,0,0,0,0,0,0,
0,0,0,0,0,0,0,0,0.