[layer]
type=Tile Layer 1
data=
2,2,21,9,2,2,2,2,2,
0,21,2,2,0,0,0,2,1,
2,2,2,2,2,2,21,9,2,
0,21,0,0,0,0,2,2,0,
1,1,21,1,6,1,1,1,6,
5,3,0,21,1,1,1,1,0,
1,1,0,21,0,3,1,5,1,
0,0,0,21,0,2,2,4,1,
0,21,1,1,2,8,2,1,1,
1,21,1,1,2,2,2,4,1,
0,21,1,4,0,1,1,1,5,
0,1,0,21,0,0,1,3,1,
0,21,0,0,0,0,0,1,1,
0,3,1,1,1,6,21,1,1,
0,21,0,0,0,0,0,2,2,
2,2,1,5,1,21,1,2,8,
9,2,2,21,2,2,2,2,0,
2,0,1,21,1,0,1,3,1,
0,2,2,2,7,2,2,2,21,
1,4,1,21,2,2,5,1,1,
0,0,1,2,8,0,21,0,0,
0,0,0,0,0,0,0,0,0,
0,0,0,0,0,0,0,0,0,
0,0,0,0,0,0,0,0,0.
[layer]
type=Tile Layer 2
data=
127,127,0,127,127,127,127,127,127,
0,0,132,132,0,0,0,132,132,
124,124,124,124,124,124,0,124,124,
0,0,0,0,0,0,113,113,0,
94,94,0,94,94,94,94,94,94,
95,95,0,0,95,95,95,95,0,
86,86,0,0,0,86,86,86,86,
0,0,0,0,0,107,107,107,107,
0,0,98,98,98,98,98,98,98,
81,0,81,81,81,81,81,81,81,
0,0,82,82,0,82,82,82,82,
0,81,0,0,0,0,81,81,81,
0,0,0,0,0,0,0,73,73,
0,68,68,68,68,68,0,68,68,
0,0,0,0,0,0,0,71,71,
60,60,60,60,60,0,60,60,60,
62,62,62,0,62,62,62,62,0,
61,0,61,0,61,0,61,61,61,
0,60,60,60,60,60,60,60,0,
54,54,54,0,54,54,54,54,54,
0,0,58,58,58,0,0,0,0,
0,0,0,0,0,0,0,0,0,
0,0,0,0,0,0,0,0,0,
0,0,0,0,0,0,0,0,0.