[layer]
type=Tile Layer 1
data=
0,1,21,1,1,0,0,1,1,
1,1,0,1,1,1,21,1,1,
1,1,0,1,0,1,1,1,21,
0,1,1,2,0,2,21,1,0,
0,1,0,0,0,1,21,1,0,
1,1,1,2,24,2,21,1,1,
0,1,1,0,0,21,1,1,1,
1,1,21,0,1,0,0,1,1,
1,21,0,1,0,1,0,0,1,
1,0,5,0,1,21,1,0,1,
1,0,0,1,21,1,0,3,0,
1,1,0,0,1,1,1,21,0,
0,0,0,0,0,0,0,0,0,
0,0,0,0,0,0,0,0,0,
0,0,0,0,0,0,0,0,0.
[layer]
type=Tile Layer 2
data=
0,89,0,89,89,0,0,89,89,
60,60,0,60,60,60,0,60,60,
63,63,0,63,0,63,63,63,0,
0,62,62,62,0,62,0,62,0,
0,55,0,0,0,55,0,55,0,
51,51,51,51,0,51,0,51,51,
0,53,53,0,0,0,53,53,53,
52,52,0,0,52,0,0,52,52,
51,0,0,51,0,51,0,0,51,
50,0,50,0,50,0,50,0,50,
49,0,0,49,0,49,0,49,0,
48,48,0,0,48,48,48,0,0,
0,0,0,0,0,0,0,0,0,
0,0,0,0,0,0,0,0,0,
0,0,0,0,0,0,0,0,0.