[layer]
type=Tile Layer 1
data=
1,0,1,21,0,5,0,1,0,
0,21,2,0,1,1,0,1,1,
1,2,21,2,1,1,3,1,1,
1,2,19,21,0,1,1,0,6,
2,2,2,21,0,1,4,1,1,
20,0,2,21,2,2,2,2,2,
0,2,2,1,0,5,21,1,0,
0,24,0,1,0,1,0,0,21,
6,1,1,3,1,1,21,1,1,
0,0,21,5,6,0,0,1,0,
0,1,1,5,21,6,4,1,1,
0,1,0,21,0,4,0,0,0,
0,0,0,0,0,0,0,0,0,
0,0,0,0,0,0,0,0,0,
0,0,0,0,0,0,0,0,0.
[layer]
type=Tile Layer 2
data=
88,0,88,0,0,88,0,88,0,
0,0,63,0,63,63,0,63,63,
56,56,0,56,56,56,56,56,56,
61,61,0,0,0,61,61,0,61,
51,51,51,0,0,51,51,51,51,
0,0,53,0,53,53,53,53,53,
0,52,52,52,0,52,0,52,0,
0,0,0,51,0,51,0,0,0,
45,45,45,45,45,45,0,45,45,
0,0,0,49,49,0,0,49,0,
0,46,46,46,0,46,46,46,46,
0,47,0,0,0,47,0,0,0,
0,0,0,0,0,0,0,0,0,
0,0,0,0,0,0,0,0,0,
0,0,0,0,0,0,0,0,0.