[layer]
type=Tile Layer 1
data=
1,1,0,0,0,21,1,0,1,
0,0,0,21,0,0,0,0,1,
0,21,1,1,1,1,0,1,1,
1,21,1,1,1,1,0,1,1,
1,21,1,1,1,1,1,0,1,
0,0,1,1,1,1,1,0,21,
0,0,21,1,1,1,1,0,0,
1,1,21,1,1,1,1,0,1,
1,1,21,1,1,1,1,0,0,
0,1,21,1,1,1,1,1,1,
0,1,0,1,0,0,0,21,0,
1,1,21,1,1,1,0,1,1,
0,0,21,1,1,1,0,1,1,
1,1,21,1,1,1,0,1,1,
0,1,0,1,21,1,0,1,0,
1,1,1,1,21,1,0,1,1,
1,1,1,1,0,1,0,21,0,
1,1,1,1,21,1,0,1,1,
1,1,1,1,1,1,21,1,1,
0,0,1,0,1,0,0,21,0,
1,21,1,0,1,0,1,1,1,
1,0,1,0,21,0,0,0,0,
1,21,1,1,1,1,1,1,1,
1,0,0,0,1,0,21,0,0,
1,1,1,21,1,1,1,1,1,
0,0,1,0,21,0,0,0,1,
1,21,1,1,1,1,1,0,1,
1,1,0,1,0,1,21,0,0,
1,1,21,1,0,1,1,1,0,
0,0,21,1,0,0,0,1,0,
1,1,1,1,1,1,21,1,1,
0,1,1,1,1,1,21,0,0,
0,1,1,1,1,1,21,1,1,
0,0,0,0,0,0,0,0,0,
0,0,0,0,0,0,0,0,0,
0,0,0,0,0,0,0,0,0.
[layer]
type=Tile Layer 2
data=
171,171,0,0,0,0,171,0,171,
0,0,0,0,0,0,0,0,170,
0,0,168,168,168,168,0,168,168,
147,0,147,147,147,147,0,147,147,
135,0,135,135,135,135,135,0,135,
0,0,124,124,124,124,124,0,0,
0,0,0,113,113,113,113,0,0,
141,141,0,141,141,141,141,0,141,
130,130,0,130,130,130,130,0,0,
0,119,0,119,119,119,119,119,119,
0,109,0,109,0,0,0,0,0,
135,135,0,135,135,135,0,135,135,
0,0,0,125,125,125,0,125,125,
115,115,0,115,115,115,0,115,115,
0,104,0,104,0,104,0,104,0,
130,130,130,130,0,130,0,130,130,
120,120,120,120,0,120,0,0,0,
110,110,110,110,0,110,0,110,110,
95,95,95,95,95,95,0,95,95,
0,0,124,0,124,0,0,0,0,
114,0,114,0,114,0,114,114,114,
105,0,105,0,0,0,0,0,0,
91,0,91,91,91,91,91,91,91,
95,0,0,0,95,0,0,0,0,
82,82,82,0,82,82,82,82,82,
0,0,85,0,0,0,0,0,85,
84,0,84,84,84,84,84,0,84,
75,75,0,75,0,75,0,0,0,
74,74,0,74,0,74,74,74,0,
0,0,0,73,0,0,0,73,0,
69,69,69,69,69,69,0,69,69,
0,71,71,71,71,71,0,0,0,
0,70,70,70,70,70,0,70,70,
0,0,0,0,0,0,0,0,0,
0,0,0,0,0,0,0,0,0,
0,0,0,0,0,0,0,0,0.