[layer]
type=Tile Layer 1
data=
1,1,1,1,1,1,1,21,1,
1,0,0,0,0,0,0,21,0,
1,1,1,1,1,1,1,21,1,
1,21,1,1,1,1,1,0,1,
1,21,1,1,1,1,1,1,1,
0,21,0,0,1,0,0,0,0,
0,21,1,1,1,1,1,1,0,
0,0,1,1,1,1,1,1,21,
0,0,1,1,1,1,1,1,21,
0,21,1,1,1,1,1,1,1,
1,0,0,0,21,0,0,0,0,
1,1,1,21,1,1,1,1,0,
1,0,0,0,1,21,0,0,0,
0,1,1,21,0,0,1,1,0,
0,0,21,1,1,1,1,1,1,
1,1,1,1,1,21,1,1,1,
0,0,21,0,0,0,1,0,0,
1,1,1,1,1,21,1,1,1,
0,0,0,21,1,0,0,0,0,
1,1,1,1,1,21,1,1,1,
1,0,0,0,21,0,1,1,1,
0,0,0,0,0,0,0,0,0,
0,0,0,0,0,0,0,0,0,
0,0,0,0,0,0,0,0,0.
[layer]
type=Tile Layer 2
data=
120,120,120,120,120,120,120,0,120,
132,0,0,0,0,0,0,0,0,
117,117,117,117,117,117,117,0,117,
107,0,107,107,107,107,107,0,107,
94,0,94,94,94,94,94,94,94,
0,0,0,0,95,0,0,0,0,
0,0,86,86,86,86,86,86,0,
0,0,107,107,107,107,107,107,0,
0,0,98,98,98,98,98,98,0,
0,0,86,86,86,86,86,86,86,
82,0,0,0,0,0,0,0,0,
77,77,77,0,77,77,77,77,0,
73,0,0,0,73,0,0,0,0,
0,72,72,0,0,0,72,72,0,
0,0,0,71,71,71,71,71,71,
57,57,57,57,57,0,57,57,57,
0,0,0,0,0,0,62,0,0,
55,55,55,55,55,0,55,55,55,
0,0,0,0,60,0,0,0,0,
54,54,54,54,54,0,54,54,54,
58,0,0,0,0,0,58,58,58,
0,0,0,0,0,0,0,0,0,
0,0,0,0,0,0,0,0,0,
0,0,0,0,0,0,0,0,0.