[layer]
type=Tile Layer 1
data=
0,2,2,0,20,0,1,21,2,
0,0,0,2,2,2,1,1,21,
5,1,0,1,21,0,1,0,2,
0,4,21,1,1,1,1,2,0,
0,2,1,1,21,1,1,0,24,
21,2,2,5,1,1,1,3,5,
0,19,5,1,0,0,21,6,0,
5,2,3,5,21,1,0,4,1,
0,1,0,0,0,1,0,21,0,
0,0,0,0,0,0,0,0,0,
0,0,0,0,0,0,0,0,0,
0,0,0,0,0,0,0,0,0.
[layer]
type=Tile Layer 2
data=
0,79,79,0,0,0,79,0,79,
0,0,0,50,50,50,50,50,0,
49,49,0,49,0,0,49,0,49,
0,48,0,48,48,48,48,48,0,
0,48,48,48,0,48,48,0,0,
0,42,42,42,42,42,42,42,42,
0,0,46,46,0,0,0,46,0,
43,43,43,43,0,43,0,43,43,
0,44,0,0,0,44,0,0,0,
0,0,0,0,0,0,0,0,0,
0,0,0,0,0,0,0,0,0,
0,0,0,0,0,0,0,0,0.