[layer]
type=Tile Layer 1
data=
0,0,0,0,1,1,0,21,1,
2,2,21,2,2,2,2,18,0,
1,1,0,1,1,1,1,21,0,
1,1,21,0,1,1,1,1,0,
0,0,21,0,1,1,1,1,0,
19,2,1,1,1,1,1,2,21,
2,2,0,2,2,2,2,21,20,
0,19,0,1,1,1,1,0,21,
0,0,2,1,1,1,1,21,2,
2,2,2,2,2,0,2,21,20,
1,19,2,0,21,0,1,2,0,
1,2,2,0,0,21,0,1,0,
1,1,0,21,1,2,2,2,0,
1,1,0,1,0,21,24,0,0,
1,1,0,21,0,0,2,0,0,
0,0,1,21,2,24,0,0,0,
1,21,1,0,1,1,1,0,1,
1,0,1,21,0,0,1,0,1,
1,21,1,1,1,0,1,1,1,
1,0,0,21,1,0,0,0,1,
2,2,2,21,2,2,2,18,2,
0,0,0,0,21,0,1,0,1,
1,1,1,1,1,21,1,0,1,
1,0,21,0,1,0,1,0,1,
1,1,1,1,21,1,1,1,1,
0,21,0,1,0,1,1,1,1,
1,1,1,1,21,2,2,2,1,
1,1,1,1,0,21,19,0,0,
1,1,1,1,21,2,2,2,1,
0,0,0,1,0,1,21,0,0,
1,1,1,1,21,1,1,1,1,
1,1,1,1,0,0,21,0,0,
1,1,1,1,1,1,21,1,1,
1,1,1,21,1,1,1,1,1,
1,1,1,0,1,21,0,0,1,
1,1,1,21,1,1,2,19,1,
0,0,21,0,1,0,0,0,1,
1,21,1,1,1,1,1,0,1,
1,21,1,1,1,1,1,0,1,
0,0,0,0,0,0,0,0,0,
0,0,0,0,0,0,0,0,0,
0,0,0,0,0,0,0,0,0.
[layer]
type=Tile Layer 2
data=
0,0,0,0,197,197,0,0,197,
195,195,0,195,195,195,195,0,0,
194,194,0,194,194,194,194,0,0,
146,146,0,0,146,146,146,146,0,
0,0,0,0,133,133,133,133,0,
0,166,166,166,166,166,166,166,0,
153,153,0,153,153,153,153,0,0,
0,0,0,141,141,141,141,0,0,
0,0,129,129,129,129,129,0,129,
161,161,161,161,161,0,161,0,0,
148,0,148,0,0,0,148,148,0,
136,136,136,0,0,0,0,136,0,
124,124,0,0,124,124,124,124,0,
155,155,0,155,0,0,0,0,0,
143,143,0,0,0,0,143,0,0,
0,0,131,0,131,0,0,0,0,
120,0,120,0,120,120,120,0,120,
149,0,149,0,0,0,149,0,149,
138,0,138,138,138,0,138,138,138,
127,0,0,0,127,0,0,0,127,
115,115,115,0,115,115,115,0,115,
0,0,0,0,0,0,144,0,144,
133,133,133,133,133,0,133,0,133,
122,0,0,0,122,0,122,0,122,
106,106,106,106,0,106,106,106,106,
0,0,0,138,0,138,138,138,138,
121,121,121,121,0,121,121,121,121,
117,117,117,117,0,0,0,0,0,
102,102,102,102,0,102,102,102,102,
0,0,0,106,0,106,0,0,0,
91,91,91,91,0,91,91,91,91,
95,95,95,95,0,0,0,0,0,
89,89,89,89,89,89,0,89,89,
80,80,80,0,80,80,80,80,80,
83,83,83,0,83,0,0,0,83,
82,82,82,0,82,82,82,0,82,
0,0,0,0,81,0,0,0,81,
80,0,80,80,80,80,80,0,80,
79,0,79,79,79,79,79,0,79,
0,0,0,0,0,0,0,0,0,
0,0,0,0,0,0,0,0,0,
0,0,0,0,0,0,0,0,0.