[layer]
type=Tile Layer 1
data=
1,1,1,21,1,1,1,1,0,
1,1,1,0,21,0,1,0,0,
1,1,1,1,1,21,1,0,1,
1,1,1,21,0,0,0,0,1,
1,1,21,0,1,0,0,1,1,
1,1,21,1,1,0,1,1,1,
1,1,0,1,1,1,21,0,1,
1,1,0,21,0,0,1,1,0,
1,1,1,1,1,1,21,0,0,
0,1,1,1,21,1,0,1,1,
0,1,0,21,0,1,0,0,0,
0,1,1,1,21,1,1,1,1,
0,21,0,1,0,1,0,1,0,
0,1,1,1,1,1,0,1,21,
0,1,1,1,1,1,0,1,21,
0,1,1,1,1,1,0,1,21,
0,1,1,1,1,1,21,1,0,
0,1,1,1,1,1,21,1,1,
1,21,1,1,1,0,0,1,0,
1,1,1,1,1,1,21,1,1,
0,0,0,21,1,0,0,0,1,
1,1,1,21,1,0,1,0,1,
0,21,1,0,0,0,1,0,1,
1,1,1,1,1,21,1,0,1,
1,0,0,0,1,21,1,0,1,
1,0,1,0,1,21,1,0,1,
0,21,1,0,1,0,1,0,1,
1,1,1,1,1,21,1,1,1,
0,0,0,0,1,0,21,0,0,
1,1,1,21,1,1,1,0,1,
1,0,1,21,1,1,1,0,0,
1,0,1,21,1,1,1,0,1,
1,0,21,0,1,1,1,0,1,
0,0,0,0,0,0,0,0,0,
0,0,0,0,0,0,0,0,0,
0,0,0,0,0,0,0,0,0.
[layer]
type=Tile Layer 2
data=
171,171,171,0,171,171,171,171,0,
170,170,170,0,0,0,170,0,0,
168,168,168,168,168,0,168,0,168,
147,147,147,0,0,0,0,0,147,
135,135,0,0,135,0,0,135,135,
124,124,0,124,124,0,124,124,124,
113,113,0,113,113,113,0,0,113,
141,141,0,0,0,0,141,141,0,
130,130,130,130,130,130,0,0,0,
0,119,119,119,0,119,0,119,119,
0,109,0,0,0,109,0,0,0,
0,135,135,135,0,135,135,135,135,
0,0,0,125,0,125,0,125,0,
0,115,115,115,115,115,0,115,0,
0,104,104,104,104,104,0,104,0,
0,130,130,130,130,130,0,130,0,
0,120,120,120,120,120,0,120,0,
0,110,110,110,110,110,0,110,110,
100,0,100,100,100,0,0,100,0,
118,118,118,118,118,118,0,118,118,
0,0,0,0,114,0,0,0,114,
105,105,105,0,105,0,105,0,105,
0,0,96,0,0,0,96,0,96,
95,95,95,95,95,0,95,0,95,
86,0,0,0,86,0,86,0,86,
85,0,85,0,85,0,85,0,85,
0,0,84,0,84,0,84,0,84,
71,71,71,71,71,0,71,71,71,
0,0,0,0,74,0,0,0,0,
73,73,73,0,73,73,73,0,73,
72,0,72,0,72,72,72,0,0,
71,0,71,0,71,71,71,0,71,
70,0,0,0,70,70,70,0,70,
0,0,0,0,0,0,0,0,0,
0,0,0,0,0,0,0,0,0,
0,0,0,0,0,0,0,0,0.