[layer]
type=Tile Layer 1
data=
0,1,1,1,21,1,0,4,0,
0,1,0,1,1,5,1,6,21,
1,1,0,1,0,21,0,1,0,
1,0,21,1,1,1,0,0,0,
0,0,3,4,0,1,6,0,21,
0,1,1,1,1,1,3,1,21,
0,1,0,1,21,1,0,1,0,
0,1,5,0,1,21,1,1,0,
0,0,6,1,3,1,1,21,0,
0,0,0,0,0,0,0,0,0,
0,0,0,0,0,0,0,0,0,
0,0,0,0,0,0,0,0,0.
[layer]
type=Tile Layer 2
data=
0,79,79,79,0,79,0,79,0,
0,50,0,50,50,50,50,50,0,
49,49,0,49,0,0,0,49,0,
48,0,0,48,48,48,0,0,0,
0,0,48,48,0,48,48,0,0,
0,44,44,44,44,44,44,44,0,
0,46,0,46,0,46,0,46,0,
0,45,45,0,45,0,45,45,0,
0,0,44,44,44,44,44,0,0,
0,0,0,0,0,0,0,0,0,
0,0,0,0,0,0,0,0,0,
0,0,0,0,0,0,0,0,0.