[layer]
type=Tile Layer 1
data=
1,21,1,1,1,0,1,1,1,
2,0,2,2,2,21,2,0,18,
1,1,1,1,1,21,1,1,1,
0,0,0,21,0,0,1,1,1,
1,1,2,2,2,21,1,1,1,
0,0,21,24,2,0,1,1,1,
1,1,1,1,1,21,1,1,1,
0,0,0,21,0,0,2,0,0,
1,21,1,1,1,1,2,19,1,
0,0,21,0,1,1,2,2,1,
0,24,21,0,1,1,1,1,1,
0,1,1,0,0,21,0,1,1,
0,0,21,1,1,1,0,0,1,
0,2,0,1,1,1,1,21,0,
20,0,0,2,2,2,2,2,21,
2,2,21,1,1,1,1,1,0,
1,1,21,1,1,1,1,1,0,
1,1,21,1,1,2,2,2,0,
0,2,1,1,21,2,19,2,1,
24,2,1,1,21,2,2,2,0,
1,1,1,1,1,1,1,1,21,
0,21,0,18,0,2,2,2,0,
1,1,1,1,1,1,1,1,21,
0,0,0,1,21,0,0,0,0,
0,1,1,1,1,1,1,1,21,
0,1,1,1,0,1,0,1,21,
0,1,1,1,0,1,0,1,21,
1,1,1,0,0,1,21,0,1,
1,1,1,1,21,1,1,0,1,
1,21,1,1,1,1,1,0,1,
0,0,1,0,0,0,21,0,1,
20,2,2,21,2,2,2,2,2,
0,2,1,21,1,1,1,1,1,
0,0,0,0,0,0,0,0,0,
0,0,0,0,0,0,0,0,0,
0,0,0,0,0,0,0,0,0.
[layer]
type=Tile Layer 2
data=
171,0,171,171,171,0,171,171,171,
170,0,170,170,170,0,170,0,0,
160,160,160,160,160,0,160,160,160,
0,0,0,0,0,0,147,147,147,
129,129,129,129,129,0,129,129,129,
0,0,0,0,124,0,124,124,124,
108,108,108,108,108,0,108,108,108,
0,0,0,0,0,0,141,0,0,
130,0,130,130,130,130,130,0,130,
0,0,0,0,119,119,119,119,119,
0,0,0,0,109,109,109,109,109,
0,135,135,0,0,0,0,135,135,
0,0,0,125,125,125,0,0,125,
0,115,0,115,115,115,115,0,0,
0,0,0,104,104,104,104,104,0,
130,130,0,130,130,130,130,130,0,
120,120,0,120,120,120,120,120,0,
110,110,0,110,110,110,110,110,0,
0,100,100,100,0,100,0,100,100,
0,124,124,124,0,124,124,124,0,
109,109,109,109,109,109,109,109,0,
0,0,0,0,0,105,105,105,0,
91,91,91,91,91,91,91,91,0,
0,0,0,95,0,0,0,0,0,
0,86,86,86,86,86,86,86,0,
0,85,85,85,0,85,0,85,0,
0,84,84,84,0,84,0,84,0,
75,75,75,0,0,75,0,0,75,
74,74,74,74,0,74,74,0,74,
73,0,73,73,73,73,73,0,73,
0,0,72,0,0,0,0,0,72,
0,71,71,0,71,71,71,71,71,
0,70,70,0,70,70,70,70,70,
0,0,0,0,0,0,0,0,0,
0,0,0,0,0,0,0,0,0,
0,0,0,0,0,0,0,0,0.