[layer]
type=Tile Layer 1
data=
1,1,1,1,0,0,0,21,0,
1,1,1,21,1,1,1,1,0,
1,1,1,0,0,21,0,0,0,
1,0,0,0,1,21,0,0,1,
1,21,1,0,1,1,1,1,1,
1,0,1,21,1,0,1,1,1,
1,21,1,0,1,0,1,1,1,
1,0,1,0,1,21,1,0,0,
1,21,1,0,1,1,1,1,1,
1,0,1,0,0,21,0,0,0,
1,1,1,1,1,21,1,1,1,
0,21,0,0,1,0,1,1,1,
0,1,1,1,0,1,1,1,21,
0,1,0,0,1,0,0,1,21,
0,0,1,1,1,1,1,21,0,
0,1,0,1,1,1,0,1,21,
0,0,1,0,1,0,1,21,0,
0,1,0,1,1,1,21,1,0,
0,0,0,0,0,0,0,0,0,
0,0,0,0,0,0,0,0,0,
0,0,0,0,0,0,0,0,0.
[layer]
type=Tile Layer 2
data=
128,128,128,128,0,0,0,0,0,
121,121,121,0,121,121,121,121,0,
125,125,125,0,0,0,0,0,0,
86,0,0,0,86,0,0,0,86,
102,0,102,0,102,102,102,102,102,
98,0,98,0,98,0,98,98,98,
90,0,90,0,90,0,90,90,90,
82,0,82,0,82,0,82,0,0,
77,0,77,0,77,77,77,77,77,
73,0,73,0,0,0,0,0,0,
65,65,65,65,65,0,65,65,65,
0,0,0,0,71,0,71,71,71,
0,63,63,63,0,63,63,63,0,
0,62,0,0,62,0,0,62,0,
0,0,61,61,61,61,61,0,0,
0,60,0,60,60,60,0,60,0,
0,0,59,0,59,0,59,0,0,
0,58,0,58,58,58,0,58,0,
0,0,0,0,0,0,0,0,0,
0,0,0,0,0,0,0,0,0,
0,0,0,0,0,0,0,0,0.