[layer]
type=Tile Layer 1
data=
1,1,1,1,1,0,1,21,0,
1,1,1,1,1,0,21,1,0,
1,1,1,1,1,1,21,1,0,
1,1,1,1,1,1,21,1,0,
1,0,21,0,0,1,1,0,0,
1,0,0,1,1,1,1,21,0,
1,1,0,0,21,1,1,1,0,
1,1,1,1,0,0,21,1,0,
1,1,1,1,1,1,21,1,0,
1,21,0,1,1,1,0,1,1,
1,1,21,1,1,1,0,0,0,
1,1,0,1,1,1,21,1,0,
1,1,0,21,1,1,0,0,0,
1,1,1,0,0,21,1,1,0,
1,1,1,0,1,21,1,1,0,
1,1,0,0,1,0,21,0,0,
1,1,0,21,1,0,1,1,1,
1,1,1,21,1,0,1,1,1,
0,0,1,0,0,0,1,21,0,
1,1,1,0,1,21,1,0,1,
1,0,21,0,1,0,0,0,1,
1,21,1,1,1,1,1,1,1,
0,0,1,0,0,0,1,0,21,
1,1,1,21,1,1,1,0,1,
0,21,1,0,0,0,1,0,1,
1,0,1,0,1,21,1,0,1,
1,0,1,0,1,21,0,0,1,
1,21,1,1,1,0,1,0,1,
1,21,1,0,1,0,1,0,0,
1,1,1,21,1,0,1,1,1,
1,1,1,0,1,0,0,21,0,
1,1,1,21,1,1,1,1,1,
1,1,1,0,21,0,0,0,1,
1,1,1,21,1,1,1,1,1,
0,0,1,21,1,1,1,1,1,
1,1,1,21,1,1,1,1,1,
1,21,1,1,1,1,1,0,0,
1,21,1,1,1,1,1,1,1,
0,0,0,0,0,0,21,0,1,
1,1,1,1,1,21,1,1,1,
1,1,1,1,1,0,1,21,0,
1,1,1,1,1,21,1,1,1,
0,0,0,0,0,0,0,0,0,
0,0,0,0,0,0,0,0,0,
0,0,0,0,0,0,0,0,0.
[layer]
type=Tile Layer 2
data=
203,203,203,203,203,0,203,0,0,
201,201,201,201,201,0,0,201,0,
200,200,200,200,200,200,0,200,0,
138,138,138,138,138,138,0,138,0,
173,0,0,0,0,173,173,0,0,
160,0,0,160,160,160,160,0,0,
147,147,0,0,0,147,147,147,0,
134,134,134,134,0,0,0,134,0,
167,167,167,167,167,167,0,167,0,
154,0,0,154,154,154,0,154,154,
142,142,0,142,142,142,0,0,0,
130,130,0,130,130,130,0,130,0,
162,162,0,0,162,162,0,0,0,
149,149,149,0,0,0,149,149,0,
137,137,137,0,137,0,137,137,0,
125,125,0,0,125,0,0,0,0,
156,156,0,0,156,0,156,156,156,
144,144,144,0,144,0,144,144,144,
0,0,132,0,0,0,132,0,0,
121,121,121,0,121,0,121,0,121,
150,0,0,0,150,0,0,0,150,
132,0,132,132,132,132,132,132,132,
0,0,128,0,0,0,128,0,0,
116,116,116,0,116,116,116,0,116,
0,0,145,0,0,0,145,0,145,
134,0,134,0,134,0,134,0,134,
123,0,123,0,123,0,0,0,123,
112,0,112,112,112,0,112,0,112,
139,0,139,0,139,0,139,0,0,
128,128,128,0,128,0,128,128,128,
118,118,118,0,118,0,0,0,0,
103,103,103,0,103,103,103,103,103,
107,107,107,0,0,0,0,0,107,
92,92,92,0,92,92,92,92,92,
0,0,96,0,96,96,96,96,96,
90,90,90,0,90,90,90,90,90,
85,0,85,85,85,85,85,0,0,
80,0,80,80,80,80,80,80,80,
0,0,0,0,0,0,0,0,83,
78,78,78,78,78,0,78,78,78,
81,81,81,81,81,0,81,0,0,
77,77,77,77,77,0,77,77,77,
0,0,0,0,0,0,0,0,0,
0,0,0,0,0,0,0,0,0,
0,0,0,0,0,0,0,0,0.