[layer]
type=Tile Layer 1
data=
1,1,1,1,21,0,0,1,1,
0,2,2,2,1,4,21,6,1,
0,0,19,0,21,0,1,5,1,
1,2,2,2,21,5,4,1,1,
0,21,24,2,0,1,1,1,0,
2,2,20,2,21,2,2,2,0,
1,2,0,2,21,6,4,1,0,
1,1,21,1,1,3,1,6,1,
1,1,0,0,0,21,0,0,0,
1,6,1,1,1,1,21,1,1,
0,0,0,1,1,1,0,21,0,
0,1,21,1,5,1,0,4,6,
1,0,6,0,21,0,1,0,1,
1,21,1,4,4,1,1,0,5,
1,0,0,21,1,0,1,0,0,
3,1,1,21,1,0,5,1,1,
0,0,0,0,0,18,2,21,2,
2,2,2,2,2,21,2,18,2,
2,21,0,0,2,20,2,0,2,
1,0,1,21,2,0,2,0,1,
1,0,1,21,3,0,0,0,4,
1,21,1,0,4,1,1,1,1,
1,0,1,0,0,0,21,0,0,
3,21,3,1,1,6,1,1,1,
0,21,1,0,1,3,6,1,1,
1,1,1,21,1,3,1,1,1,
0,0,4,0,0,0,21,0,1,
0,0,0,0,0,0,0,0,0,
0,0,0,0,0,0,0,0,0,
0,0,0,0,0,0,0,0,0.
[layer]
type=Tile Layer 2
data=
160,160,160,160,0,0,0,160,160,
0,158,158,158,158,158,0,158,158,
0,0,0,0,0,0,157,157,157,
112,112,112,112,0,112,112,112,112,
0,0,0,107,0,107,107,107,0,
133,133,0,133,0,133,133,133,0,
123,123,0,123,0,123,123,123,0,
107,107,0,107,107,107,107,107,107,
102,102,0,0,0,0,0,0,0,
122,122,122,122,122,122,0,122,122,
0,0,0,118,118,118,0,0,0,
0,108,0,108,108,108,0,108,108,
98,0,98,0,0,0,98,0,98,
122,0,122,122,122,122,122,0,122,
112,0,0,0,112,0,112,0,0,
103,103,103,0,103,0,103,103,103,
0,0,0,0,0,0,94,0,94,
93,93,93,93,93,0,93,0,93,
84,0,0,0,84,0,84,0,84,
83,0,83,0,83,0,83,0,83,
82,0,82,0,82,0,0,0,82,
73,0,73,0,73,73,73,73,73,
72,0,72,0,0,0,0,0,0,
68,0,68,68,68,68,68,68,68,
0,0,70,0,70,70,70,70,70,
66,66,66,0,66,66,66,66,66,
0,0,68,0,0,0,0,0,68,
0,0,0,0,0,0,0,0,0,
0,0,0,0,0,0,0,0,0,
0,0,0,0,0,0,0,0,0.