[layer]
type=Tile Layer 1
data=
1,1,1,1,21,0,0,0,0,
1,1,1,1,1,1,21,0,0,
1,1,1,1,1,1,21,1,1,
1,1,0,21,0,1,1,0,0,
1,1,21,0,1,1,1,0,1,
1,1,1,0,0,21,1,0,1,
1,1,1,1,1,0,1,21,0,
1,1,1,0,0,0,0,21,0,
1,1,1,21,1,1,0,1,1,
21,1,1,1,1,1,1,1,1,
0,21,0,0,0,0,0,1,1,
1,1,1,1,21,1,0,1,1,
1,1,1,1,0,21,0,1,1,
1,1,1,0,0,21,0,1,1,
1,1,1,0,0,21,0,1,1,
1,1,21,0,0,0,0,1,1,
1,1,21,1,1,1,1,1,1,
1,1,21,1,1,1,1,1,1,
1,1,21,0,1,1,1,1,1,
1,1,1,21,0,0,0,0,0,
1,1,1,1,1,1,1,1,21,
1,1,1,1,1,1,21,0,0,
1,1,1,1,1,0,21,0,0,
1,1,1,1,1,21,0,0,0,
1,1,1,1,1,1,0,21,0,
1,1,1,1,1,1,21,0,0,
1,1,1,1,21,0,0,0,0,
1,1,0,21,0,1,1,1,1,
1,1,0,21,0,0,1,1,1,
1,1,1,1,1,21,1,1,1,
0,21,1,1,1,1,0,1,0,
1,0,1,1,1,1,0,21,0,
1,0,0,21,0,0,0,1,1,
1,1,1,1,1,21,1,0,0,
1,1,1,1,1,21,1,1,0,
1,1,1,0,21,1,1,1,0,
1,1,1,0,1,1,1,21,0,
1,1,1,1,21,1,0,1,1,
0,0,0,21,0,1,0,1,1,
1,1,21,1,1,1,0,1,1,
0,1,21,1,1,1,0,1,1,
1,1,21,1,1,1,0,1,1,
0,0,21,1,1,1,0,1,1,
1,1,21,1,1,1,1,1,1,
1,1,0,0,21,1,0,1,0,
1,1,21,1,1,1,1,1,0,
1,1,21,1,1,1,1,1,0,
1,1,21,1,1,1,1,1,0,
1,21,1,1,1,1,1,0,1,
1,21,1,1,1,1,1,0,1,
1,1,1,1,1,1,1,21,1,
0,0,1,1,1,1,1,21,1,
1,1,1,1,1,1,1,21,1,
0,0,0,0,0,21,0,0,1,
0,0,0,0,0,0,0,0,0,
0,0,0,0,0,0,0,0,0,
0,0,0,0,0,0,0,0,0.
[layer]
type=Tile Layer 2
data=
239,239,239,239,0,0,0,0,0,
237,237,237,237,237,237,0,0,0,
224,224,224,224,224,224,0,224,224,
164,164,0,0,0,164,164,0,0,
205,205,0,0,205,205,205,0,205,
189,189,189,0,0,0,189,0,189,
174,174,174,174,174,0,174,0,0,
159,159,159,0,0,0,0,0,0,
199,199,199,0,199,199,0,199,199,
0,175,175,175,175,175,175,175,175,
0,0,0,0,0,0,0,169,169,
155,155,155,155,0,155,0,155,155,
193,193,193,193,0,0,0,193,193,
179,179,179,0,0,0,0,179,179,
165,165,165,0,0,0,0,165,165,
150,150,0,0,0,0,0,150,150,
179,179,0,179,179,179,179,179,179,
165,165,0,165,165,165,165,165,165,
160,160,0,0,160,160,160,160,160,
146,146,146,0,0,0,0,0,0,
173,173,173,173,173,173,173,173,0,
168,168,168,168,168,168,0,0,0,
155,155,155,155,155,0,0,0,0,
142,142,142,142,142,0,0,0,0,
177,177,177,177,177,177,0,0,0,
163,163,163,163,163,163,0,0,0,
150,150,150,150,0,0,0,0,0,
137,137,0,0,0,137,137,137,137,
171,171,0,0,0,0,171,171,171,
151,151,151,151,151,0,151,151,151,
0,0,145,145,145,145,0,145,0,
133,0,133,133,133,133,0,0,0,
165,0,0,0,0,0,0,165,165,
153,153,153,153,153,0,153,0,0,
141,141,141,141,141,0,141,141,0,
128,128,128,0,0,128,128,128,0,
160,160,160,0,160,160,160,0,0,
148,148,148,148,0,148,0,148,148,
0,0,0,0,0,136,0,136,136,
124,124,0,124,124,124,0,124,124,
0,154,0,154,154,154,0,154,154,
142,142,0,142,142,142,0,142,142,
0,0,0,131,131,131,0,131,131,
114,114,0,114,114,114,114,114,114,
119,119,0,0,0,119,0,119,0,
108,108,0,108,108,108,108,108,0,
107,107,0,107,107,107,107,107,0,
106,106,0,106,106,106,106,106,0,
95,0,95,95,95,95,95,0,95,
94,0,94,94,94,94,94,0,94,
89,89,89,89,89,89,89,0,89,
0,0,92,92,92,92,92,0,92,
87,87,87,87,87,87,87,0,87,
0,0,0,0,0,0,0,0,90,
0,0,0,0,0,0,0,0,0,
0,0,0,0,0,0,0,0,0,
0,0,0,0,0,0,0,0,0.