[layer]
type=Tile Layer 1
data=
1,1,1,21,1,1,1,1,1,
1,21,0,0,1,1,1,1,1,
1,21,1,1,1,1,1,1,1,
1,21,1,1,1,1,1,1,1,
1,0,21,0,0,0,0,0,0,
1,21,1,1,1,1,1,1,1,
1,0,1,21,0,0,1,0,1,
1,0,1,0,1,21,1,0,1,
1,21,1,0,1,0,1,0,1,
1,0,1,21,1,1,1,0,1,
1,0,1,21,1,1,1,0,1,
1,1,1,21,1,1,1,0,1,
1,1,0,0,21,0,1,1,1,
0,1,1,0,21,0,1,1,1,
0,1,21,0,1,1,1,1,1,
0,0,21,1,1,1,1,1,1,
0,0,0,21,0,1,1,1,1,
0,0,0,21,1,1,1,1,1,
0,21,1,1,1,1,1,1,1,
0,0,0,0,21,0,1,1,1,
0,0,0,21,0,0,1,1,1,
0,21,1,1,1,0,1,1,1,
0,1,1,1,1,21,1,1,1,
0,0,1,1,1,21,0,1,1,
1,21,0,0,0,0,0,1,1,
1,1,1,0,21,0,1,1,1,
1,1,1,21,0,0,1,1,1,
1,1,0,21,0,1,1,1,1,
1,0,21,1,0,1,1,1,1,
1,21,1,1,0,1,1,1,1,
0,1,21,0,0,0,0,0,0,
21,1,1,1,1,1,1,1,1,
0,1,0,0,21,0,0,0,0,
0,1,0,1,21,1,1,1,0,
0,1,21,1,0,1,1,1,0,
0,1,1,1,1,1,1,1,21,
0,0,0,1,21,1,0,0,0,
0,1,1,1,21,1,1,1,0,
0,1,1,1,0,1,0,1,21,
0,0,0,21,1,1,1,0,0,
0,1,1,1,1,1,1,0,21,
0,1,1,1,1,1,1,0,21,
0,21,0,0,1,1,0,0,1,
1,1,21,1,1,1,1,0,0,
1,1,0,1,1,1,1,21,0,
0,0,0,0,0,0,0,0,0,
0,0,0,0,0,0,0,0,0,
0,0,0,0,0,0,0,0,0.
[layer]
type=Tile Layer 2
data=
198,198,198,0,198,198,198,198,198,
206,0,0,0,206,206,206,206,206,
194,0,194,194,194,194,194,194,194,
170,0,170,170,170,170,170,170,170,
165,0,0,0,0,0,0,0,0,
144,0,144,144,144,144,144,144,144,
138,0,138,0,0,0,138,0,138,
173,0,173,0,173,0,173,0,173,
160,0,160,0,160,0,160,0,160,
147,0,147,0,147,147,147,0,147,
134,0,134,0,134,134,134,0,134,
167,167,167,0,167,167,167,0,167,
154,154,0,0,0,0,154,154,154,
0,142,142,0,0,0,142,142,142,
0,130,0,0,130,130,130,130,130,
0,0,0,162,162,162,162,162,162,
0,0,0,0,0,149,149,149,149,
0,0,0,0,137,137,137,137,137,
0,0,125,125,125,125,125,125,125,
0,0,0,0,0,0,156,156,156,
0,0,0,0,0,0,144,144,144,
0,0,132,132,132,0,132,132,132,
0,121,121,121,121,0,121,121,121,
0,0,150,150,150,0,0,150,150,
139,0,0,0,0,0,0,139,139,
128,128,128,0,0,0,128,128,128,
116,116,116,0,0,0,116,116,116,
145,145,0,0,0,145,145,145,145,
134,0,0,134,0,134,134,134,134,
123,0,123,123,0,123,123,123,123,
0,112,0,0,0,0,0,0,0,
0,133,133,133,133,133,133,133,133,
0,128,0,0,0,0,0,0,0,
0,118,0,118,0,118,118,118,0,
0,108,0,108,0,108,108,108,0,
0,107,107,107,107,107,107,107,0,
0,0,0,97,0,97,0,0,0,
0,96,96,96,0,96,96,96,0,
0,95,95,95,0,95,0,95,0,
0,0,0,0,85,85,85,0,0,
0,84,84,84,84,84,84,0,0,
0,83,83,83,83,83,83,0,0,
0,0,0,0,82,82,0,0,82,
81,81,0,81,81,81,81,0,0,
80,80,0,80,80,80,80,0,0,
0,0,0,0,0,0,0,0,0,
0,0,0,0,0,0,0,0,0,
0,0,0,0,0,0,0,0,0.