[layer]
type=Tile Layer 1
data=
1,1,21,0,1,1,1,1,1,
2,21,20,0,2,2,2,2,2,
1,21,0,2,1,1,1,1,1,
2,2,21,18,2,2,2,2,2,
1,1,1,0,0,0,21,0,1,
1,1,1,1,1,1,1,21,1,
1,21,1,1,1,1,1,1,1,
0,0,0,0,0,0,21,1,0,
0,1,1,1,21,1,1,1,1,
0,1,1,1,0,0,21,0,0,
21,1,1,1,1,1,1,1,1,
0,1,1,1,0,0,0,0,21,
0,1,1,1,21,1,1,1,1,
0,0,0,1,0,1,0,0,21,
1,1,1,1,21,1,1,1,1,
1,1,1,21,0,0,0,0,1,
1,1,1,1,0,0,21,0,0,
1,1,1,1,0,0,0,21,0,
1,1,1,1,1,0,21,0,1,
2,2,2,2,2,2,21,18,0,
1,1,1,1,1,1,0,21,0,
1,1,1,1,1,1,1,21,0,
1,1,0,0,0,21,1,1,0,
1,1,1,2,2,21,1,1,0,
0,21,1,2,24,2,1,1,1,
0,0,0,0,21,1,1,1,1,
1,21,1,0,1,1,1,1,1,
1,21,1,0,2,2,1,1,1,
1,21,2,2,24,2,1,1,1,
1,0,19,2,1,21,0,1,1,
1,2,2,21,1,1,0,0,1,
1,1,1,0,0,21,1,0,0,
1,1,1,21,1,1,1,2,24,
1,0,1,1,2,21,2,0,0,
1,21,1,1,2,24,2,0,1,
0,0,1,0,21,0,2,0,1,
1,1,1,21,1,1,2,24,1,
0,0,0,0,1,21,0,0,0,
1,1,1,1,1,21,1,1,1,
0,0,21,0,0,0,1,1,1,
1,1,1,1,21,2,2,1,1,
1,21,2,0,0,19,2,1,1,
0,21,0,24,0,2,2,1,1,
24,2,21,1,1,1,1,1,1,
0,2,21,1,1,1,1,1,1,
24,2,21,1,1,1,1,1,1,
0,2,0,0,0,21,1,1,1,
24,2,1,1,1,0,0,0,21,
0,0,0,0,0,0,0,0,0,
0,0,0,0,0,0,0,0,0,
0,0,0,0,0,0,0,0,0.
[layer]
type=Tile Layer 2
data=
229,229,0,0,229,229,229,229,229,
228,0,0,0,228,228,228,228,228,
226,0,0,226,226,226,226,226,226,
184,184,0,0,184,184,184,184,184,
169,169,169,0,0,0,0,0,169,
147,147,147,147,147,147,147,0,147,
184,0,184,184,184,184,184,184,184,
0,0,0,0,0,0,0,179,0,
0,165,165,165,0,165,165,165,165,
0,150,150,150,0,0,0,0,0,
0,179,179,179,179,179,179,179,179,
0,174,174,174,0,0,0,0,0,
0,160,160,160,0,160,160,160,160,
0,0,0,146,0,146,0,0,0,
173,173,173,173,0,173,173,173,173,
168,168,168,0,0,0,0,0,168,
155,155,155,155,0,0,0,0,0,
142,142,142,142,0,0,0,0,0,
177,177,177,177,177,0,0,0,177,
163,163,163,163,163,163,0,0,0,
150,150,150,150,150,150,0,0,0,
137,137,137,137,137,137,137,0,0,
171,171,0,0,0,0,171,171,0,
158,158,158,158,158,0,158,158,0,
0,0,145,145,0,145,145,145,145,
0,0,0,0,0,133,133,133,133,
165,0,165,0,165,165,165,165,165,
153,0,153,0,153,153,153,153,153,
141,0,141,141,0,141,141,141,141,
128,0,0,128,128,0,0,128,128,
160,160,160,0,160,160,0,0,160,
148,148,148,0,0,0,148,0,0,
136,136,136,0,136,136,136,136,0,
124,0,124,124,124,0,124,0,0,
154,0,154,154,154,0,154,0,154,
0,0,142,0,0,0,142,0,142,
131,131,131,0,131,131,131,0,131,
0,0,0,0,120,0,0,0,0,
113,113,113,113,113,0,113,113,113,
0,0,0,0,0,0,108,108,108,
102,102,102,102,0,102,102,102,102,
106,0,106,0,0,0,106,106,106,
0,0,0,0,0,95,95,95,95,
0,94,0,94,94,94,94,94,94,
0,93,0,93,93,93,93,93,93,
0,92,0,92,92,92,92,92,92,
0,91,0,0,0,0,91,91,91,
0,90,90,90,90,0,0,0,0,
0,0,0,0,0,0,0,0,0,
0,0,0,0,0,0,0,0,0,
0,0,0,0,0,0,0,0,0.