[layer]
type=Tile Layer 1
data=
3,5,0,6,5,6,21,1,0,
6,3,0,1,3,6,21,1,0,
5,1,0,0,21,0,0,0,0,
4,4,21,1,3,4,5,3,5,
0,0,0,3,4,5,21,0,4,
5,1,21,1,1,3,3,5,1,
4,1,6,3,6,1,1,6,21,
0,21,0,1,4,4,4,4,0,
3,3,21,1,3,3,6,6,0,
0,6,0,0,0,6,21,1,0,
0,5,1,5,5,3,0,6,21,
0,0,21,0,0,0,0,3,0,
6,1,5,4,21,6,4,5,0,
5,1,6,6,21,1,6,1,0,
5,5,4,4,21,1,4,1,6,
1,5,3,21,6,0,6,3,6,
0,0,5,0,5,21,1,0,1,
3,21,1,3,5,0,6,0,6,
6,21,0,0,0,0,3,0,3,
5,5,1,3,1,5,6,21,6,
3,1,1,1,1,21,1,1,1,
6,1,4,1,6,21,6,1,1,
5,0,21,1,5,1,1,0,4,
6,4,5,1,1,21,5,0,4,
5,4,1,6,1,21,0,0,0,
5,1,5,1,4,21,6,0,4,
4,4,6,5,21,1,5,0,6,
4,6,1,3,21,0,0,0,1,
1,3,0,0,0,3,4,21,0,
6,6,21,6,0,1,4,3,0,
1,4,0,21,0,6,4,1,0,
5,6,21,5,1,1,4,4,0,
6,5,21,0,0,0,0,0,0,
1,5,3,0,0,21,0,6,5,
3,1,6,0,5,21,0,3,5,
3,6,1,21,6,0,5,3,1,
4,4,6,4,1,0,0,21,0,
1,5,6,21,0,5,1,4,0,
0,0,21,0,6,5,6,1,0,
0,0,0,0,0,0,0,0,0,
0,0,0,0,0,0,0,0,0,
0,0,0,0,0,0,0,0,0.
[layer]
type=Tile Layer 2
data=
197,197,0,197,197,197,0,197,0,
195,195,0,195,195,195,0,195,0,
194,194,0,0,0,0,0,0,0,
139,139,0,139,139,139,139,139,139,
0,0,0,133,133,133,0,0,133,
158,158,0,158,158,158,158,158,158,
146,146,146,146,146,146,146,146,0,
0,0,0,141,141,141,141,141,0,
129,129,0,129,129,129,129,129,0,
0,161,0,0,0,161,0,161,0,
0,148,148,148,148,148,0,148,0,
0,0,0,0,0,0,0,136,0,
124,124,124,124,0,124,124,124,0,
155,155,155,155,0,155,155,155,0,
136,136,136,136,0,136,136,136,136,
131,131,131,0,131,0,131,131,131,
0,0,120,0,120,0,120,0,120,
149,0,149,149,149,0,149,0,149,
138,0,0,0,0,0,138,0,138,
121,121,121,121,121,121,121,0,121,
92,5,5,5,5,0,92,5,5,
144,7,115,115,115,0,115,7,144,
133,0,0,6,106,6,106,0,133,
122,122,122,6,97,0,122,0,122,
111,111,111,111,89,0,0,0,0,
138,138,138,110,110,0,138,0,138,
127,127,127,127,0,127,127,0,127,
117,117,117,117,0,0,0,0,117,
107,107,0,0,0,107,107,0,0,
106,106,0,106,0,106,106,106,0,
96,96,0,0,0,96,96,96,0,
95,95,0,95,95,95,95,95,0,
94,94,0,0,0,0,0,0,0,
84,84,84,0,0,0,0,84,84,
83,83,83,0,83,0,0,83,83,
82,82,82,0,82,0,82,82,82,
81,81,81,81,81,0,0,0,0,
80,80,80,0,0,80,80,80,0,
0,0,0,0,79,79,79,79,0,
0,0,0,0,0,0,0,0,0,
0,0,0,0,0,0,0,0,0,
0,0,0,0,0,0,0,0,0.