[layer]
type=Tile Layer 1
data=
0,0,0,1,0,1,21,0,0,
0,0,0,1,0,1,21,0,0,
0,0,0,1,0,1,21,0,0,
0,0,0,1,0,1,21,0,0,
0,0,0,1,0,1,21,0,0,
0,0,0,1,0,1,21,0,0,
0,0,0,0,0,0,0,0,0,
0,0,0,0,0,0,0,0,0,
0,0,0,0,0,0,0,0,0.
[layer]
type=Tile Layer 2
data=
0,0,0,32,0,32,0,0,0,
0,0,0,32,0,32,0,0,0,
0,0,0,32,0,32,0,0,0,
0,0,0,32,0,32,0,0,0,
0,0,0,32,0,32,0,0,0,
0,0,0,32,0,32,0,0,0,
0,0,0,0,0,0,0,0,0,
0,0,0,0,0,0,0,0,0,
0,0,0,0,0,0,0,0,0.