[layer]
type=Tile Layer 1
data=
0,5,3,1,0,0,0,3,21,
6,5,6,1,21,3,5,1,0,
0,21,0,6,0,0,0,0,0,
0,1,21,3,3,4,1,6,4,
0,6,0,4,2,2,21,6,0,
4,1,1,3,2,8,2,6,21,
0,0,0,1,2,2,0,0,21,
5,5,21,3,4,4,1,2,8,
1,1,1,1,1,1,1,21,2,
1,1,1,4,21,4,6,3,3,
1,2,2,2,21,4,1,6,6,
0,2,9,2,21,2,2,2,2,
3,2,2,0,21,2,5,0,3,
2,2,2,2,9,21,2,0,2,
0,0,1,2,2,2,6,21,10,
1,21,4,3,6,0,4,2,2,
2,2,2,21,2,2,2,0,7,
4,3,6,0,6,21,1,0,1,
0,0,21,0,6,0,3,0,6,
5,1,3,5,6,21,5,0,2,
1,21,1,0,0,0,0,2,10,
5,21,0,1,1,5,0,2,2,
4,3,21,5,3,3,4,1,0,
0,0,21,1,4,4,4,5,3,
0,0,21,1,6,1,5,6,4,
5,5,4,5,21,6,4,0,6,
0,0,21,0,0,0,0,1,1,
0,1,1,4,5,5,21,3,4,
3,21,3,5,1,4,1,0,0,
5,0,0,0,0,21,0,0,0,
2,2,2,21,7,2,2,2,0,
8,2,6,21,0,0,1,5,0,
10,2,6,3,1,0,0,21,0,
0,2,4,4,21,6,6,3,1,
0,4,1,4,21,1,3,3,1,
0,0,0,3,6,0,0,0,21,
0,0,0,0,0,0,0,0,0,
0,0,0,0,0,0,0,0,0,
0,0,0,0,0,0,0,0,0.
[layer]
type=Tile Layer 2
data=
0,176,176,176,0,0,0,176,0,
175,175,175,175,0,175,175,175,0,
0,0,0,173,0,0,0,0,0,
0,140,0,140,140,140,140,140,140,
0,129,0,129,129,129,0,129,0,
118,118,118,118,118,118,118,118,0,
0,0,0,147,147,147,0,0,0,
108,108,0,108,108,108,6,108,108,
6,99,6,6,6,6,6,0,99,
5,90,90,90,0,90,90,90,90,
7,113,113,113,0,113,7,113,113,
0,130,130,130,0,130,130,130,130,
119,119,119,0,0,119,119,0,119,
109,109,109,109,109,0,109,0,109,
0,0,135,135,135,135,135,0,135,
125,0,125,125,125,0,125,125,125,
115,115,115,0,115,115,115,0,115,
104,104,104,0,104,0,104,0,104,
0,0,0,0,130,0,130,0,130,
120,120,120,120,120,0,120,0,120,
110,0,110,0,0,0,0,110,110,
100,0,0,100,100,100,0,100,100,
124,124,0,124,124,124,124,124,0,
0,0,0,114,114,114,114,114,114,
0,0,0,105,105,105,105,105,105,
96,96,96,96,0,96,96,0,96,
0,0,0,0,0,0,0,95,95,
0,86,86,86,86,86,0,86,86,
85,0,85,85,85,85,85,0,0,
84,0,0,0,0,0,0,0,0,
75,75,75,0,75,75,75,75,0,
74,74,74,0,0,0,74,74,0,
73,73,73,73,73,0,0,0,0,
0,72,72,72,0,72,72,72,72,
0,71,71,71,0,71,71,71,71,
0,0,0,70,70,0,0,0,0,
0,0,0,0,0,0,0,0,0,
0,0,0,0,0,0,0,0,0,
0,0,0,0,0,0,0,0,0.