[layer]
type=Tile Layer 1
data=
21,1,6,4,1,1,1,1,1,
21,1,1,4,3,1,1,6,1,
21,3,1,1,1,1,1,1,1,
0,0,0,21,2,0,2,5,3,
1,1,2,8,2,19,21,0,0,
1,1,2,2,2,2,2,1,21,
1,0,1,21,1,0,5,0,1,
1,0,1,0,1,21,3,0,1,
2,18,2,2,2,21,2,0,2,
0,2,1,1,6,0,1,0,21,
9,21,2,2,2,0,2,2,2,
2,21,8,0,18,0,2,0,0,
2,2,2,21,7,0,2,2,2,
6,0,1,21,1,0,2,0,2,
2,2,2,21,2,0,2,24,9,
2,2,21,0,0,0,0,2,2,
8,2,0,0,0,1,21,0,0,
2,2,1,1,3,21,0,1,5,
1,2,2,2,6,21,0,1,5,
2,2,9,2,21,2,2,2,2,
1,2,2,2,21,2,8,2,1,
1,1,0,21,0,2,2,0,2,
1,4,0,1,1,5,1,21,24,
1,5,21,1,1,1,3,2,19,
2,2,2,2,2,2,21,18,2,
2,2,20,0,0,0,21,0,2,
1,21,0,2,1,1,4,3,1,
1,21,1,1,4,1,6,2,2,
1,21,0,0,0,1,1,2,10,
2,7,2,2,2,21,0,2,2,
1,1,21,0,1,3,0,1,1,
1,5,0,0,21,0,0,1,1,
7,2,2,2,2,2,21,2,2,
1,1,1,21,1,1,3,6,4,
0,0,6,0,0,21,2,2,0,
1,21,1,1,1,2,8,2,1,
1,21,0,0,0,2,2,0,0,
4,21,2,2,2,1,1,1,1,
3,21,2,24,0,0,1,0,0,
5,0,6,21,1,1,1,0,1,
0,21,2,0,2,4,1,0,0,
2,21,2,24,2,1,1,1,1,
20,21,0,0,2,2,2,2,2,
2,0,1,21,24,2,2,5,1,
2,0,0,2,21,20,0,0,0,
6,2,0,21,10,2,0,0,0,
2,9,2,21,2,0,2,2,2,
1,2,8,2,1,0,1,21,0,
0,0,0,0,0,0,0,0,0,
0,0,0,0,0,0,0,0,0,
0,0,0,0,0,0,0,0,0.
[layer]
type=Tile Layer 2
data=
0,218,218,218,218,218,218,218,218,
0,217,217,217,217,217,217,217,217,
0,215,215,215,215,215,215,215,215,
0,0,0,0,184,0,184,184,184,
169,169,169,169,169,0,0,0,0,
147,147,147,147,147,147,147,147,0,
193,0,193,0,193,0,193,0,193,
179,0,179,0,179,0,179,0,179,
165,0,165,165,165,0,165,0,165,
0,150,150,150,150,0,150,0,0,
188,0,188,188,188,0,188,188,188,
174,0,174,0,0,0,174,0,0,
160,160,160,0,160,0,160,160,160,
146,0,146,0,146,0,146,0,146,
182,182,182,0,182,0,182,0,182,
168,168,0,0,0,0,0,168,168,
155,155,0,0,0,155,0,0,0,
142,142,142,142,142,0,0,142,142,
177,177,177,177,177,0,0,177,177,
163,163,163,163,0,163,163,163,163,
150,150,150,150,0,150,150,150,150,
137,137,0,0,0,137,137,0,137,
171,171,0,171,171,171,171,0,0,
158,158,0,158,158,158,158,158,0,
145,145,145,145,145,145,0,0,145,
133,133,0,0,0,0,0,0,133,
165,0,0,165,165,165,165,165,165,
146,0,146,146,146,146,146,146,146,
141,0,0,0,0,141,141,141,141,
128,128,128,128,128,0,0,128,128,
160,160,0,0,160,160,0,160,160,
148,148,0,0,0,0,0,148,148,
136,136,136,136,136,136,0,136,136,
118,118,118,0,118,118,118,118,118,
0,0,154,0,0,0,154,154,0,
142,0,142,142,142,142,142,142,142,
131,0,0,0,0,131,131,0,0,
114,0,114,114,114,114,114,114,114,
119,0,119,0,0,0,119,0,0,
108,0,108,0,108,108,108,0,108,
0,0,107,0,107,107,107,0,0,
106,0,106,0,106,106,106,106,106,
0,0,0,0,95,95,95,95,95,
94,0,94,0,0,94,94,94,94,
93,0,0,93,0,0,0,0,0,
92,92,0,0,92,92,0,0,0,
91,91,91,0,91,0,91,91,91,
90,90,90,90,90,0,90,0,0,
0,0,0,0,0,0,0,0,0,
0,0,0,0,0,0,0,0,0,
0,0,0,0,0,0,0,0,0.