[layer]
type=Tile Layer 1
data=
1,3,21,1,5,6,1,1,0,
1,2,24,2,21,0,0,1,0,
1,1,21,1,0,2,2,3,1,
1,1,0,3,0,19,0,21,0,
5,1,21,1,0,2,2,1,6,
0,1,21,6,0,1,1,1,1,
0,1,1,0,0,1,4,21,0,
1,1,1,21,3,1,2,2,19,
1,1,6,0,0,21,2,19,0,
0,0,21,0,2,24,2,0,1,
6,1,1,0,1,21,1,0,0,
1,4,5,21,1,1,1,1,0,
5,1,21,0,1,3,1,1,0,
1,1,1,6,6,1,1,1,21,
1,0,0,0,0,0,1,21,0,
1,21,5,1,1,0,1,1,1,
1,0,3,1,6,21,1,0,0,
1,0,2,2,2,21,6,0,1,
1,0,0,19,2,21,1,0,1,
2,2,2,2,2,21,2,18,2,
0,0,0,0,0,21,1,0,5,
0,0,0,0,0,0,0,0,0,
0,0,0,0,0,0,0,0,0,
0,0,0,0,0,0,0,0,0.
[layer]
type=Tile Layer 2
data=
127,127,0,127,127,127,127,127,0,
132,132,0,132,0,0,0,132,0,
124,124,0,124,0,124,124,124,124,
113,113,0,113,0,0,0,0,0,
99,99,0,99,0,99,99,99,99,
0,95,0,95,0,95,95,95,95,
0,86,86,0,0,86,86,0,0,
102,102,102,0,102,102,102,102,0,
98,98,98,0,0,0,98,0,0,
0,0,0,0,90,0,90,0,90,
82,82,82,0,82,0,82,0,0,
77,77,77,0,77,77,77,77,0,
73,73,0,0,73,73,73,73,0,
65,65,65,65,65,65,65,65,0,
71,0,0,0,0,0,71,0,0,
60,0,60,60,60,0,60,60,60,
62,0,62,62,62,0,62,0,0,
61,0,61,61,61,0,61,0,61,
60,0,0,0,60,0,60,0,60,
57,57,57,57,57,0,57,0,57,
0,0,0,0,0,0,58,0,58,
0,0,0,0,0,0,0,0,0,
0,0,0,0,0,0,0,0,0,
0,0,0,0,0,0,0,0,0.