[layer]
type=Tile Layer 1
data=
1,1,1,1,1,5,6,1,21,
0,21,1,1,5,1,1,0,0,
1,21,1,1,3,6,1,0,1,
4,21,6,5,1,1,1,0,1,
4,21,1,1,1,1,1,0,1,
1,0,1,21,0,0,0,0,0,
1,1,1,1,21,1,1,4,5,
0,21,0,3,0,1,1,1,0,
1,4,0,1,21,1,1,1,0,
6,1,21,4,0,1,1,5,0,
1,1,21,1,1,1,1,4,1,
1,1,21,0,0,0,0,0,0,
1,1,1,4,1,6,21,1,1,
0,0,21,1,4,1,0,0,0,
0,1,0,1,3,1,21,1,1,
1,21,1,0,6,1,6,0,1,
3,0,1,0,0,21,1,0,0,
1,1,1,1,1,21,1,5,1,
6,21,0,0,0,0,1,0,1,
4,21,3,1,1,1,1,0,1,
1,0,1,21,0,0,0,0,1,
1,21,1,0,3,0,1,1,1,
1,0,4,0,1,21,0,0,1,
1,0,1,21,1,1,4,0,6,
0,5,0,21,1,1,4,1,1,
0,3,21,1,1,1,1,1,1,
0,1,5,21,0,3,1,1,1,
0,1,21,0,1,4,3,1,1,
21,1,1,5,5,1,1,1,1,
0,21,0,0,0,0,1,1,1,
0,0,6,1,21,0,4,1,1,
0,0,1,0,5,0,0,0,21,
0,0,0,21,0,1,1,1,1,
3,1,1,0,0,0,21,0,1,
1,4,3,1,1,21,1,1,0,
1,1,1,6,1,0,21,0,0,
1,0,0,0,0,21,1,1,0,
1,21,4,0,1,1,1,3,0,
1,0,1,21,6,4,1,1,0,
0,0,0,0,0,0,0,0,0,
0,0,0,0,0,0,0,0,0,
0,0,0,0,0,0,0,0,0.
[layer]
type=Tile Layer 2
data=
188,188,188,188,188,188,188,188,0,
0,0,196,196,196,196,196,0,0,
195,0,195,195,195,195,195,0,195,
147,0,147,147,147,147,147,0,147,
134,0,134,134,134,134,134,0,134,
167,0,167,0,0,0,0,0,0,
147,147,147,147,0,147,147,147,147,
0,0,0,142,0,142,142,142,0,
130,130,0,130,0,130,130,130,0,
162,162,0,162,0,162,162,162,0,
142,142,0,142,142,142,142,142,142,
137,137,0,0,0,0,0,0,0,
119,119,119,119,119,119,0,119,119,
0,0,0,156,156,156,0,0,0,
0,144,0,144,144,144,0,144,144,
132,0,132,0,132,132,132,0,132,
121,0,121,0,0,0,121,0,0,
143,143,143,143,143,0,143,143,143,
139,0,0,0,0,0,139,0,139,
128,0,128,128,128,128,128,0,128,
116,0,116,0,0,0,0,0,116,
145,0,145,0,145,0,145,145,145,
134,0,134,0,134,0,0,0,134,
123,0,123,0,123,123,123,0,123,
0,112,0,0,112,112,112,112,112,
0,139,0,139,139,139,139,139,139,
0,128,128,0,0,128,128,128,128,
0,118,0,0,118,118,118,118,118,
0,103,103,103,103,103,103,103,103,
0,0,0,0,0,0,107,107,107,
0,0,97,97,0,0,97,97,97,
0,0,96,0,96,0,0,0,0,
0,0,0,0,0,95,95,95,95,
85,85,85,0,0,0,0,0,85,
84,84,84,84,84,0,84,84,0,
83,83,83,83,83,0,0,0,0,
82,0,0,0,0,0,82,82,0,
81,0,81,0,81,81,81,81,0,
80,0,80,0,80,80,80,80,0,
0,0,0,0,0,0,0,0,0,
0,0,0,0,0,0,0,0,0,
0,0,0,0,0,0,0,0,0.