[layer]
type=Tile Layer 1
data=
5,5,0,0,0,21,5,4,0,
0,21,4,4,1,3,1,1,3,
0,4,1,3,0,21,3,3,5,
1,21,0,0,0,1,5,0,0,
4,5,6,5,0,0,21,6,0,
1,4,6,4,0,0,21,0,0,
5,21,3,0,3,0,4,0,5,
1,0,3,21,5,0,4,0,4,
4,0,3,1,1,21,1,0,5,
0,0,5,6,3,0,5,0,21,
3,21,5,6,1,0,1,1,1,
5,0,6,0,0,0,3,21,0,
4,4,5,21,1,0,4,5,4,
1,0,4,21,1,0,3,0,1,
5,21,3,0,5,0,3,0,3,
3,1,1,4,1,21,1,3,4,
1,1,1,1,21,1,5,1,1,
1,5,5,3,21,4,1,5,1,
1,1,5,21,1,1,1,1,1,
1,6,21,3,6,0,6,0,0,
3,5,3,0,1,21,0,5,0,
0,0,0,0,0,0,0,0,0,
0,0,0,0,0,0,0,0,0,
0,0,0,0,0,0,0,0,0.
[layer]
type=Tile Layer 2
data=
133,133,0,0,0,0,133,133,0,
0,0,125,125,125,125,125,125,125,
0,130,130,130,0,0,130,130,130,
113,0,0,0,0,113,113,0,0,
104,104,104,104,0,0,0,104,0,
95,95,95,95,0,0,0,0,0,
86,0,86,0,86,0,86,0,86,
107,0,107,0,107,0,107,0,107,
98,0,98,98,98,0,98,0,98,
0,0,90,90,90,0,90,0,0,
78,0,78,78,78,0,78,78,78,
81,0,81,0,0,0,81,0,0,
69,69,69,0,69,0,69,69,69,
72,0,72,0,72,0,72,0,72,
71,0,71,0,71,0,71,0,71,
50,3,3,50,50,0,3,50,50,
3,3,50,3,0,3,50,3,3,
3,49,49,49,0,49,49,49,3,
3,3,48,0,3,3,3,3,48,
59,59,0,59,59,0,59,0,0,
58,58,58,0,58,0,0,58,0,
0,0,0,0,0,0,0,0,0,
0,0,0,0,0,0,0,0,0,
0,0,0,0,0,0,0,0,0.