[layer]
type=Tile Layer 1
data=
1,1,1,1,1,1,0,21,0,
1,1,1,0,0,0,0,21,0,
0,0,0,21,1,1,1,1,1,
0,21,1,1,1,1,1,1,1,
1,21,0,1,1,1,1,1,1,
1,1,0,0,21,0,1,1,1,
1,1,1,1,1,21,0,0,1,
1,1,1,0,0,0,21,0,1,
1,1,1,21,1,1,1,1,1,
1,1,1,1,1,21,1,0,1,
0,0,1,1,1,21,1,0,1,
1,21,1,1,1,1,1,0,1,
0,21,1,0,0,0,0,0,1,
1,1,1,1,1,1,1,21,1,
1,1,1,21,1,1,1,0,0,
1,1,1,21,1,1,1,0,1,
0,0,21,0,1,1,1,0,1,
1,0,1,21,1,1,1,0,1,
1,1,1,21,1,1,1,0,1,
1,0,0,0,1,21,0,0,1,
1,21,1,1,1,0,1,1,1,
0,0,0,0,0,0,1,21,1,
1,1,1,1,1,1,1,21,1,
1,0,21,0,0,0,0,0,0,
1,21,1,1,1,1,1,1,1,
1,0,0,0,0,21,0,0,0,
1,1,21,1,1,1,0,1,1,
1,21,1,0,1,1,1,1,1,
1,0,1,21,1,0,0,0,0,
1,1,1,21,1,0,1,1,1,
1,0,0,21,1,0,1,1,1,
1,21,1,1,1,0,1,1,1,
0,0,1,0,21,0,1,1,1,
0,0,0,0,0,0,0,0,0,
0,0,0,0,0,0,0,0,0,
0,0,0,0,0,0,0,0,0.
[layer]
type=Tile Layer 2
data=
171,171,171,171,171,171,0,0,0,
170,170,170,0,0,0,0,0,0,
0,0,0,0,168,168,168,168,168,
0,0,147,147,147,147,147,147,147,
135,0,0,135,135,135,135,135,135,
124,124,0,0,0,0,124,124,124,
113,113,113,113,113,0,0,0,113,
141,141,141,0,0,0,0,0,141,
124,124,124,0,124,124,124,124,124,
119,119,119,119,119,0,119,0,119,
0,0,109,109,109,0,109,0,109,
135,0,135,135,135,135,135,0,135,
0,0,125,0,0,0,0,0,125,
109,109,109,109,109,109,109,0,109,
104,104,104,0,104,104,104,0,0,
130,130,130,0,130,130,130,0,130,
0,0,0,0,120,120,120,0,120,
110,0,110,0,110,110,110,0,110,
100,100,100,0,100,100,100,0,100,
124,0,0,0,124,0,0,0,124,
114,0,114,114,114,0,114,114,114,
0,0,0,0,0,0,105,0,105,
91,91,91,91,91,91,91,0,91,
95,0,0,0,0,0,0,0,0,
82,0,82,82,82,82,82,82,82,
85,0,0,0,0,0,0,0,0,
84,84,0,84,84,84,0,84,84,
75,0,75,0,75,75,75,75,75,
74,0,74,0,74,0,0,0,0,
73,73,73,0,73,0,73,73,73,
72,0,0,0,72,0,72,72,72,
71,0,71,71,71,0,71,71,71,
0,0,70,0,0,0,70,70,70,
0,0,0,0,0,0,0,0,0,
0,0,0,0,0,0,0,0,0,
0,0,0,0,0,0,0,0,0.