[layer]
type=Tile Layer 1
data=
1,1,1,21,0,3,1,1,1,
4,1,1,0,0,0,0,21,0,
1,1,1,3,6,1,1,1,21,
0,0,0,21,0,0,0,1,5,
0,0,1,1,21,1,4,1,1,
0,21,3,1,0,1,1,4,1,
0,0,1,1,3,0,21,0,1,
1,0,0,0,21,1,1,0,1,
5,1,1,3,1,1,1,21,6,
0,0,1,3,1,0,0,21,1,
0,1,1,1,21,6,4,1,1,
0,0,21,3,0,0,1,1,1,
1,1,5,21,0,0,0,0,5,
1,1,1,1,4,1,1,21,0,
1,1,6,1,21,0,0,0,0,
5,1,1,1,21,0,1,1,1,
4,1,1,1,1,21,0,0,0,
1,1,1,4,3,0,0,21,0,
1,6,1,0,21,0,1,1,1,
1,1,1,21,0,0,1,4,1,
1,1,3,1,3,21,4,1,1,
1,1,1,1,5,21,0,1,6,
1,1,1,5,0,0,21,0,1,
1,1,1,1,0,1,4,21,0,
4,1,1,1,0,0,0,21,0,
1,1,1,6,0,0,21,0,0,
1,5,1,1,21,0,6,1,0,
1,1,5,1,1,21,0,0,0,
1,4,1,1,0,0,21,0,0,
1,1,6,6,1,0,21,0,0,
4,3,21,3,0,0,1,1,1,
0,0,0,0,0,21,1,5,1,
0,0,1,0,21,1,1,1,1,
1,0,21,6,0,0,1,1,1,
1,1,0,21,0,0,4,3,1,
1,1,21,1,3,1,1,1,1,
0,0,0,21,0,0,0,1,1,
0,6,6,1,1,4,21,0,1,
5,1,1,1,1,0,21,0,1,
1,1,21,1,0,1,1,1,1,
1,1,21,1,0,3,4,1,4,
1,1,0,1,0,6,0,21,0,
1,1,21,6,1,3,1,1,1,
0,0,0,0,0,0,0,1,21,
6,1,1,4,21,1,1,1,1,
1,1,1,5,21,1,1,1,5,
1,1,1,1,21,4,1,1,6,
6,1,1,4,21,1,1,1,1,
1,1,21,4,3,1,0,1,1,
1,6,21,1,1,1,0,3,1,
0,1,0,0,0,1,21,1,1,
0,1,21,1,1,3,5,1,1,
0,1,0,0,21,0,0,0,0,
1,1,1,3,21,4,1,1,1,
0,0,0,0,0,0,0,0,0,
0,0,0,0,0,0,0,0,0,
0,0,0,0,0,0,0,0,0.
[layer]
type=Tile Layer 2
data=
239,239,239,0,0,239,239,239,239,
237,237,237,0,0,0,0,0,0,
224,224,224,224,224,224,224,224,0,
0,0,0,0,0,0,0,164,164,
0,0,205,205,0,205,205,205,205,
0,0,189,189,0,189,189,189,189,
0,0,174,174,174,0,0,0,174,
159,0,0,0,0,159,159,0,159,
189,189,189,189,189,189,189,0,189,
0,0,184,184,184,0,0,0,184,
0,169,169,169,0,169,169,169,169,
0,0,0,155,0,0,155,155,155,
193,193,193,0,0,0,0,0,193,
179,179,179,179,179,179,179,0,0,
165,165,165,165,0,0,0,0,0,
150,150,150,150,0,0,150,150,150,
188,188,188,188,188,0,0,0,0,
174,174,174,174,174,0,0,0,0,
160,160,160,0,0,0,160,160,160,
146,146,146,0,0,0,146,146,146,
173,173,173,173,173,0,173,173,173,
168,168,168,168,168,0,0,168,168,
155,155,155,155,0,0,0,0,155,
142,142,142,142,0,142,142,0,0,
177,177,177,177,0,0,0,0,0,
163,163,163,163,0,0,0,0,0,
150,150,150,150,0,0,150,150,0,
137,137,137,137,137,0,0,0,0,
171,171,171,171,0,0,0,0,0,
158,158,158,158,158,0,0,0,0,
145,145,0,145,0,0,145,145,145,
0,0,0,0,0,0,133,133,133,
0,0,165,0,0,165,165,165,165,
153,0,0,153,0,0,153,153,153,
141,141,0,0,0,0,141,141,141,
122,122,0,122,122,122,122,122,122,
0,0,0,0,0,0,0,160,160,
0,148,148,148,148,148,0,0,148,
136,136,136,136,136,0,0,0,136,
124,124,0,124,0,124,124,124,124,
154,154,0,154,0,154,154,154,154,
142,142,0,142,0,142,0,0,0,
125,125,0,125,125,125,125,125,125,
0,0,0,0,0,0,0,120,0,
113,113,113,113,0,113,113,113,113,
103,103,103,103,0,103,103,103,103,
102,102,102,102,0,102,102,102,102,
101,101,101,101,0,101,101,101,101,
95,95,0,95,95,95,0,95,95,
94,94,0,94,94,94,0,94,94,
0,93,0,0,0,93,0,93,93,
0,92,0,92,92,92,92,92,92,
0,91,0,0,0,0,0,0,0,
86,86,86,86,0,86,86,86,86,
0,0,0,0,0,0,0,0,0,
0,0,0,0,0,0,0,0,0,
0,0,0,0,0,0,0,0,0.