[layer]
type=Tile Layer 1
data=
8,2,1,1,1,1,21,0,0,
2,2,2,2,0,21,0,1,0,
1,2,19,2,0,1,1,21,0,
1,2,2,2,0,0,21,0,1,
2,7,2,21,2,2,2,2,0,
1,1,0,1,1,1,2,21,0,
2,2,21,0,2,2,2,20,0,
1,1,21,0,2,10,2,2,0,
1,1,21,1,2,2,8,2,1,
1,1,21,1,1,2,0,2,0,
2,2,2,2,2,2,21,2,18,
0,19,21,1,1,1,0,0,0,
1,2,21,1,1,1,0,1,1,
0,0,2,1,0,0,21,1,1,
1,10,21,1,1,1,1,1,1,
1,10,2,0,21,0,0,1,1,
1,2,21,1,1,1,1,2,2,
0,20,0,0,21,0,0,2,19,
1,0,2,1,1,21,1,0,2,
0,21,2,0,2,0,2,18,2,
1,1,1,21,1,0,1,0,1,
1,0,0,21,0,0,1,0,0,
2,2,2,2,7,2,2,21,2,
0,0,2,2,0,0,2,21,1,
1,21,8,2,1,0,2,24,1,
2,2,2,2,2,21,7,0,2,
1,10,2,1,1,21,1,0,1,
1,2,0,21,1,0,0,0,1,
1,1,1,1,1,1,2,21,1,
1,21,1,1,1,1,2,24,1,
1,21,1,1,1,1,1,0,2,
2,0,0,21,0,0,0,0,20,
1,21,1,1,1,1,1,2,2,
0,0,0,0,0,0,0,0,0,
0,0,0,0,0,0,0,0,0,
0,0,0,0,0,0,0,0,0.
[layer]
type=Tile Layer 2
data=
170,170,170,170,170,170,0,0,0,
169,169,169,169,0,0,0,169,0,
167,167,0,167,0,167,167,0,0,
146,146,146,146,0,0,0,0,146,
134,134,134,0,134,134,134,134,0,
123,123,0,123,123,123,123,0,0,
112,112,0,0,112,112,112,0,0,
140,140,0,0,140,140,140,140,0,
129,129,0,129,129,129,129,129,129,
118,118,0,118,118,118,0,118,0,
108,108,108,108,108,108,0,108,0,
0,0,0,134,134,134,0,0,0,
124,124,0,124,124,124,0,124,124,
0,0,114,114,0,0,0,114,114,
103,103,0,103,103,103,103,103,103,
129,129,129,0,0,0,0,129,129,
113,113,0,113,113,113,113,113,113,
0,0,0,0,0,0,0,109,0,
99,0,99,99,99,0,99,0,99,
0,0,123,0,123,0,123,0,123,
113,113,113,0,113,0,113,0,113,
104,0,0,0,0,0,104,0,0,
95,95,95,95,95,95,95,0,95,
0,0,94,94,0,0,94,0,94,
85,0,85,85,85,0,85,0,85,
84,84,84,84,84,0,84,0,84,
83,83,83,83,83,0,83,0,83,
74,74,0,0,74,0,0,0,74,
70,70,70,70,70,70,70,0,70,
72,0,72,72,72,72,72,0,72,
71,0,71,71,71,71,71,0,71,
70,0,0,0,0,0,0,0,0,
66,0,66,66,66,66,66,66,66,
0,0,0,0,0,0,0,0,0,
0,0,0,0,0,0,0,0,0,
0,0,0,0,0,0,0,0,0.