[layer]
type=Tile Layer 1
data=
1,1,1,6,1,0,1,21,0,
4,3,4,1,1,21,1,1,1,
0,0,0,1,0,0,21,0,0,
1,1,21,3,0,1,1,1,1,
0,1,21,1,0,0,0,1,0,
1,3,21,6,0,1,4,1,1,
0,21,0,0,0,1,1,1,1,
4,5,6,1,21,1,1,1,6,
0,21,0,1,0,1,1,1,1,
1,5,21,1,0,1,3,1,4,
0,1,0,4,0,0,0,21,0,
0,1,21,1,0,1,1,1,1,
1,0,1,21,1,0,1,0,0,
3,21,6,0,1,0,1,1,5,
0,0,1,0,1,0,1,21,0,
1,1,6,21,1,0,1,0,1,
3,0,21,0,1,0,0,0,1,
1,21,4,1,1,6,1,1,1,
1,0,21,0,0,0,1,0,0,
1,1,1,1,1,21,1,0,3,
0,21,1,0,0,0,4,0,5,
5,21,1,1,1,0,0,6,1,
0,21,5,1,4,0,1,1,1,
0,1,1,1,1,0,0,21,1,
0,1,1,1,1,1,1,0,21,
0,1,4,1,3,1,6,1,21,
0,4,1,0,0,21,0,0,0,
1,0,21,0,1,1,5,3,1,
1,0,1,21,0,1,1,1,1,
6,0,1,21,0,1,5,1,1,
1,1,1,1,21,1,1,0,3,
1,1,1,3,21,1,6,0,1,
1,1,1,1,21,1,4,0,4,
1,0,21,0,0,3,1,0,1,
4,21,1,1,1,1,0,0,1,
0,21,1,1,5,1,1,3,0,
0,0,0,0,0,0,0,0,0,
0,0,0,0,0,0,0,0,0,
0,0,0,0,0,0,0,0,0.
[layer]
type=Tile Layer 2
data=
192,192,192,192,192,0,192,0,0,
181,181,181,181,181,0,181,181,181,
0,0,0,189,0,0,0,0,0,
153,153,0,153,0,153,153,153,153,
0,141,0,141,0,0,0,141,0,
129,129,0,129,0,129,129,129,129,
0,0,0,0,0,161,161,161,161,
141,141,141,141,0,141,141,141,141,
0,0,0,136,0,136,136,136,136,
124,124,0,124,0,124,124,124,124,
0,155,0,155,0,0,0,0,0,
0,143,0,143,0,143,143,143,143,
131,0,131,0,131,0,131,0,0,
120,0,120,0,120,0,120,120,120,
0,0,149,0,149,0,149,0,0,
138,138,138,0,138,0,138,0,138,
127,0,0,0,127,0,0,0,127,
110,0,110,110,110,110,110,110,110,
144,0,0,0,0,0,144,0,0,
133,133,133,133,133,0,133,0,133,
0,0,122,0,0,0,122,0,122,
111,0,111,111,111,0,0,111,111,
0,0,138,138,138,0,138,138,138,
0,127,127,127,127,0,0,0,127,
0,117,117,117,117,117,117,0,0,
0,107,107,107,107,107,107,107,0,
0,106,106,0,0,0,0,0,0,
96,0,0,0,96,96,96,96,96,
95,0,95,0,0,95,95,95,95,
94,0,94,0,0,94,94,94,94,
84,84,84,84,0,84,84,0,84,
83,83,83,83,0,83,83,0,83,
82,82,82,82,0,82,82,0,82,
81,0,0,0,0,81,81,0,81,
80,0,80,80,80,80,0,0,80,
0,0,79,79,79,79,79,79,0,
0,0,0,0,0,0,0,0,0,
0,0,0,0,0,0,0,0,0,
0,0,0,0,0,0,0,0,0.