[layer]
type=Tile Layer 1
data=
1,3,1,1,6,0,1,21,0,
1,1,21,6,1,1,0,1,0,
0,5,0,2,2,1,0,1,21,
0,2,21,9,2,2,2,2,2,
0,2,2,2,2,21,0,18,0,
24,2,21,2,2,2,2,2,7,
0,2,21,1,1,5,1,1,0,
20,2,2,2,2,2,2,2,21,
0,9,2,2,2,21,2,2,18,
1,2,2,0,21,0,0,3,1,
1,0,21,0,6,0,2,2,1,
2,21,2,2,2,18,2,10,2,
9,2,21,2,2,0,2,2,2,
2,21,1,4,2,24,2,1,1,
2,21,2,2,2,9,0,2,2,
0,0,0,1,2,2,21,5,1,
0,1,1,0,4,21,1,1,1,
0,1,1,2,21,0,2,6,1,
0,2,0,21,20,10,2,2,2,
21,2,2,2,2,9,2,2,2,
0,21,0,1,2,2,0,0,0,
3,1,21,1,0,3,1,1,1,
1,5,21,1,0,1,1,4,0,
2,2,21,1,0,2,2,2,0,
19,2,0,21,0,2,10,2,0,
2,2,1,1,5,2,10,2,21,
0,1,1,6,0,2,2,0,21,
0,21,0,1,1,1,5,1,5,
4,0,0,0,21,1,0,0,3,
1,1,1,1,21,0,1,0,0,
1,4,1,5,1,0,0,21,24,
1,1,1,1,6,1,21,0,1,
1,1,5,1,1,6,21,0,1,
0,0,0,0,0,0,0,0,0,
0,0,0,0,0,0,0,0,0,
0,0,0,0,0,0,0,0,0.
[layer]
type=Tile Layer 2
data=
171,171,171,171,171,0,171,0,0,
170,170,0,170,170,170,0,170,0,
0,168,0,168,168,168,0,168,0,
0,147,0,147,147,147,147,147,147,
0,135,135,135,135,0,0,0,0,
0,124,0,124,124,124,124,124,124,
0,113,0,113,113,113,113,113,0,
0,141,141,141,141,141,141,141,0,
0,130,130,130,130,0,130,130,0,
119,119,119,0,0,0,0,119,119,
109,0,0,0,109,0,109,109,109,
135,0,135,135,135,0,135,135,135,
125,125,0,125,125,0,125,125,125,
115,0,115,115,115,0,115,115,115,
104,0,104,104,104,104,0,104,104,
0,0,0,130,130,130,0,130,130,
0,120,120,0,120,0,120,120,120,
0,110,110,110,0,0,110,110,110,
0,100,0,0,0,100,100,100,100,
0,124,124,124,124,124,124,124,124,
0,0,0,114,114,114,0,0,0,
105,105,0,105,0,105,105,105,105,
96,96,0,96,0,96,96,96,0,
95,95,0,95,0,95,95,95,0,
0,86,0,0,0,86,86,86,0,
85,85,85,85,85,85,85,85,0,
0,84,84,84,0,84,84,0,0,
0,0,0,75,75,75,75,75,75,
74,0,0,0,0,74,0,0,74,
73,73,73,73,0,0,73,0,0,
72,72,72,72,72,0,0,0,0,
71,71,71,71,71,71,0,0,71,
70,70,70,70,70,70,0,0,70,
0,0,0,0,0,0,0,0,0,
0,0,0,0,0,0,0,0,0,
0,0,0,0,0,0,0,0,0.