[layer]
type=Tile Layer 1
data=
1,0,21,1,1,0,0,1,1,
6,21,1,1,0,0,1,1,1,
0,5,1,6,1,0,21,0,4,
0,5,4,1,1,1,1,3,21,
1,0,0,0,2,21,1,6,0,
1,1,1,1,2,1,21,0,0,
1,1,6,0,0,21,1,1,5,
3,21,1,4,1,1,1,5,1,
6,0,1,21,0,0,1,0,1,
0,1,1,1,1,1,21,3,0,
1,1,1,3,1,1,21,1,1,
0,0,1,1,21,5,3,0,0,
0,0,0,0,0,0,0,0,0,
0,0,0,0,0,0,0,0,0,
0,0,0,0,0,0,0,0,0.
[layer]
type=Tile Layer 2
data=
88,0,0,88,88,0,0,88,88,
63,0,63,63,0,0,63,63,63,
0,62,62,62,62,0,0,0,62,
0,58,58,58,58,58,58,58,0,
54,0,0,0,54,0,54,54,0,
53,53,42,2,53,2,0,0,0,
52,41,41,0,0,0,2,41,52,
41,0,2,41,51,41,2,41,41,
40,0,40,0,0,0,40,0,40,
0,49,2,39,2,39,0,49,0,
2,48,2,48,48,48,0,48,2,
0,0,47,47,0,47,47,0,0,
0,0,0,0,0,0,0,0,0,
0,0,0,0,0,0,0,0,0,
0,0,0,0,0,0,0,0,0.