[layer]
type=Tile Layer 1
data=
1,1,0,0,0,0,0,21,0,
1,2,2,1,1,1,1,2,21,
1,8,2,1,1,0,21,2,24,
1,2,2,1,0,21,0,0,0,
1,2,2,21,0,1,0,1,1,
1,19,2,0,1,1,21,0,0,
1,2,2,1,1,1,21,1,0,
1,1,1,0,21,1,0,0,1,
1,0,0,0,21,1,1,0,1,
1,1,0,0,2,2,21,0,1,
1,2,0,0,2,10,21,0,1,
2,2,20,2,2,21,0,2,2,
9,2,2,2,24,21,0,2,2,
2,2,1,0,1,1,21,0,0,
8,2,1,21,1,2,2,2,0,
19,2,0,1,0,0,19,21,0,
0,21,0,1,1,2,2,2,0,
9,2,21,2,2,2,2,2,0,
2,21,1,1,1,1,1,0,2,
1,0,0,0,21,0,2,2,10,
1,0,2,2,2,21,2,24,2,
2,20,2,21,9,2,2,2,0,
2,18,2,21,2,0,2,2,2,
1,0,21,0,1,2,10,2,1,
1,1,1,2,2,21,2,2,2,
0,21,2,2,19,2,2,2,9,
2,2,2,2,2,2,2,21,7,
2,21,7,0,2,2,2,2,2,
0,21,1,0,1,1,1,1,1,
1,21,1,0,1,1,1,1,1,
0,0,1,21,0,0,0,0,0,
1,1,1,21,1,1,1,1,1,
0,0,0,0,21,0,0,0,1,
1,1,1,1,1,21,1,1,1,
1,21,1,1,1,0,1,1,1,
1,21,1,1,1,1,1,1,1,
1,0,1,0,21,0,1,0,1,
1,21,1,1,1,1,1,0,1,
1,0,1,1,1,1,1,21,0,
2,21,1,1,1,1,1,0,1,
8,0,21,0,0,2,2,0,1,
2,2,21,1,2,10,2,1,1,
0,0,0,0,0,0,0,0,0,
0,0,0,0,0,0,0,0,0,
0,0,0,0,0,0,0,0,0.
[layer]
type=Tile Layer 2
data=
203,203,0,0,0,0,0,0,0,
191,191,191,191,191,191,191,191,0,
200,200,200,200,200,0,0,200,0,
138,138,138,138,0,0,0,0,0,
173,173,173,0,0,173,0,173,173,
160,0,160,0,160,160,0,0,0,
147,147,147,147,147,147,0,147,0,
134,134,134,0,0,134,0,0,134,
167,0,0,0,0,167,167,0,167,
154,154,0,0,154,154,0,0,154,
142,142,0,0,142,142,0,0,142,
130,130,0,130,130,0,0,130,130,
162,162,162,162,0,0,0,162,162,
149,149,149,0,149,149,0,0,0,
137,137,137,0,137,137,137,137,0,
0,125,0,125,0,0,0,0,0,
0,0,0,156,156,156,156,156,0,
144,144,0,144,144,144,144,144,0,
132,0,132,132,132,132,132,0,132,
121,0,0,0,0,0,121,121,121,
150,0,150,150,150,0,150,0,150,
139,0,139,0,139,139,139,139,0,
128,0,128,0,128,0,128,128,128,
116,0,0,0,116,116,116,116,116,
138,138,138,138,138,0,138,138,138,
0,0,134,134,0,134,134,134,134,
123,123,123,123,123,123,123,0,123,
112,0,112,0,112,112,112,112,112,
0,0,139,0,139,139,139,139,139,
128,0,128,0,128,128,128,128,128,
0,0,118,0,0,0,0,0,0,
103,103,103,0,103,103,103,103,103,
0,0,0,0,0,0,0,0,107,
92,92,92,92,92,0,92,92,92,
96,0,96,96,96,0,96,96,96,
90,0,90,90,90,90,90,90,90,
85,0,85,0,0,0,85,0,85,
84,0,84,84,84,84,84,0,84,
83,0,83,83,83,83,83,0,0,
82,0,82,82,82,82,82,0,82,
81,0,0,0,0,81,81,0,81,
80,80,0,80,80,80,80,80,80,
0,0,0,0,0,0,0,0,0,
0,0,0,0,0,0,0,0,0,
0,0,0,0,0,0,0,0,0.