[layer]
type=Tile Layer 1
data=
1,21,3,1,3,0,1,1,6,
1,0,0,21,0,0,1,1,4,
1,21,1,4,1,1,1,1,1,
4,0,1,0,21,0,0,0,1,
1,1,4,21,1,1,5,1,1,
1,1,3,21,3,1,1,1,1,
1,6,1,21,6,1,1,1,1,
0,21,0,0,5,3,1,1,1,
3,21,1,1,1,1,1,1,1,
1,1,0,21,0,0,0,1,1,
1,1,1,21,0,0,1,5,1,
0,0,21,1,3,0,5,6,1,
6,1,1,1,21,0,0,0,0,
1,21,0,0,0,0,1,1,1,
3,21,5,3,1,0,0,1,1,
1,0,1,0,21,0,1,1,5,
1,0,0,1,1,1,21,0,0,
1,4,6,0,0,21,0,0,0,
0,0,0,3,21,1,1,4,0,
1,1,1,1,21,5,1,1,0,
0,0,0,21,0,1,0,0,0,
1,1,6,21,1,1,5,1,1,
0,0,1,0,0,0,1,21,1,
5,4,1,1,21,1,1,1,4,
0,1,1,1,21,4,6,1,3,
21,1,1,1,3,1,1,1,1,
0,1,1,1,21,1,4,6,1,
1,21,4,0,1,1,4,1,1,
1,21,1,0,1,1,1,1,1,
1,0,21,0,1,6,6,5,1,
1,4,1,21,6,1,1,1,4,
1,1,1,0,0,0,0,21,0,
1,1,1,3,1,1,6,21,1,
0,21,1,3,0,0,0,0,1,
4,21,1,0,1,6,1,3,1,
1,21,1,0,1,1,1,1,1,
1,0,0,0,21,0,0,1,1,
1,0,3,1,1,1,21,0,0,
1,21,0,0,1,4,6,1,0,
0,1,1,1,1,6,1,1,21,
0,1,1,3,5,1,0,21,0,
0,0,0,0,0,0,21,3,1,
1,1,0,1,21,0,0,3,1,
1,1,21,0,1,4,0,1,5,
0,21,1,0,0,0,0,0,0,
0,1,1,1,4,1,0,1,21,
21,1,1,5,1,1,1,3,1,
0,0,0,21,0,0,0,4,1,
1,6,1,1,1,1,21,5,1,
6,1,3,5,21,1,0,3,1,
1,1,1,1,1,1,21,1,1,
0,0,0,0,0,0,0,0,0,
0,0,0,0,0,0,0,0,0,
0,0,0,0,0,0,0,0,0.
[layer]
type=Tile Layer 2
data=
234,0,234,234,234,0,234,234,234,
233,0,0,0,0,0,233,233,233,
220,0,220,220,220,220,220,220,220,
174,0,174,0,0,0,0,0,174,
152,152,152,0,152,152,152,152,152,
189,189,189,0,189,189,189,189,189,
175,175,175,0,175,175,175,175,175,
0,0,0,0,169,169,169,169,169,
147,0,147,147,147,147,147,147,147,
193,193,0,0,0,0,0,193,193,
179,179,179,0,0,0,179,179,179,
0,0,0,165,165,0,165,165,165,
150,150,150,150,0,0,0,0,0,
188,0,0,0,0,0,188,188,188,
174,0,174,174,174,0,0,174,174,
160,0,160,0,0,0,160,160,160,
146,0,0,146,146,146,0,0,0,
182,182,182,0,0,0,0,0,0,
0,0,0,168,0,168,168,168,0,
155,155,155,155,0,155,155,155,0,
0,0,0,0,0,142,0,0,0,
168,168,168,0,168,168,168,168,168,
0,0,163,0,0,0,163,0,163,
143,143,143,143,0,143,143,143,143,
0,137,137,137,0,137,137,137,137,
0,163,163,163,163,163,163,163,163,
0,158,158,158,0,158,158,158,158,
145,0,145,0,145,145,145,145,145,
133,0,133,0,133,133,133,133,133,
165,0,0,0,165,165,165,165,165,
146,146,146,0,146,146,146,146,146,
141,141,141,0,0,0,0,0,0,
122,122,122,122,122,122,122,0,122,
0,0,160,160,0,0,0,0,160,
148,0,148,0,148,148,148,148,148,
136,0,136,0,136,136,136,136,136,
124,0,0,0,0,0,0,124,124,
154,0,154,154,154,154,0,0,0,
142,0,0,0,142,142,142,142,0,
0,131,131,131,131,131,131,131,0,
0,120,120,120,120,120,0,0,0,
0,0,0,0,0,0,0,119,119,
108,108,0,108,0,0,0,108,108,
107,107,0,0,107,107,0,107,107,
0,0,106,0,0,0,0,0,0,
0,95,95,95,95,95,0,95,0,
0,90,90,90,90,90,90,90,90,
0,0,0,0,0,0,0,93,93,
88,88,88,88,88,88,0,88,88,
91,91,91,91,0,91,0,91,91,
86,86,86,86,86,86,0,86,86,
0,0,0,0,0,0,0,0,0,
0,0,0,0,0,0,0,0,0,
0,0,0,0,0,0,0,0,0.