[layer]
type=Tile Layer 1
data=
0,0,0,21,1,0,1,1,1,
1,1,1,1,1,21,1,1,1,
1,0,1,21,1,0,0,0,1,
1,21,1,0,1,0,1,1,1,
1,0,1,21,0,0,1,1,1,
1,21,1,1,1,0,1,1,1,
0,0,0,0,1,21,1,1,1,
1,21,1,0,1,0,1,1,1,
1,21,1,0,1,0,0,0,0,
0,21,0,1,1,1,1,1,1,
1,1,1,21,1,1,1,1,1,
0,1,1,0,0,0,0,21,1,
0,0,21,1,1,1,1,1,1,
1,1,0,21,0,1,1,0,0,
1,1,1,1,1,1,1,1,21,
1,1,0,0,21,1,1,1,0,
1,1,0,1,1,1,21,0,1,
1,1,0,0,21,0,1,1,1,
0,0,1,1,1,21,1,0,1,
1,1,1,1,1,21,1,0,1,
1,0,0,0,1,0,1,21,0,
1,21,1,1,1,0,1,0,1,
1,21,1,0,0,0,1,0,1,
1,21,1,0,1,1,1,0,1,
0,0,0,0,0,0,0,0,0,
0,0,0,0,0,0,0,0,0,
0,0,0,0,0,0,0,0,0.
[layer]
type=Tile Layer 2
data=
0,0,0,0,138,0,138,138,138,
123,123,123,123,123,0,123,123,123,
135,0,135,0,135,0,0,0,135,
109,0,109,0,109,0,109,109,109,
100,0,100,0,0,0,100,100,100,
86,0,86,86,86,0,86,86,86,
0,0,0,0,113,0,113,113,113,
104,0,104,0,104,0,104,104,104,
95,0,95,0,95,0,0,0,0,
0,0,0,86,86,86,86,86,86,
97,97,97,0,97,97,97,97,97,
0,98,98,0,0,0,0,0,98,
0,0,0,90,90,90,90,90,90,
82,82,0,0,0,82,82,0,0,
73,73,73,73,73,73,73,73,0,
73,73,0,0,0,73,73,73,0,
72,72,0,72,72,72,0,0,72,
71,71,0,0,0,0,71,71,71,
0,0,63,63,63,0,63,0,63,
59,59,59,59,59,0,59,0,59,
61,0,0,0,61,0,61,0,0,
60,0,60,60,60,0,60,0,60,
59,0,59,0,0,0,59,0,59,
58,0,58,0,58,58,58,0,58,
0,0,0,0,0,0,0,0,0,
0,0,0,0,0,0,0,0,0,
0,0,0,0,0,0,0,0,0.