[layer]
type=Tile Layer 1
data=
1,1,1,21,1,1,1,1,1,
0,0,1,21,1,1,1,1,1,
2,2,2,21,7,2,2,2,2,
2,2,18,9,2,21,0,2,2,
1,0,21,2,2,0,2,1,1,
2,21,7,2,2,24,2,2,2,
0,2,10,2,0,0,21,1,1,
0,21,2,0,0,1,0,0,1,
1,1,1,1,0,0,21,0,1,
0,0,21,1,1,1,0,0,1,
20,2,2,2,2,2,0,2,21,
0,2,1,21,0,0,0,0,0,
20,2,2,2,2,2,21,2,2,
0,2,1,1,1,2,21,2,1,
21,1,1,1,1,2,8,2,1,
0,0,21,1,0,2,0,2,1,
2,2,21,2,7,2,2,2,2,
1,1,0,2,0,21,0,0,0,
1,1,21,19,0,1,1,1,1,
1,1,21,2,0,1,0,1,1,
2,2,21,1,0,1,0,1,1,
10,0,2,2,0,0,1,21,0,
2,2,10,21,1,1,1,1,1,
0,21,2,18,2,2,2,0,2,
1,2,10,21,1,1,2,19,1,
1,2,21,0,0,0,2,0,0,
2,2,2,21,2,18,2,2,2,
1,8,2,21,2,24,2,1,1,
1,2,2,21,2,10,2,1,1,
1,21,1,0,2,0,2,1,1,
0,21,1,0,0,0,0,1,1,
0,2,2,2,21,2,2,7,2,
0,1,0,1,0,21,2,1,1,
1,2,2,21,2,24,0,1,1,
0,2,19,21,1,1,0,1,1,
0,2,2,0,0,1,21,1,1,
0,0,1,0,0,0,21,0,0,
0,0,1,1,1,21,2,0,0,
0,1,1,1,1,0,21,19,1,
2,21,2,7,2,0,2,2,2,
2,21,0,18,0,0,2,2,2,
1,21,1,1,1,0,1,1,1,
0,0,1,1,1,21,1,2,2,
1,21,1,1,1,1,1,2,8,
1,0,1,1,1,0,21,2,0,
0,0,0,0,0,0,0,0,0,
0,0,0,0,0,0,0,0,0,
0,0,0,0,0,0,0,0,0.
[layer]
type=Tile Layer 2
data=
198,198,198,0,198,198,198,198,198,
0,0,206,0,206,206,206,206,206,
204,204,204,0,204,204,204,204,204,
178,178,0,178,178,0,0,178,178,
165,0,0,165,165,0,165,165,165,
152,0,152,152,152,0,152,152,152,
0,138,138,138,0,0,0,138,138,
0,0,173,0,0,173,0,0,173,
160,160,160,160,0,0,0,0,160,
0,0,0,147,147,147,0,0,147,
0,134,134,134,134,134,0,134,0,
0,167,167,0,0,0,0,0,0,
0,154,154,154,154,154,0,154,154,
0,142,142,142,142,142,0,142,142,
0,130,130,130,130,130,130,130,130,
0,0,0,162,0,162,0,162,162,
149,149,0,149,149,149,149,149,149,
137,137,0,137,0,0,0,0,0,
125,125,0,0,0,125,125,125,125,
156,156,0,156,0,156,0,156,156,
144,144,0,144,0,144,0,144,144,
132,0,132,132,0,0,132,0,0,
121,121,121,0,121,121,121,121,121,
0,0,150,0,150,150,150,0,150,
139,139,139,0,139,139,139,0,139,
128,128,0,0,0,0,128,0,0,
116,116,116,0,116,0,116,116,116,
145,145,145,0,145,0,145,145,145,
134,134,134,0,134,134,134,134,134,
123,0,123,0,123,0,123,123,123,
0,0,112,0,0,0,0,112,112,
0,139,139,139,0,139,139,139,139,
0,128,0,128,0,0,128,128,128,
118,118,118,0,118,0,0,118,118,
0,108,0,0,108,108,0,108,108,
0,107,107,0,0,107,0,107,107,
0,0,97,0,0,0,0,0,0,
0,0,96,96,96,0,96,0,0,
0,95,95,95,95,0,0,0,95,
85,0,85,85,85,0,85,85,85,
84,0,0,0,0,0,84,84,84,
83,0,83,83,83,0,83,83,83,
0,0,82,82,82,0,82,82,82,
81,0,81,81,81,81,81,81,81,
80,0,80,80,80,0,0,80,0,
0,0,0,0,0,0,0,0,0,
0,0,0,0,0,0,0,0,0,
0,0,0,0,0,0,0,0,0.