[layer]
type=Tile Layer 1
data=
0,1,1,1,1,1,4,4,21,
0,0,0,1,0,1,1,0,21,
1,5,21,6,0,1,1,1,1,
1,1,21,1,1,1,0,0,0,
1,1,1,1,0,1,21,1,0,
0,0,0,1,21,3,0,4,0,
21,1,1,1,3,1,1,1,4,
0,0,1,0,0,1,21,0,1,
0,5,3,5,0,1,21,1,1,
3,21,1,1,1,1,1,0,0,
0,0,0,1,1,1,0,0,21,
0,1,3,0,6,0,4,1,21,
1,1,1,21,2,0,1,1,1,
0,1,21,0,3,0,0,1,0,
0,0,21,1,4,1,0,0,0,
0,0,0,0,0,0,0,0,0,
0,0,0,0,0,0,0,0,0,
0,0,0,0,0,0,0,0,0.
[layer]
type=Tile Layer 2
data=
0,102,102,102,102,102,102,102,0,
0,0,0,84,0,84,84,0,0,
79,79,0,79,0,79,79,79,79,
82,82,0,82,82,82,0,0,0,
74,74,74,74,0,74,0,74,0,
0,0,0,73,0,73,0,73,0,
0,65,65,65,65,65,65,65,65,
0,0,64,0,0,64,0,0,64,
0,63,63,63,0,63,0,63,63,
62,0,62,62,62,62,62,0,0,
0,0,0,61,61,61,0,0,0,
0,60,60,0,60,0,60,60,0,
56,56,56,0,56,0,56,56,56,
0,58,0,0,58,0,0,58,0,
0,0,0,57,57,57,0,0,0,
0,0,0,0,0,0,0,0,0,
0,0,0,0,0,0,0,0,0,
0,0,0,0,0,0,0,0,0.