[layer]
type=Tile Layer 1
data=
1,4,1,6,3,4,1,21,1,
1,1,1,21,0,0,1,0,1,
1,1,1,21,1,1,6,1,1,
1,5,0,0,0,21,3,0,1,
0,0,0,0,0,21,0,0,1,
0,21,1,6,1,1,0,1,1,
1,21,1,1,1,1,0,1,1,
4,21,4,1,1,6,3,0,3,
0,0,1,1,1,1,1,21,0,
0,21,0,4,1,1,1,0,0,
5,1,21,1,1,1,1,0,1,
6,1,1,1,4,1,1,21,1,
1,1,1,21,6,1,5,1,1,
1,4,1,1,1,1,21,1,1,
1,1,1,21,1,1,1,5,6,
3,1,1,0,1,21,0,0,1,
5,3,1,21,1,1,1,0,1,
0,0,0,0,1,21,0,0,6,
6,1,1,5,1,21,1,1,1,
1,0,21,0,0,0,4,1,1,
1,21,1,1,1,1,1,5,6,
0,0,1,1,1,1,1,1,21,
0,4,21,0,1,6,4,1,1,
0,0,1,1,0,0,21,3,1,
1,1,21,1,1,1,0,1,1,
1,6,0,21,0,0,0,0,1,
1,6,4,21,1,5,1,0,0,
0,0,0,0,0,0,0,0,0,
0,0,0,0,0,0,0,0,0,
0,0,0,0,0,0,0,0,0.
[layer]
type=Tile Layer 2
data=
152,152,152,152,152,152,152,0,152,
158,158,158,0,0,0,158,0,158,
149,149,149,0,149,149,149,149,149,
117,117,0,0,0,0,117,0,117,
0,0,0,0,0,0,0,0,107,
0,0,133,133,133,133,0,133,133,
123,0,123,123,123,123,0,123,123,
113,0,113,113,113,113,113,0,113,
0,0,102,82,102,82,102,0,0,
0,0,0,102,128,102,128,0,0,
118,118,0,94,94,94,94,0,118,
86,86,5,86,108,86,86,0,5,
93,93,75,0,93,93,75,93,93,
98,98,98,6,122,6,0,6,6,
107,107,107,0,107,107,107,107,107,
103,103,103,0,103,0,0,0,103,
94,94,94,0,94,94,94,0,94,
0,0,0,0,93,0,0,0,93,
80,80,80,80,80,0,80,80,80,
83,0,0,0,0,0,83,83,83,
78,0,78,78,78,78,78,78,78,
0,0,73,73,73,73,73,73,0,
0,72,0,0,72,72,72,72,72,
0,0,71,71,0,0,0,71,71,
70,70,0,70,70,70,0,70,70,
69,69,0,0,0,0,0,0,69,
68,68,68,0,68,68,68,0,0,
0,0,0,0,0,0,0,0,0,
0,0,0,0,0,0,0,0,0,
0,0,0,0,0,0,0,0,0.