[layer]
type=Tile Layer 1
data=
1,1,21,1,1,1,1,4,1,
0,0,21,1,1,6,4,1,1,
0,21,0,1,3,1,6,1,1,
1,1,21,0,5,1,5,1,1,
1,1,1,21,0,1,1,1,3,
1,1,1,6,21,0,0,0,0,
1,1,0,21,0,0,0,0,0,
3,21,0,1,1,1,3,1,5,
4,21,1,1,1,1,1,1,1,
21,4,1,1,5,1,1,1,4,
0,1,1,6,1,1,0,0,21,
0,1,1,1,5,1,0,1,21,
0,21,0,0,0,3,0,1,0,
1,1,1,1,21,6,0,4,1,
0,21,0,1,0,1,0,1,0,
0,3,1,1,0,1,21,1,0,
0,21,0,0,0,5,0,0,0,
21,6,1,1,5,1,1,1,1,
0,0,21,3,4,1,4,0,0,
0,1,0,1,1,1,6,1,21,
1,0,21,1,1,1,1,1,0,
1,21,0,0,1,1,6,1,0,
1,5,1,21,4,1,0,0,0,
4,1,1,21,0,0,0,1,0,
1,1,4,1,1,6,1,1,21,
1,1,5,1,0,0,21,1,0,
1,1,5,6,1,1,21,0,0,
1,5,5,21,1,1,3,0,0,
1,1,1,21,3,1,6,1,0,
1,1,1,21,1,1,1,1,0,
5,1,1,0,0,0,21,0,0,
0,21,0,0,1,1,0,0,3,
0,1,1,1,1,1,4,0,21,
0,1,1,4,1,4,1,1,21,
0,1,3,1,6,1,1,1,21,
0,0,0,0,1,1,1,0,21,
1,6,0,0,0,21,0,1,0,
1,6,21,1,1,1,0,1,0,
3,1,21,1,5,1,0,0,0,
1,5,21,6,5,1,1,1,1,
0,0,0,1,1,1,0,21,0,
1,1,1,3,1,1,21,1,0,
0,0,0,0,0,0,0,1,21,
0,1,4,1,1,1,6,1,21,
0,1,21,0,0,0,0,1,0,
0,1,21,3,4,1,1,1,4,
0,1,0,0,21,0,0,0,0,
1,1,1,1,5,1,1,21,0,
1,1,1,1,0,21,0,0,1,
1,1,6,4,0,21,0,1,1,
1,6,1,3,1,1,21,0,0,
0,0,0,0,0,0,0,0,0,
0,0,0,0,0,0,0,0,0,
0,0,0,0,0,0,0,0,0.
[layer]
type=Tile Layer 2
data=
223,223,0,223,223,223,223,223,223,
0,0,0,233,233,233,233,233,233,
0,0,0,231,231,231,231,231,231,
174,174,0,0,174,174,174,174,174,
159,159,159,0,0,159,159,159,159,
199,199,199,199,0,0,0,0,0,
184,184,0,0,0,0,0,0,0,
169,0,0,169,169,169,169,169,169,
147,0,147,147,147,147,147,147,147,
0,184,184,184,184,184,184,184,184,
0,179,179,179,179,179,0,0,0,
0,165,165,165,165,165,0,165,0,
0,0,0,0,0,150,0,150,0,
188,188,188,188,0,188,0,188,188,
0,0,0,174,0,174,0,174,0,
0,160,160,160,0,160,0,160,0,
0,0,0,0,0,146,0,0,0,
0,173,173,173,173,173,173,173,173,
0,0,0,168,168,168,168,0,0,
0,155,0,155,155,155,155,155,0,
142,0,0,142,142,142,142,142,0,
177,0,0,0,177,177,177,177,0,
163,163,163,0,163,163,0,0,0,
150,150,150,0,0,0,0,150,0,
131,131,131,131,131,131,131,131,0,
171,171,171,171,0,0,0,171,0,
158,158,158,158,158,158,0,0,0,
145,145,145,0,145,145,145,0,0,
133,133,133,0,133,133,133,133,0,
165,165,165,0,165,165,165,165,0,
153,153,153,0,0,0,0,0,0,
0,0,0,0,141,141,0,0,141,
0,128,128,128,128,128,128,0,0,
0,160,160,160,160,160,160,160,0,
0,148,148,148,148,148,148,148,0,
0,0,0,0,136,136,136,0,0,
124,124,0,0,0,0,0,124,0,
154,154,0,154,154,154,0,154,0,
142,142,0,142,142,142,0,0,0,
125,125,0,125,125,125,125,125,125,
0,0,0,120,120,120,0,0,0,
119,119,119,119,119,119,0,119,0,
0,0,0,0,0,0,0,108,0,
0,107,107,107,107,107,107,107,0,
0,106,0,0,0,0,0,106,0,
0,95,0,95,95,95,95,95,95,
0,94,0,0,0,0,0,0,0,
93,93,93,93,93,93,93,0,0,
92,92,92,92,0,0,0,0,92,
91,91,91,91,0,0,0,91,91,
90,90,90,90,90,90,0,0,0,
0,0,0,0,0,0,0,0,0,
0,0,0,0,0,0,0,0,0,
0,0,0,0,0,0,0,0,0.