[layer]
type=Tile Layer 1
data=
1,1,21,0,1,0,0,1,0,
0,1,21,1,1,1,0,1,1,
0,21,0,1,0,1,0,1,1,
1,1,1,1,21,1,0,1,1,
1,1,0,0,0,1,21,1,0,
1,1,0,1,0,1,21,1,0,
1,1,0,1,21,1,0,0,0,
0,1,1,1,21,1,1,1,1,
0,0,0,21,0,1,0,0,0,
0,1,1,0,21,0,1,1,0,
0,1,1,1,1,1,1,1,21,
0,1,21,0,0,0,0,1,0,
1,0,1,1,21,1,1,0,1,
1,0,0,1,0,1,21,0,1,
1,1,21,0,1,0,0,1,1,
0,0,0,0,0,0,0,0,0,
0,0,0,0,0,0,0,0,0,
0,0,0,0,0,0,0,0,0.
[layer]
type=Tile Layer 2
data=
94,94,0,0,94,0,0,94,0,
0,73,0,73,73,73,0,73,73,
0,0,0,72,0,72,0,72,72,
67,67,67,67,0,67,0,67,67,
64,64,0,0,0,64,0,64,0,
63,63,0,63,0,63,0,63,0,
62,62,0,62,0,62,0,0,0,
0,52,52,52,0,52,52,52,52,
0,0,0,0,0,54,0,0,0,
0,53,53,0,0,0,53,53,0,
0,50,50,50,50,50,50,50,0,
0,51,0,0,0,0,0,51,0,
50,0,50,50,0,50,50,0,50,
49,0,0,49,0,49,0,0,49,
48,48,0,0,48,0,0,48,48,
0,0,0,0,0,0,0,0,0,
0,0,0,0,0,0,0,0,0,
0,0,0,0,0,0,0,0,0.