[layer]
type=Tile Layer 1
data=
1,1,1,1,1,0,21,0,0,
1,1,1,1,1,0,21,1,0,
1,1,1,0,21,1,0,1,0,
1,1,1,21,1,1,0,0,0,
1,1,1,21,1,1,1,0,0,
0,1,21,0,0,0,1,1,0,
0,0,1,1,1,0,21,0,0,
1,0,21,1,1,1,1,1,0,
1,1,21,1,1,1,1,1,0,
1,1,1,21,0,0,0,0,0,
1,1,1,1,1,1,1,21,1,
0,0,0,21,1,1,1,0,0,
1,1,1,1,1,1,1,21,1,
1,0,1,0,21,0,1,0,1,
1,0,1,1,1,21,1,0,1,
0,0,21,0,0,0,1,0,1,
1,1,1,1,1,1,1,21,1,
0,21,1,1,0,0,0,1,1,
1,1,1,21,0,1,0,1,1,
1,1,1,21,1,1,0,1,1,
1,1,1,0,0,0,21,0,0,
1,1,1,1,1,1,1,21,0,
1,1,1,1,21,1,1,0,0,
0,0,0,21,0,1,0,0,0,
0,0,0,0,0,0,0,0,0,
0,0,0,0,0,0,0,0,0,
0,0,0,0,0,0,0,0,0.
[layer]
type=Tile Layer 2
data=
138,138,138,138,138,0,0,0,0,
136,136,136,136,136,0,0,136,0,
135,135,135,0,0,135,0,135,0,
109,109,109,0,109,109,0,0,0,
100,100,100,0,100,100,100,0,0,
0,90,0,0,0,0,90,90,0,
0,0,113,113,113,0,0,0,0,
104,0,0,104,104,104,104,104,0,
90,90,0,90,90,90,90,90,0,
86,86,86,0,0,0,0,0,0,
97,97,97,97,97,97,97,0,97,
0,0,0,0,98,98,98,0,0,
81,81,81,81,81,81,81,0,81,
82,0,82,0,0,0,82,0,82,
81,0,81,81,81,0,81,0,81,
0,0,0,0,0,0,73,0,73,
65,65,65,65,65,65,65,0,65,
0,0,71,71,0,0,0,71,71,
63,63,63,0,0,63,0,63,63,
59,59,59,0,59,59,0,59,59,
61,61,61,0,0,0,0,0,0,
57,57,57,57,57,57,57,0,0,
59,59,59,59,0,59,59,0,0,
0,0,0,0,0,58,0,0,0,
0,0,0,0,0,0,0,0,0,
0,0,0,0,0,0,0,0,0,
0,0,0,0,0,0,0,0,0.