[layer]
type=Tile Layer 1
data=
1,1,1,1,1,0,0,21,0,
0,21,0,0,0,0,1,1,1,
21,1,1,1,1,1,1,1,1,
0,21,1,1,1,1,1,1,1,
1,0,21,0,0,1,1,1,1,
1,1,1,1,21,1,1,1,1,
1,21,1,0,1,1,1,1,1,
1,21,1,0,0,0,0,0,1,
1,21,1,1,1,1,1,0,1,
1,21,0,0,1,1,1,0,1,
1,1,1,1,1,1,1,21,1,
0,0,0,0,21,0,1,0,1,
1,1,1,1,1,1,1,21,1,
0,0,0,0,1,0,21,0,0,
1,1,1,21,1,0,1,1,1,
1,0,0,21,0,0,1,1,1,
1,21,1,1,1,0,1,1,1,
1,21,1,1,1,0,1,1,1,
1,1,1,0,21,0,0,1,1,
1,1,1,1,21,1,0,1,1,
1,1,1,1,21,1,0,1,1,
1,1,21,1,0,1,0,1,1,
1,0,0,1,21,1,0,1,1,
1,1,0,0,21,0,0,1,1,
1,1,1,0,21,0,1,1,0,
1,1,1,1,1,0,0,21,0,
1,1,1,1,1,0,21,0,1,
1,1,1,1,0,0,1,21,0,
1,1,1,1,0,21,1,1,0,
1,1,1,1,1,0,1,21,0,
1,1,1,1,1,0,0,21,0,
1,1,0,21,0,0,0,0,0,
1,1,21,1,1,1,1,0,1,
1,0,1,0,21,0,0,0,0,
1,21,1,1,1,0,1,1,1,
1,0,1,0,0,21,1,0,1,
1,21,1,1,1,1,1,0,1,
0,0,0,0,0,21,0,0,1,
1,1,1,21,1,1,1,0,1,
0,0,1,0,1,1,1,21,1,
1,1,1,21,1,1,1,1,1,
1,1,1,0,1,21,0,0,1,
0,21,0,0,1,1,1,1,1,
0,1,1,21,1,1,1,1,1,
0,1,0,0,21,1,1,1,1,
0,0,1,1,21,0,1,1,1,
1,21,1,1,1,0,0,1,1,
1,21,1,1,1,1,0,1,1,
0,0,0,0,0,0,0,0,0,
0,0,0,0,0,0,0,0,0,
0,0,0,0,0,0,0,0,0.
[layer]
type=Tile Layer 2
data=
228,228,228,228,228,0,0,0,0,
0,0,0,0,0,0,227,227,227,
0,214,214,214,214,214,214,214,214,
0,0,183,183,183,183,183,183,183,
168,0,0,0,0,168,168,168,168,
146,146,146,146,0,146,146,146,146,
192,0,192,0,192,192,192,192,192,
178,0,178,0,0,0,0,0,178,
164,0,164,164,164,164,164,0,164,
149,0,0,0,149,149,149,0,149,
178,178,178,178,178,178,178,0,178,
0,0,0,0,0,0,173,0,173,
151,151,151,151,151,151,151,0,151,
0,0,0,0,145,0,0,0,0,
181,181,181,0,181,0,181,181,181,
167,0,0,0,0,0,167,167,167,
154,0,154,154,154,0,154,154,154,
141,0,141,141,141,0,141,141,141,
176,176,176,0,0,0,0,176,176,
162,162,162,162,0,162,0,162,162,
149,149,149,149,0,149,0,149,149,
136,136,0,136,0,136,0,136,136,
170,0,0,170,0,170,0,170,170,
157,157,0,0,0,0,0,157,157,
144,144,144,0,0,0,144,144,0,
132,132,132,132,132,0,0,0,0,
164,164,164,164,164,0,0,0,164,
152,152,152,152,0,0,152,0,0,
140,140,140,140,0,0,140,140,0,
127,127,127,127,127,0,127,0,0,
159,159,159,159,159,0,0,0,0,
147,147,0,0,0,0,0,0,0,
135,135,0,135,135,135,135,0,135,
123,0,123,0,0,0,0,0,0,
153,0,153,153,153,0,153,153,153,
141,0,141,0,0,0,141,0,141,
130,0,130,130,130,130,130,0,130,
0,0,0,0,0,0,0,0,119,
118,118,118,0,118,118,118,0,118,
0,0,107,0,107,107,107,0,107,
101,101,101,0,101,101,101,101,101,
105,105,105,0,105,0,0,0,105,
0,0,0,0,94,94,94,94,94,
0,93,93,0,93,93,93,93,93,
0,92,0,0,0,92,92,92,92,
0,0,91,91,0,0,91,91,91,
90,0,90,90,90,0,0,90,90,
89,0,89,89,89,89,0,89,89,
0,0,0,0,0,0,0,0,0,
0,0,0,0,0,0,0,0,0,
0,0,0,0,0,0,0,0,0.