[layer]
type=Tile Layer 1
data=
1,1,1,1,1,21,1,0,1,
0,0,1,0,1,0,1,21,1,
1,1,1,21,1,0,1,1,1,
1,1,1,0,0,0,21,0,1,
1,1,1,1,1,1,1,21,1,
1,0,0,21,1,1,1,0,1,
1,1,1,1,1,1,21,0,1,
1,1,1,0,21,0,0,0,1,
1,1,1,21,0,1,0,0,0,
1,1,1,1,21,1,0,1,1,
1,1,1,1,0,1,21,0,1,
1,0,0,21,0,1,1,0,1,
1,0,1,1,1,21,0,1,1,
1,21,0,0,0,1,0,0,1,
1,21,0,1,1,1,1,0,1,
1,1,21,1,1,1,0,1,1,
0,1,0,0,0,21,0,0,0,
0,1,1,1,1,1,1,1,21,
0,1,1,1,1,1,21,1,0,
0,1,1,1,1,1,21,1,0,
0,0,0,0,0,0,21,1,0,
0,0,0,0,0,0,0,0,0,
0,0,0,0,0,0,0,0,0,
0,0,0,0,0,0,0,0,0.
[layer]
type=Tile Layer 2
data=
127,127,127,127,127,0,127,0,127,
0,0,132,0,132,0,132,0,132,
124,124,124,0,124,0,124,124,124,
113,113,113,0,0,0,0,0,113,
94,94,94,94,94,94,94,0,94,
95,0,0,0,95,95,95,0,95,
82,82,82,82,82,82,0,0,82,
107,107,107,0,0,0,0,0,107,
98,98,98,0,0,98,0,0,0,
86,86,86,86,0,86,0,86,86,
82,82,82,82,0,82,0,0,82,
81,0,0,0,0,81,81,0,81,
73,0,73,73,73,0,0,73,73,
72,0,0,0,0,72,0,0,72,
71,0,0,71,71,71,71,0,71,
60,60,0,60,60,60,0,60,60,
0,62,0,0,0,0,0,0,0,
0,58,58,58,58,58,58,58,0,
0,60,60,60,60,60,0,60,0,
0,59,59,59,59,59,0,59,0,
0,0,0,0,0,0,0,58,0,
0,0,0,0,0,0,0,0,0,
0,0,0,0,0,0,0,0,0,
0,0,0,0,0,0,0,0,0.