[layer]
type=Tile Layer 1
data=
1,5,0,0,0,0,21,0,1,
2,7,2,2,2,2,2,21,2,
2,7,2,2,21,2,2,0,2,
4,1,4,21,0,1,1,1,1,
6,1,1,21,0,1,1,5,1,
1,1,0,21,0,5,1,1,1,
1,2,21,1,1,5,6,1,6,
1,8,0,0,0,21,0,0,0,
1,2,2,4,1,1,1,1,21,
1,1,1,21,0,0,0,0,0,
1,4,6,1,6,3,1,21,1,
0,0,21,0,1,1,1,0,0,
1,1,3,1,1,5,1,21,1,
1,0,2,2,21,0,4,0,1,
2,21,9,2,2,2,2,0,2,
1,2,2,2,21,1,3,1,1,
5,1,1,6,1,6,1,21,1,
1,1,1,1,21,2,1,1,1,
1,21,1,1,2,8,2,1,1,
0,0,6,1,2,2,2,0,21,
0,0,1,4,1,1,1,1,21,
0,2,2,7,2,2,2,2,21,
0,0,21,1,1,5,1,0,1,
3,1,0,0,21,0,0,0,1,
1,1,5,1,21,1,1,4,0,
2,2,2,2,21,2,7,2,0,
1,3,1,1,0,0,0,21,0,
2,2,0,2,2,21,2,9,2,
2,2,21,5,1,6,2,2,0,
8,2,1,1,1,1,0,21,0,
2,2,3,0,0,21,2,8,0,
1,1,1,21,0,1,2,2,0,
5,1,1,1,0,21,4,1,0,
1,1,1,1,1,0,21,0,0,
1,6,1,1,1,21,0,0,0,
1,1,6,4,3,0,1,21,0,
2,2,21,1,0,1,1,1,0,
9,2,2,2,21,2,2,2,0,
2,2,21,1,0,1,1,4,3,
6,1,0,1,0,21,0,1,1,
5,1,21,1,1,3,0,1,1,
0,7,2,2,2,2,2,2,21,
0,1,0,2,2,1,21,6,0,
0,1,2,8,21,1,0,1,0,
4,1,2,2,21,1,0,1,0,
0,2,2,2,2,21,2,7,2,
1,4,1,5,1,21,1,1,3,
1,1,1,1,1,21,1,1,5,
1,1,1,1,4,0,2,21,1,
2,2,2,2,21,2,9,2,0,
8,2,1,0,0,2,21,2,1,
0,0,0,0,0,0,0,0,0,
0,0,0,0,0,0,0,0,0,
0,0,0,0,0,0,0,0,0.
[layer]
type=Tile Layer 2
data=
234,234,0,0,0,0,0,0,234,
233,233,233,233,233,233,233,0,233,
231,231,231,231,0,231,231,0,231,
174,174,174,0,0,174,174,174,174,
159,159,159,0,0,159,159,159,159,
199,199,0,0,0,199,199,199,199,
175,175,0,175,175,175,175,175,175,
169,169,0,0,0,0,0,0,0,
147,147,147,147,147,147,147,147,0,
193,193,193,0,0,0,0,0,0,
170,170,170,170,170,170,170,0,170,
0,0,0,0,165,165,165,0,0,
143,143,143,143,143,143,143,0,143,
188,0,188,188,0,0,188,0,188,
174,0,174,174,174,174,174,0,174,
8,128,128,128,0,8,128,8,128,
111,111,111,111,111,111,111,0,111,
9,9,146,146,0,146,9,146,146,
8,0,135,135,135,135,135,8,8,
0,0,155,155,155,155,155,0,0,
0,0,142,142,142,142,142,142,0,
0,177,177,177,177,177,177,177,0,
0,0,0,163,163,163,163,0,163,
150,150,0,0,0,0,0,0,150,
137,137,137,137,0,137,137,137,0,
171,171,171,171,0,171,171,171,0,
158,158,158,158,0,0,0,0,0,
145,145,0,145,145,0,145,145,145,
133,133,0,133,133,133,133,133,0,
165,165,165,165,165,165,0,0,0,
153,153,153,0,0,0,153,153,0,
141,141,141,0,0,141,141,141,0,
128,128,128,128,0,0,128,128,0,
160,160,160,160,160,0,0,0,0,
148,148,148,148,148,0,0,0,0,
136,136,136,136,136,0,136,0,0,
124,124,0,124,0,124,124,124,0,
154,154,154,154,0,154,154,154,0,
142,142,0,142,0,142,142,142,142,
131,131,0,131,0,0,0,131,131,
120,120,0,120,120,120,0,120,120,
0,119,119,119,119,119,119,119,0,
0,108,0,108,108,108,0,108,0,
0,107,107,107,0,107,0,107,0,
106,106,106,106,0,106,0,106,0,
0,95,76,76,95,0,76,95,95,
94,75,75,94,94,0,4,75,94,
74,74,74,74,93,0,74,4,74,
74,92,74,92,92,0,74,0,4,
91,91,73,73,0,73,73,91,0,
72,90,4,0,0,90,0,90,4,
0,0,0,0,0,0,0,0,0,
0,0,0,0,0,0,0,0,0,
0,0,0,0,0,0,0,0,0.