[layer]
type=Tile Layer 1
data=
3,0,1,0,21,0,0,0,0,
1,21,1,1,1,1,4,5,1,
1,0,0,0,0,0,1,21,0,
1,3,1,4,1,21,1,1,1,
0,0,0,0,1,0,21,0,0,
21,1,6,1,4,1,1,1,1,
21,1,6,1,5,1,1,1,1,
0,1,21,1,0,1,1,1,1,
0,3,1,1,21,1,6,1,5,
3,0,21,1,5,1,1,1,5,
1,1,1,1,1,1,21,1,1,
1,0,1,1,1,6,1,21,0,
1,3,1,1,21,1,1,1,1,
1,1,1,5,1,4,1,1,21,
1,3,1,1,4,21,0,0,1,
3,1,1,1,1,0,1,21,0,
1,0,0,0,0,21,1,5,0,
0,0,1,1,1,1,4,4,21,
6,21,1,1,1,0,1,1,1,
3,0,0,0,0,21,1,0,0,
1,1,6,1,4,1,1,21,1,
0,21,1,1,4,1,1,0,1,
6,1,4,1,1,1,1,21,1,
0,0,0,0,0,0,0,21,3,
1,1,1,1,6,1,1,21,3,
1,1,1,21,0,0,3,0,5,
1,1,1,21,1,1,1,1,6,
0,21,0,0,0,0,1,3,1,
0,1,1,6,21,1,1,1,1,
0,0,0,1,21,6,4,1,1,
1,1,0,0,21,0,1,1,0,
0,21,6,1,4,1,1,3,1,
0,1,1,1,0,21,3,1,1,
0,0,0,0,0,0,0,0,0,
0,0,0,0,0,0,0,0,0,
0,0,0,0,0,0,0,0,0.
[layer]
type=Tile Layer 2
data=
171,0,171,0,0,0,0,0,0,
162,0,162,162,162,162,162,162,162,
168,0,0,0,0,0,168,0,0,
140,140,140,140,140,0,140,140,140,
0,0,0,0,135,0,0,0,0,
0,118,118,118,118,118,118,118,118,
0,108,108,108,108,108,108,108,108,
0,141,0,7,0,113,141,141,141,
0,130,130,104,0,104,130,130,130,
119,0,0,95,95,95,5,119,119,
87,5,87,87,109,87,0,5,87,
135,0,108,135,135,135,108,0,0,
100,100,100,100,0,6,6,100,6,
109,109,109,109,109,109,109,109,0,
104,104,104,104,104,0,0,0,104,
130,130,130,130,130,0,130,0,0,
120,0,0,0,0,0,120,120,0,
0,0,110,110,110,110,110,110,0,
100,0,100,100,100,0,100,100,100,
124,0,0,0,0,0,124,0,0,
109,109,109,109,109,109,109,0,109,
0,0,105,105,105,105,105,0,105,
91,91,91,91,91,91,91,0,91,
0,0,0,0,0,0,0,0,95,
82,82,82,82,82,82,82,0,82,
85,85,85,0,0,0,85,0,85,
80,80,80,0,80,80,80,80,80,
0,0,0,0,0,0,75,75,75,
0,74,74,74,0,74,74,74,74,
0,0,0,73,0,73,73,73,73,
72,72,0,0,0,0,72,72,0,
0,0,71,71,71,71,71,71,71,
0,70,70,70,0,0,70,70,70,
0,0,0,0,0,0,0,0,0,
0,0,0,0,0,0,0,0,0,
0,0,0,0,0,0,0,0,0.