[layer]
type=Tile Layer 1
data=
0,21,0,1,1,1,0,1,1,
0,1,1,21,1,0,1,1,1,
0,1,1,1,21,0,1,1,1,
1,1,1,1,1,21,0,0,1,
1,1,1,1,1,1,1,21,1,
0,1,1,0,21,0,0,0,1,
1,21,1,1,1,1,1,0,1,
1,21,1,1,1,1,1,0,1,
1,21,1,1,1,1,1,0,1,
1,0,1,0,0,0,21,0,1,
1,21,1,1,1,0,1,0,1,
1,21,1,1,1,0,1,0,1,
1,0,0,0,1,0,21,0,1,
1,21,1,0,1,1,1,1,1,
0,0,1,0,1,0,0,21,1,
1,1,1,0,1,21,1,0,1,
0,21,1,0,0,0,1,0,1,
1,21,1,1,1,1,1,0,1,
0,0,0,21,0,0,1,0,0,
1,1,1,1,1,21,1,1,1,
0,0,1,21,0,0,1,0,1,
0,1,1,1,21,1,1,1,1,
0,0,0,1,21,0,0,0,0,
0,1,0,1,21,1,1,1,1,
0,1,0,1,21,1,0,0,0,
0,1,21,1,1,1,0,1,1,
0,1,0,0,21,0,0,1,1,
0,0,0,0,0,0,0,0,0,
0,0,0,0,0,0,0,0,0,
0,0,0,0,0,0,0,0,0.
[layer]
type=Tile Layer 2
data=
0,0,0,160,160,160,0,160,160,
0,158,158,0,158,0,158,158,158,
0,157,157,157,0,0,157,157,157,
117,117,117,117,117,0,0,0,117,
102,102,102,102,102,102,102,0,102,
0,133,133,0,0,0,0,0,133,
123,0,123,123,123,123,123,0,123,
113,0,113,113,113,113,113,0,113,
102,0,102,102,102,102,102,0,102,
128,0,128,0,0,0,0,0,128,
118,0,118,118,118,0,118,0,118,
108,0,108,108,108,0,108,0,108,
98,0,0,0,98,0,0,0,98,
122,0,122,0,122,122,122,122,122,
0,0,112,0,112,0,0,0,112,
103,103,103,0,103,0,103,0,103,
0,0,94,0,0,0,94,0,94,
93,0,93,93,93,93,93,0,93,
0,0,0,0,0,0,84,0,0,
79,79,79,79,79,0,79,79,79,
0,0,82,0,0,0,82,0,82,
0,73,73,73,0,73,73,73,73,
0,0,0,72,0,0,0,0,0,
0,71,0,71,0,71,71,71,71,
0,70,0,70,0,70,0,0,0,
0,69,0,69,69,69,0,69,69,
0,68,0,0,0,0,0,68,68,
0,0,0,0,0,0,0,0,0,
0,0,0,0,0,0,0,0,0,
0,0,0,0,0,0,0,0,0.