[layer]
type=Tile Layer 1
data=
6,21,0,1,1,4,21,1,0,
1,21,0,5,0,1,1,1,0,
0,21,1,3,0,0,0,1,0,
3,21,1,1,1,1,0,3,1,
1,0,1,21,0,1,0,0,0,
1,3,5,1,5,1,1,1,21,
0,0,0,0,0,0,0,0,0,
0,0,0,0,0,0,0,0,0,
0,0,0,0,0,0,0,0,0.
[layer]
type=Tile Layer 2
data=
35,0,0,35,35,35,0,35,0,
34,0,0,34,0,34,34,34,0,
0,0,34,34,0,0,0,34,0,
30,0,30,30,30,30,0,30,30,
32,0,32,0,0,32,0,0,0,
27,27,27,27,27,27,27,27,0,
0,0,0,0,0,0,0,0,0,
0,0,0,0,0,0,0,0,0,
0,0,0,0,0,0,0,0,0.