[layer]
type=Tile Layer 1
data=
1,8,21,0,1,0,0,1,1,
1,21,0,0,1,0,1,1,1,
1,2,2,21,1,1,0,1,1,
2,9,2,21,2,2,0,2,2,
1,21,0,1,1,0,1,2,2,
0,2,2,2,2,21,2,2,9,
0,1,1,1,0,0,21,2,2,
0,1,2,21,2,1,0,0,0,
0,0,2,8,2,0,21,0,0,
1,1,21,0,2,1,1,1,0,
7,2,2,2,2,21,2,2,0,
1,1,1,1,1,0,0,21,0,
0,1,1,1,21,1,1,1,1,
0,1,1,1,21,1,1,1,1,
0,0,21,1,1,0,0,0,0,
0,1,21,0,0,0,0,1,1,
21,7,2,2,2,2,2,2,2,
0,0,0,0,21,1,1,1,1,
1,0,0,0,21,0,1,0,1,
1,1,1,1,1,1,1,21,1,
0,0,2,0,0,0,1,21,1,
1,10,2,0,1,21,1,0,1,
1,2,2,21,1,0,1,0,1,
1,21,1,1,1,0,1,0,1,
1,0,0,0,1,0,1,21,0,
1,1,1,21,1,1,1,1,1,
0,21,0,0,1,0,0,0,1,
0,1,1,1,1,1,21,0,0,
0,1,1,1,1,1,21,1,1,
0,2,2,7,21,2,2,2,2,
1,1,1,1,1,1,21,1,1,
0,21,0,0,2,2,0,1,1,
21,1,0,2,8,2,1,1,1,
0,1,1,2,2,2,21,1,0,
0,2,2,2,2,2,21,2,7,
0,0,0,21,0,0,2,2,1,
2,2,21,2,2,2,9,2,0,
0,21,2,2,2,9,2,2,2,
1,1,1,1,2,2,21,2,10,
0,21,0,0,0,1,0,2,2,
1,1,1,1,21,1,1,1,1,
1,1,1,1,21,1,0,1,1,
0,0,0,0,0,0,0,0,0,
0,0,0,0,0,0,0,0,0,
0,0,0,0,0,0,0,0,0.
[layer]
type=Tile Layer 2
data=
203,203,0,0,203,0,0,203,203,
201,0,0,0,201,0,201,201,201,
200,200,200,0,200,200,0,200,200,
138,138,138,0,138,138,0,138,138,
173,0,0,173,173,0,173,173,173,
0,160,160,160,160,0,160,160,160,
0,147,147,147,0,0,0,147,147,
0,134,134,0,134,134,0,0,0,
0,0,167,167,167,0,0,0,0,
154,154,0,0,154,154,154,154,0,
142,142,142,142,142,0,142,142,0,
130,130,130,130,130,0,0,0,0,
0,162,162,162,0,162,162,162,162,
0,149,149,149,0,149,149,149,149,
0,0,0,137,137,0,0,0,0,
0,125,0,0,0,0,0,125,125,
0,156,156,156,156,156,156,156,156,
0,0,0,0,0,144,144,144,144,
132,0,0,0,0,0,132,0,132,
115,115,115,115,115,115,115,0,115,
0,0,150,0,0,0,150,0,150,
139,139,139,0,139,0,139,0,139,
128,128,128,0,128,0,128,0,128,
116,0,116,116,116,0,116,0,116,
145,0,0,0,145,0,145,0,0,
127,127,127,0,127,127,127,127,127,
0,0,0,0,123,0,0,0,123,
0,112,112,112,112,112,0,0,0,
0,139,139,139,139,139,0,139,139,
0,128,128,128,0,128,128,128,128,
112,112,112,112,112,112,0,112,112,
0,0,0,0,108,108,0,108,108,
0,107,0,107,107,107,107,107,107,
0,97,97,97,97,97,0,97,0,
0,96,96,96,96,96,0,96,96,
0,0,0,0,0,0,95,95,95,
85,85,0,85,85,85,85,85,0,
0,0,84,84,84,84,84,84,84,
83,83,83,83,83,83,0,83,83,
0,0,0,0,0,82,0,82,82,
78,78,78,78,0,78,78,78,78,
80,80,80,80,0,80,0,80,80,
0,0,0,0,0,0,0,0,0,
0,0,0,0,0,0,0,0,0,
0,0,0,0,0,0,0,0,0.