[layer]
type=Tile Layer 1
data=
0,1,1,1,1,1,5,1,21,
0,0,0,0,0,1,21,0,0,
5,3,1,1,21,1,0,1,6,
4,1,0,0,21,0,0,5,1,
1,5,6,1,1,1,21,0,1,
1,21,0,0,1,0,1,0,1,
1,1,1,1,1,21,1,0,3,
1,21,0,0,1,0,1,0,1,
1,21,1,6,4,1,1,0,4,
0,0,0,0,0,0,0,0,0,
0,0,0,0,0,0,0,0,0,
0,0,0,0,0,0,0,0,0.
[layer]
type=Tile Layer 2
data=
0,71,71,71,71,71,71,71,0,
0,0,0,0,0,47,0,0,0,
44,44,44,44,0,44,0,44,44,
46,46,0,0,0,0,0,46,46,
43,43,43,43,43,43,0,0,43,
44,0,0,0,44,0,44,0,44,
41,41,41,41,41,0,41,0,41,
43,0,0,0,43,0,43,0,43,
40,0,40,40,40,40,40,0,40,
0,0,0,0,0,0,0,0,0,
0,0,0,0,0,0,0,0,0,
0,0,0,0,0,0,0,0,0.