[layer]
type=Tile Layer 1
data=
0,1,1,1,1,1,1,1,21,
1,21,1,1,1,1,1,1,1,
1,21,1,1,1,1,1,1,1,
1,21,1,1,1,1,1,1,1,
1,1,1,1,1,1,1,1,21,
0,0,0,0,0,0,0,0,0,
0,0,0,0,0,0,0,0,0,
0,0,0,0,0,0,0,0,0,
0,0,0,0,0,0,0,0,0.
[layer]
type=Tile Layer 2
data=
0,15,15,15,15,15,15,15,0,
15,0,1,1,1,1,1,1,15,
15,0,1,1,1,1,1,1,15,
15,0,15,1,1,1,1,1,15,
15,1,15,15,15,15,15,15,0,
0,0,0,0,0,0,0,0,0,
0,0,0,0,0,0,0,0,0,
0,0,0,0,0,0,0,0,0,
0,0,0,0,0,0,0,0,0.