[layer]
type=Tile Layer 1
data=
2,7,2,2,21,2,0,2,2,
0,0,2,2,21,0,0,1,1,
0,21,0,24,2,1,1,1,1,
0,0,0,1,1,1,21,1,1,
0,1,0,1,1,1,0,0,21,
18,21,2,2,2,2,2,2,0,
0,2,2,2,2,2,9,21,2,
2,2,2,2,0,2,21,18,2,
1,1,0,21,0,1,1,0,1,
2,7,2,2,2,2,21,0,2,
0,21,2,24,2,1,1,1,1,
0,0,21,0,1,1,1,1,1,
2,21,2,2,2,0,2,2,7,
2,21,0,0,2,20,0,0,0,
1,1,1,21,2,2,2,1,1,
2,2,7,21,2,2,2,0,2,
2,18,2,0,2,21,2,0,2,
1,0,1,0,1,21,1,0,1,
2,0,2,21,2,18,2,0,2,
0,21,0,0,0,0,1,0,1,
10,21,2,2,2,18,2,2,2,
2,2,21,2,10,2,8,2,0,
0,0,18,0,2,2,21,2,0,
0,2,2,2,2,2,2,7,21,
0,1,1,1,21,0,0,1,0,
0,2,2,1,21,1,0,1,1,
0,9,2,2,21,2,2,2,2,
0,2,7,2,21,2,2,2,2,
0,0,0,0,0,21,0,1,0,
24,2,1,1,1,1,21,1,1,
0,1,21,0,0,1,0,1,1,
0,1,1,1,21,1,0,1,1,
0,0,21,0,0,1,0,1,1,
0,1,1,1,1,1,21,1,1,
0,1,0,0,0,21,0,1,0,
0,1,1,1,1,1,21,1,0,
0,0,0,0,0,0,0,0,0,
0,0,0,0,0,0,0,0,0,
0,0,0,0,0,0,0,0,0.
[layer]
type=Tile Layer 2
data=
176,176,176,176,0,176,0,176,176,
0,0,175,175,0,0,0,175,175,
0,0,0,0,173,173,173,173,173,
0,0,0,140,140,140,0,140,140,
0,129,0,129,129,129,0,0,0,
0,0,118,118,118,118,118,118,0,
0,147,147,147,147,147,147,0,147,
135,135,135,135,0,135,0,0,135,
124,124,0,0,0,124,124,0,124,
113,113,113,113,113,113,0,0,113,
0,0,141,0,141,141,141,141,141,
0,0,0,0,130,130,130,130,130,
119,0,119,119,119,0,119,119,119,
109,0,0,0,109,0,0,0,0,
129,129,129,0,129,129,129,129,129,
125,125,125,0,125,125,125,0,125,
115,0,115,0,115,0,115,0,115,
104,0,104,0,104,0,104,0,104,
130,0,130,0,130,0,130,0,130,
0,0,0,0,0,0,120,0,120,
110,0,110,110,110,0,110,110,110,
100,100,0,100,100,100,100,100,0,
0,0,0,0,124,124,0,124,0,
0,114,114,114,114,114,114,114,0,
0,105,105,105,0,0,0,105,0,
0,96,96,96,0,96,0,96,96,
0,95,95,95,0,95,95,95,95,
0,86,86,86,0,86,86,86,86,
0,0,0,0,0,0,0,85,0,
0,84,84,84,84,84,0,84,84,
0,75,0,0,0,75,0,75,75,
0,74,74,74,0,74,0,74,74,
0,0,0,0,0,73,0,73,73,
0,72,72,72,72,72,0,72,72,
0,71,0,0,0,0,0,71,0,
0,70,70,70,70,70,0,70,0,
0,0,0,0,0,0,0,0,0,
0,0,0,0,0,0,0,0,0,
0,0,0,0,0,0,0,0,0.