[layer]
type=Tile Layer 1
data=
5,3,1,6,3,6,5,5,21,
0,0,21,1,6,1,3,1,0,
5,6,21,1,6,5,3,3,0,
0,1,21,0,0,1,0,3,0,
0,3,3,6,6,4,21,4,0,
0,0,0,0,0,21,0,4,0,
6,1,6,1,21,6,6,3,0,
1,1,3,3,21,5,5,3,0,
6,1,5,6,21,5,5,1,3,
5,4,21,0,1,4,0,1,6,
6,4,5,21,0,0,0,0,4,
6,1,5,0,0,1,6,21,0,
6,1,5,5,21,0,0,0,0,
1,5,1,0,21,0,4,6,4,
4,6,4,21,1,0,6,5,4,
3,3,3,21,6,0,0,0,0,
6,3,1,0,0,6,0,21,0,
1,4,4,1,21,4,0,6,1,
5,1,1,21,3,1,5,3,3,
5,5,4,0,1,0,21,0,1,
4,4,3,21,4,5,3,0,4,
0,0,21,0,6,0,0,0,3,
5,21,5,5,1,3,6,0,3,
1,21,6,1,1,5,3,0,6,
6,21,1,1,1,4,3,0,3,
3,0,21,0,0,0,4,0,0,
6,3,6,1,4,21,6,6,4,
5,5,1,1,1,21,5,1,6,
6,5,1,1,1,21,6,1,6,
4,1,1,4,1,1,21,1,4,
1,6,21,5,0,4,5,6,6,
5,0,21,0,0,0,5,1,4,
0,21,1,5,1,0,4,4,6,
0,0,0,0,0,0,0,0,0,
0,0,0,0,0,0,0,0,0,
0,0,0,0,0,0,0,0,0.
[layer]
type=Tile Layer 2
data=
162,162,162,162,162,162,162,162,0,
0,0,0,169,169,169,169,169,0,
167,167,0,167,167,167,167,167,0,
0,146,0,0,0,146,0,146,0,
0,134,134,134,134,134,0,134,0,
0,0,0,0,0,0,0,123,0,
112,112,112,112,0,112,112,112,0,
140,140,140,140,0,140,140,140,0,
123,123,123,123,0,123,123,123,123,
118,118,0,0,118,118,0,118,118,
108,108,108,0,0,0,0,0,108,
134,134,134,0,0,134,134,0,0,
124,124,124,124,0,0,0,0,0,
114,114,114,0,0,0,114,114,114,
103,103,103,0,103,0,103,103,103,
129,129,129,0,129,0,0,0,0,
119,119,119,0,0,119,0,0,0,
109,109,109,109,0,109,0,109,109,
94,94,94,0,94,94,94,94,94,
123,123,123,0,123,0,0,0,123,
113,113,113,0,113,113,113,0,113,
0,0,0,0,104,0,0,0,104,
95,0,95,95,95,95,95,0,95,
94,0,94,94,94,94,94,0,94,
85,0,85,85,85,85,85,0,85,
84,0,0,0,0,0,84,0,0,
63,63,63,63,63,0,63,63,63,
59,59,3,3,3,0,59,3,59,
58,58,58,58,58,0,58,3,58,
58,58,3,58,3,3,0,3,58,
71,71,0,71,0,71,71,71,71,
70,0,0,0,0,0,70,70,70,
0,0,69,69,69,0,69,69,69,
0,0,0,0,0,0,0,0,0,
0,0,0,0,0,0,0,0,0,
0,0,0,0,0,0,0,0,0.