[layer]
type=Tile Layer 1
data=
1,21,1,1,1,0,1,1,1,
1,21,1,1,1,0,1,1,1,
1,21,1,1,1,0,1,1,1,
0,0,21,0,1,0,0,0,1,
1,1,1,1,1,1,1,21,1,
0,21,0,0,0,0,1,0,1,
1,1,1,1,1,21,0,0,0,
1,1,1,1,1,21,1,0,1,
1,1,1,1,21,1,1,0,1,
1,1,1,1,0,21,0,0,1,
1,1,21,0,0,1,1,0,0,
1,1,21,1,0,1,1,1,0,
1,1,0,21,0,1,1,1,0,
1,1,21,1,1,1,1,1,0,
1,1,0,0,21,0,0,0,0,
0,1,0,1,21,1,0,0,0,
0,1,21,1,0,1,0,1,0,
0,1,21,1,0,0,0,1,0,
0,1,1,1,1,1,1,1,21,
0,1,0,0,0,0,0,1,21,
0,1,21,1,1,1,0,1,0,
0,0,0,0,0,0,0,0,0,
0,0,0,0,0,0,0,0,0,
0,0,0,0,0,0,0,0,0.
[layer]
type=Tile Layer 2
data=
127,0,127,127,127,0,127,127,127,
125,0,125,125,125,0,125,125,125,
124,0,124,124,124,0,124,124,124,
0,0,0,0,113,0,0,0,113,
94,94,94,94,94,94,94,0,94,
0,0,0,0,0,0,95,0,95,
86,86,86,86,86,0,0,0,0,
102,102,102,102,102,0,102,0,102,
94,94,94,94,0,94,94,0,94,
90,90,90,90,0,0,0,0,90,
82,82,0,0,0,82,82,0,0,
81,81,0,81,0,81,81,81,0,
73,73,0,0,0,73,73,73,0,
68,68,0,68,68,68,68,68,0,
71,71,0,0,0,0,0,0,0,
0,63,0,63,0,63,0,0,0,
0,62,0,62,0,62,0,62,0,
0,61,0,61,0,0,0,61,0,
0,57,57,57,57,57,57,57,0,
0,59,0,0,0,0,0,59,0,
0,58,0,58,58,58,0,58,0,
0,0,0,0,0,0,0,0,0,
0,0,0,0,0,0,0,0,0,
0,0,0,0,0,0,0,0,0.