[layer]
type=Tile Layer 1
data=
0,0,0,1,6,6,0,0,21,
4,1,21,4,5,5,0,2,2,
0,2,21,2,2,2,2,2,9,
0,6,6,3,21,5,1,2,2,
0,6,5,1,0,3,21,2,2,
0,2,2,2,21,2,2,2,9,
1,6,1,6,1,21,1,1,2,
3,3,1,5,5,5,5,21,1,
3,6,1,1,1,21,1,1,1,
1,1,21,3,5,6,1,6,6,
0,0,0,21,1,5,6,3,5,
1,6,21,0,3,5,5,1,3,
3,2,2,0,21,0,5,1,6,
2,2,9,2,2,2,21,2,0,
2,2,2,2,2,2,2,7,21,
5,3,5,21,5,1,3,6,1,
5,1,1,21,0,0,0,0,0,
6,3,6,21,6,5,3,1,6,
0,0,0,21,3,6,4,2,2,
2,21,2,2,2,2,2,2,9,
1,2,8,0,21,0,0,2,0,
3,21,2,2,1,0,6,5,5,
2,2,9,21,2,0,2,2,2,
6,2,2,21,1,0,3,5,6,
3,5,2,2,21,0,6,1,3,
2,2,2,9,21,0,2,2,2,
2,2,2,2,0,21,0,0,0,
10,2,1,5,5,6,1,4,21,
2,2,5,1,6,4,21,0,0,
0,0,0,0,0,21,0,6,4,
0,0,0,0,0,0,0,0,0,
0,0,0,0,0,0,0,0,0,
0,0,0,0,0,0,0,0,0.
[layer]
type=Tile Layer 2
data=
0,0,0,165,165,165,0,0,0,
163,163,0,163,163,163,0,163,163,
0,161,0,161,161,161,161,161,161,
0,111,111,111,0,111,111,111,111,
0,139,139,139,0,139,0,139,139,
0,128,128,128,0,128,128,128,128,
94,94,94,94,5,0,5,5,94,
85,85,85,85,85,85,85,0,5,
107,107,6,6,6,0,6,6,6,
6,6,0,98,98,98,98,98,98,
0,0,0,0,113,113,113,113,113,
102,102,0,0,102,102,102,102,102,
128,128,128,0,0,0,128,128,128,
118,118,118,118,118,118,0,118,0,
108,108,108,108,108,108,108,108,0,
93,93,93,0,93,93,93,93,93,
122,122,122,0,0,0,0,0,0,
107,107,107,0,107,107,107,107,107,
0,0,0,0,103,103,103,103,103,
94,0,94,94,94,94,94,94,94,
93,93,93,0,0,0,0,93,0,
84,0,84,84,84,0,84,84,84,
83,83,83,0,83,0,83,83,83,
82,82,82,0,82,0,82,82,82,
73,73,73,73,0,0,73,73,73,
72,72,72,72,0,0,72,72,72,
71,71,71,71,0,0,0,0,0,
70,70,70,70,70,70,70,70,0,
69,69,69,69,69,69,0,0,0,
0,0,0,0,0,0,0,68,68,
0,0,0,0,0,0,0,0,0,
0,0,0,0,0,0,0,0,0,
0,0,0,0,0,0,0,0,0.