[layer]
type=Tile Layer 1
data=
0,1,1,1,21,1,1,1,1,
0,0,21,1,0,0,0,1,1,
1,1,21,1,0,1,0,1,0,
0,1,0,1,0,1,0,1,21,
1,1,21,1,1,1,0,1,0,
1,1,0,1,21,0,0,1,0,
1,1,21,1,0,1,1,1,1,
0,1,0,0,21,1,0,0,0,
0,1,1,1,1,1,0,1,21,
0,1,1,21,1,1,1,1,1,
1,1,0,0,0,21,0,1,1,
1,1,0,21,1,1,0,0,0,
1,1,1,0,0,21,0,1,0,
1,1,1,1,21,1,1,1,1,
1,1,1,1,0,0,0,21,0,
0,0,0,0,0,0,0,0,0,
0,0,0,0,0,0,0,0,0,
0,0,0,0,0,0,0,0,0.
[layer]
type=Tile Layer 2
data=
0,102,102,102,0,102,102,102,102,
0,0,0,84,0,0,0,84,84,
83,83,0,83,0,83,0,83,0,
0,82,0,82,0,82,0,82,0,
74,74,0,74,74,74,0,74,0,
73,73,0,73,0,0,0,73,0,
68,68,0,68,0,68,68,68,68,
0,64,0,0,0,64,0,0,0,
0,63,63,63,63,63,0,63,0,
0,59,59,0,59,59,59,59,59,
61,61,0,0,0,0,0,61,61,
60,60,0,0,60,60,0,0,0,
59,59,59,0,0,0,0,59,0,
53,53,53,53,0,53,53,53,53,
57,57,57,57,0,0,0,0,0,
0,0,0,0,0,0,0,0,0,
0,0,0,0,0,0,0,0,0,
0,0,0,0,0,0,0,0,0.