[layer]
type=Tile Layer 1
data=
2,2,9,2,2,2,2,21,0,
1,2,2,2,8,2,0,21,0,
1,2,8,2,2,2,1,1,21,
1,2,2,0,1,21,1,0,1,
1,0,21,0,1,0,1,0,1,
1,21,1,1,1,0,1,0,1,
1,0,1,0,0,0,21,0,0,
1,21,1,1,1,1,1,1,1,
1,0,0,0,0,0,0,21,0,
1,1,1,1,1,1,1,21,1,
0,2,1,1,1,0,1,21,1,
10,2,1,1,1,21,1,0,1,
2,2,21,1,1,1,1,1,1,
0,1,1,21,1,1,1,1,1,
1,0,1,1,0,21,0,1,1,
1,21,1,1,1,2,2,2,1,
2,21,2,2,2,2,9,2,2,
1,1,21,1,1,0,10,2,1,
0,2,7,2,2,21,2,2,2,
1,0,0,1,1,21,0,0,1,
1,1,21,0,0,1,2,0,1,
1,1,1,0,21,0,2,8,1,
1,2,21,1,1,0,2,2,1,
1,10,0,0,0,0,0,21,0,
2,2,2,2,2,2,7,21,0,
2,2,2,2,2,2,7,21,0,
10,2,1,0,0,0,21,0,0,
2,21,0,0,1,1,1,1,1,
1,0,21,0,1,1,1,1,1,
2,2,2,21,7,2,2,2,2,
1,1,1,21,1,1,1,0,1,
0,21,0,0,1,0,0,0,1,
1,1,1,1,1,1,1,21,1,
1,21,0,0,0,0,0,0,1,
1,1,21,1,1,1,1,1,1,
1,0,0,0,0,0,21,0,0,
1,21,1,0,1,1,1,1,1,
0,0,1,21,1,1,1,0,0,
1,1,1,21,1,1,1,0,1,
1,1,0,0,21,0,1,1,1,
1,1,1,0,1,21,0,1,1,
2,2,1,21,1,1,0,1,1,
8,2,1,0,1,1,21,0,0,
2,2,1,1,0,0,0,21,0,
1,1,0,21,1,0,1,1,1,
0,0,0,0,0,0,0,0,0,
0,0,0,0,0,0,0,0,0,
0,0,0,0,0,0,0,0,0.
[layer]
type=Tile Layer 2
data=
208,208,208,208,208,208,208,0,0,
206,206,206,206,206,206,0,0,0,
204,204,204,204,204,204,204,204,0,
178,178,178,0,178,0,178,0,178,
165,0,0,0,165,0,165,0,165,
152,0,152,152,152,0,152,0,152,
138,0,138,0,0,0,0,0,0,
164,0,164,164,164,164,164,164,164,
160,0,0,0,0,0,0,0,0,
140,140,140,140,140,140,140,0,140,
0,134,134,134,134,0,134,0,134,
167,167,167,167,167,0,167,0,167,
147,147,0,147,147,147,147,147,147,
0,142,142,0,142,142,142,142,142,
130,0,130,130,0,0,0,130,130,
154,0,154,154,154,154,154,154,154,
149,0,149,149,149,149,149,149,149,
137,137,0,137,137,0,137,137,137,
0,125,125,125,125,0,125,125,125,
156,0,0,156,156,0,0,0,156,
144,144,0,0,0,144,144,0,144,
132,132,132,0,0,0,132,132,132,
121,121,0,121,121,0,121,121,121,
150,150,0,0,0,0,0,0,0,
139,139,139,139,139,139,139,0,0,
128,128,128,128,128,128,128,0,0,
116,116,116,0,0,0,0,0,0,
145,0,0,0,145,145,145,145,145,
134,0,0,0,134,134,134,134,134,
123,123,123,0,123,123,123,123,123,
112,112,112,0,112,112,112,0,112,
0,0,0,0,139,0,0,0,139,
122,122,122,122,122,122,122,0,122,
118,0,0,0,0,0,0,0,118,
103,103,0,103,103,103,103,103,103,
107,0,0,0,0,0,0,0,0,
97,0,97,0,97,97,97,97,97,
0,0,96,0,96,96,96,0,0,
95,95,95,0,95,95,95,0,95,
85,85,0,0,0,0,85,85,85,
84,84,84,0,84,0,0,84,84,
83,83,83,0,83,83,0,83,83,
82,82,82,0,82,82,0,0,0,
81,81,81,81,0,0,0,0,0,
80,80,0,0,80,0,80,80,80,
0,0,0,0,0,0,0,0,0,
0,0,0,0,0,0,0,0,0,
0,0,0,0,0,0,0,0,0.