[layer]
type=Tile Layer 1
data=
1,1,1,21,1,0,1,1,1,
0,0,1,0,0,0,1,21,0,
1,0,1,21,1,1,1,0,1,
1,0,1,21,1,0,1,1,1,
1,0,1,1,1,21,1,0,1,
0,0,1,21,1,0,1,1,1,
1,1,1,1,1,21,1,0,1,
1,0,1,21,1,0,1,0,0,
1,0,1,1,1,21,1,1,1,
1,1,1,0,1,3,21,0,1,
1,1,1,21,1,1,6,0,1,
0,21,0,5,1,6,4,0,0,
0,1,1,21,6,4,1,1,0,
1,1,1,0,4,1,1,1,21,
0,1,1,0,0,0,0,1,21,
0,0,0,0,0,0,0,0,0,
0,0,0,0,0,0,0,0,0,
0,0,0,0,0,0,0,0,0.
[layer]
type=Tile Layer 2
data=
89,89,89,0,89,0,89,89,89,
0,0,73,0,0,0,73,0,0,
72,0,72,0,72,72,72,0,72,
71,0,71,0,71,0,71,71,71,
64,0,64,64,64,0,64,0,64,
0,0,63,0,63,0,63,63,63,
59,59,59,59,59,0,59,0,59,
55,0,55,0,55,0,55,0,0,
51,0,51,51,51,0,51,51,51,
53,53,53,0,53,53,0,0,53,
50,50,50,0,50,50,50,0,50,
0,0,0,51,51,51,51,0,0,
0,50,50,0,50,50,50,50,0,
47,47,47,0,47,47,47,47,0,
0,48,48,0,0,0,0,48,0,
0,0,0,0,0,0,0,0,0,
0,0,0,0,0,0,0,0,0,
0,0,0,0,0,0,0,0,0.