[layer]
type=Tile Layer 1
data=
1,1,1,21,1,0,1,1,1,
0,0,2,21,2,0,1,0,0,
2,2,2,20,2,21,2,2,2,
20,21,2,0,0,0,2,0,2,
2,21,1,1,1,1,1,1,1,
2,0,0,21,1,0,1,0,1,
20,21,2,2,2,0,2,2,2,
2,0,0,21,0,0,1,1,1,
1,1,1,21,2,2,2,1,1,
1,1,1,0,0,19,21,0,1,
1,1,1,0,2,2,21,0,1,
0,0,0,0,0,1,1,21,1,
0,0,0,0,0,0,0,0,0,
0,0,0,0,0,0,0,0,0,
0,0,0,0,0,0,0,0,0.
[layer]
type=Tile Layer 2
data=
85,85,85,0,85,0,85,85,85,
0,0,64,0,64,0,64,0,0,
60,60,60,0,60,0,60,60,60,
0,0,62,0,0,0,62,0,62,
49,0,49,49,49,49,49,49,49,
54,0,0,0,54,0,54,0,54,
0,0,53,53,53,0,53,53,53,
52,0,0,0,0,0,52,52,52,
46,46,46,0,46,46,46,46,46,
50,50,50,0,0,0,0,0,50,
49,49,49,0,49,49,0,0,49,
0,0,0,0,0,48,48,0,48,
0,0,0,0,0,0,0,0,0,
0,0,0,0,0,0,0,0,0,
0,0,0,0,0,0,0,0,0.