[layer]
type=Tile Layer 1
data=
1,21,1,1,1,0,1,1,1,
1,0,1,1,1,21,1,0,0,
1,21,1,1,1,0,1,1,1,
1,1,21,1,1,1,1,1,0,
0,0,0,0,0,1,0,0,21,
1,1,1,1,1,1,21,1,1,
0,0,0,0,0,1,21,1,1,
1,1,1,1,21,1,1,1,1,
1,1,1,1,21,1,0,1,1,
1,1,1,1,21,1,0,1,1,
0,21,0,1,0,0,0,1,0,
0,1,1,1,1,1,1,1,21,
1,21,1,0,1,0,1,1,1,
1,0,1,0,0,0,1,21,0,
1,0,1,1,1,21,1,0,1,
1,21,0,0,1,0,1,0,0,
1,1,1,21,1,1,1,1,1,
1,0,1,0,1,0,21,0,0,
1,0,1,21,1,0,1,1,1,
0,0,1,0,21,0,1,0,0,
1,21,1,1,1,1,1,0,1,
1,1,1,1,1,21,1,0,1,
1,1,1,1,21,0,1,0,0,
1,1,1,1,0,21,1,1,0,
1,1,1,21,1,0,0,0,1,
1,1,1,0,21,1,1,0,1,
1,1,1,21,0,1,1,0,0,
1,1,1,0,1,21,0,0,0,
1,1,1,21,1,0,1,1,1,
1,1,0,21,1,0,1,1,1,
1,1,1,21,1,1,1,1,1,
1,1,21,0,1,1,1,1,1,
1,1,21,0,0,0,0,0,0,
1,1,1,1,1,1,1,21,0,
1,0,0,0,21,0,0,0,1,
0,21,1,1,1,1,1,1,1,
0,0,0,0,0,0,0,0,0,
0,0,0,0,0,0,0,0,0,
0,0,0,0,0,0,0,0,0.
[layer]
type=Tile Layer 2
data=
192,0,192,192,192,0,192,192,192,
191,0,191,191,191,0,191,0,0,
189,0,189,189,189,0,189,189,189,
153,153,0,153,153,153,153,153,0,
0,0,0,0,0,141,0,0,0,
122,122,122,122,122,122,0,122,122,
0,0,0,0,0,161,0,161,161,
141,141,141,141,0,141,141,141,141,
136,136,136,136,0,136,0,136,136,
124,124,124,124,0,124,0,124,124,
0,0,0,155,0,0,0,155,0,
0,143,143,143,143,143,143,143,0,
131,0,131,0,131,0,131,131,131,
120,0,120,0,0,0,120,0,0,
149,0,149,149,149,0,149,0,149,
138,0,0,0,138,0,138,0,0,
121,121,121,0,121,121,121,121,121,
115,0,115,0,115,0,0,0,0,
144,0,144,0,144,0,144,144,144,
0,0,133,0,0,0,133,0,0,
122,0,122,122,122,122,122,0,122,
111,111,111,111,111,0,111,0,111,
138,138,138,138,0,0,138,0,0,
127,127,127,127,0,0,127,127,0,
117,117,117,0,117,0,0,0,117,
107,107,107,0,0,107,107,0,107,
106,106,106,0,0,106,106,0,0,
96,96,96,0,96,0,0,0,0,
95,95,95,0,95,0,95,95,95,
94,94,0,0,94,0,94,94,94,
80,80,80,0,80,80,80,80,80,
83,83,0,0,83,83,83,83,83,
82,82,0,0,0,0,0,0,0,
81,81,81,81,81,81,81,0,0,
80,0,0,0,0,0,0,0,80,
0,0,79,79,79,79,79,79,79,
0,0,0,0,0,0,0,0,0,
0,0,0,0,0,0,0,0,0,
0,0,0,0,0,0,0,0,0.