[layer]
type=Tile Layer 1
data=
21,0,0,0,0,0,0,0,0,
1,21,0,0,0,0,0,0,1,
1,1,21,0,0,0,0,1,1,
1,1,1,21,0,0,1,1,1,
1,1,1,21,0,0,1,1,1,
0,0,0,0,0,0,0,0,0,
0,0,0,0,0,0,0,0,0,
0,0,0,0,0,0,0,0,0,
0,0,0,0,0,0,0,0,0.
[layer]
type=Tile Layer 2
data=
0,0,0,0,0,0,0,0,0,
1,0,0,0,0,0,0,0,1,
5,5,0,0,0,0,0,5,5,
10,10,15,0,0,0,15,10,10,
15,20,30,0,0,0,30,20,15,
0,0,0,0,0,0,0,0,0,
0,0,0,0,0,0,0,0,0,
0,0,0,0,0,0,0,0,0,
0,0,0,0,0,0,0,0,0.