[layer]
type=Tile Layer 1
data=
1,1,1,21,1,1,0,1,1,
1,1,1,21,1,0,1,1,1,
1,1,1,21,0,1,1,1,1,
1,1,1,1,1,0,0,21,0,
1,1,1,1,1,21,1,1,0,
1,1,1,1,1,1,21,0,0,
1,0,21,1,1,1,1,1,0,
1,0,0,0,0,21,0,0,0,
1,1,21,1,1,1,0,1,1,
1,1,21,1,1,1,0,0,0,
1,1,0,0,0,0,0,21,0,
1,1,21,1,1,0,1,1,1,
1,1,1,1,1,1,0,21,0,
1,1,1,1,1,1,1,21,0,
1,1,1,0,21,0,0,0,1,
1,1,1,21,1,1,1,1,1,
0,0,0,21,1,1,1,1,1,
21,1,1,1,1,1,1,1,1,
0,0,21,1,1,1,1,1,1,
1,1,0,21,0,0,0,1,1,
1,1,1,1,1,1,21,1,1,
0,21,0,1,1,1,1,1,1,
0,21,0,1,1,1,1,1,1,
0,21,0,0,1,1,1,1,1,
0,0,21,0,1,1,1,1,1,
0,1,21,1,1,1,1,1,1,
0,0,0,0,21,1,1,1,1,
0,21,1,1,0,1,1,1,1,
0,0,0,1,21,0,1,1,1,
1,1,0,1,1,21,0,0,1,
1,1,1,1,21,1,1,0,1,
1,1,1,1,21,1,1,0,1,
1,1,1,1,21,1,1,0,1,
1,21,0,0,0,1,1,0,1,
1,0,1,1,1,1,21,0,1,
0,21,1,1,1,1,1,1,0,
0,1,1,0,0,0,21,0,0,
0,21,0,0,1,1,1,1,1,
0,0,21,1,1,1,1,1,1,
1,0,1,0,1,21,0,0,1,
1,21,1,0,1,1,1,1,1,
1,0,1,0,1,0,21,0,0,
1,1,1,21,1,1,1,1,1,
1,1,1,21,1,1,1,1,1,
1,1,1,21,1,1,1,1,1,
1,1,1,21,1,1,1,1,1,
1,1,1,21,1,1,1,1,1,
0,0,1,0,0,21,0,0,0,
1,1,1,1,21,1,1,1,1,
0,0,0,1,21,1,1,1,1,
1,1,1,1,21,1,1,1,1,
1,1,0,1,0,1,21,0,0,
1,1,21,1,0,1,1,1,1,
0,0,0,1,1,1,21,0,1,
0,0,0,0,0,0,0,0,0,
0,0,0,0,0,0,0,0,0,
0,0,0,0,0,0,0,0,0.
[layer]
type=Tile Layer 2
data=
239,239,239,0,239,239,0,239,239,
237,237,237,0,237,0,237,237,237,
236,236,236,0,0,236,236,236,236,
164,164,164,164,164,0,0,0,0,
205,205,205,205,205,0,205,205,0,
189,189,189,189,189,189,0,0,0,
174,0,0,174,174,174,174,174,0,
159,0,0,0,0,0,0,0,0,
199,199,0,199,199,199,0,199,199,
184,184,0,184,184,184,0,0,0,
169,169,0,0,0,0,0,0,0,
155,155,0,155,155,0,155,155,155,
193,193,193,193,193,193,0,0,0,
179,179,179,179,179,179,179,0,0,
165,165,165,0,0,0,0,0,165,
143,143,143,0,143,143,143,143,143,
0,0,0,0,188,188,188,188,188,
0,165,165,165,165,165,165,165,165,
0,0,0,160,160,160,160,160,160,
146,146,0,0,0,0,0,146,146,
173,173,173,173,173,173,0,173,173,
0,0,0,168,168,168,168,168,168,
0,0,0,155,155,155,155,155,155,
0,0,0,0,142,142,142,142,142,
0,0,0,0,177,177,177,177,177,
0,163,0,163,163,163,163,163,163,
0,0,0,0,0,150,150,150,150,
0,0,137,137,0,137,137,137,137,
0,0,0,171,0,0,171,171,171,
158,158,0,158,158,0,0,0,158,
145,145,145,145,0,145,145,0,145,
133,133,133,133,0,133,133,0,133,
165,165,165,165,0,165,165,0,165,
153,0,0,0,0,153,153,0,153,
141,0,141,141,141,141,0,0,141,
0,0,128,128,128,128,128,128,0,
0,160,160,0,0,0,0,0,0,
0,0,0,0,148,148,148,148,148,
0,0,0,136,136,136,136,136,136,
124,0,124,0,124,0,0,0,124,
154,0,154,0,154,154,154,154,154,
142,0,142,0,142,0,0,0,0,
125,125,125,0,125,125,125,125,125,
114,114,114,0,114,114,114,114,114,
113,113,113,0,113,113,113,113,113,
103,103,103,0,103,103,103,103,103,
102,102,102,0,102,102,102,102,102,
0,0,106,0,0,0,0,0,0,
91,91,91,91,0,91,91,91,91,
0,0,0,94,0,94,94,94,94,
89,89,89,89,0,89,89,89,89,
92,92,0,92,0,92,0,0,0,
91,91,0,91,0,91,91,91,91,
0,0,0,90,90,90,0,0,90,
0,0,0,0,0,0,0,0,0,
0,0,0,0,0,0,0,0,0,
0,0,0,0,0,0,0,0,0.