[layer]
type=Tile Layer 1
data=
0,1,1,21,3,6,1,1,1,
0,0,1,0,0,0,21,0,0,
5,1,1,3,1,1,1,1,21,
0,1,0,6,0,0,0,21,0,
0,1,1,1,21,1,1,1,1,
0,0,21,5,0,1,1,4,0,
0,1,1,5,21,1,5,1,0,
0,1,1,1,0,1,4,1,21,
0,1,1,3,0,1,1,1,21,
0,1,1,1,0,21,0,3,0,
5,1,1,1,21,1,1,1,0,
0,0,0,4,0,0,0,0,21,
1,0,0,21,1,0,4,0,1,
1,3,1,21,1,1,1,0,1,
0,21,6,0,0,0,0,0,1,
1,21,1,1,1,1,5,6,1,
1,21,0,0,0,0,1,0,0,
4,1,6,1,1,21,1,0,1,
0,0,1,0,1,21,1,0,1,
1,0,1,21,5,0,1,0,1,
4,0,1,21,1,0,3,0,0,
1,21,0,0,1,4,1,0,1,
1,1,6,21,3,1,3,0,1,
1,0,0,21,0,0,1,0,0,
1,6,1,1,1,21,1,1,1,
0,0,21,0,5,0,4,0,0,
1,1,5,21,1,0,1,0,1,
0,0,0,0,0,0,0,0,0,
0,0,0,0,0,0,0,0,0,
0,0,0,0,0,0,0,0,0.
[layer]
type=Tile Layer 2
data=
0,160,160,0,160,160,160,160,160,
0,0,158,0,0,0,0,0,0,
149,149,149,149,149,149,149,149,0,
0,117,0,117,0,0,0,0,0,
0,107,107,107,0,107,107,107,107,
0,0,0,133,0,133,133,133,0,
0,123,123,123,0,123,123,123,0,
0,113,113,113,0,113,113,113,0,
0,102,102,102,0,102,102,102,0,
0,128,128,128,0,0,0,128,0,
118,118,118,118,0,118,118,118,0,
0,0,0,108,0,0,0,0,0,
98,0,0,0,98,0,98,0,98,
122,122,122,0,122,122,122,0,122,
0,0,112,0,0,0,0,0,112,
98,0,98,98,98,98,98,98,98,
94,0,0,0,0,0,94,0,0,
93,93,93,93,93,0,93,0,93,
0,0,84,0,84,0,84,0,84,
83,0,83,0,83,0,83,0,83,
82,0,82,0,82,0,82,0,0,
73,0,0,0,73,73,73,0,73,
72,72,72,0,72,72,72,0,72,
71,0,0,0,0,0,71,0,0,
67,67,67,67,67,0,67,67,67,
0,0,0,0,69,0,69,0,0,
68,68,68,0,68,0,68,0,68,
0,0,0,0,0,0,0,0,0,
0,0,0,0,0,0,0,0,0,
0,0,0,0,0,0,0,0,0.