[layer]
type=Tile Layer 1
data=
1,0,0,0,0,1,0,21,0,
1,21,0,1,1,1,1,1,0,
1,1,21,1,1,1,1,1,0,
0,21,0,1,1,1,1,1,1,
1,1,1,21,1,1,1,1,1,
0,1,1,0,0,0,0,21,1,
0,0,21,1,1,1,1,1,1,
1,1,0,0,0,1,1,21,0,
1,1,1,1,1,1,1,1,21,
1,1,0,0,21,1,1,1,0,
1,1,21,1,1,1,0,0,1,
1,1,0,21,0,0,1,1,1,
1,0,0,0,1,0,21,0,0,
1,0,1,21,1,1,1,0,1,
1,0,1,0,21,0,1,0,0,
1,1,1,21,1,0,1,1,1,
0,0,1,21,1,0,1,0,1,
1,0,1,1,1,21,1,0,1,
1,0,21,0,1,0,1,0,0,
1,1,1,21,1,0,1,0,1,
0,0,1,0,0,21,1,0,0,
1,1,21,1,0,1,1,1,0,
1,1,1,1,1,1,1,1,21,
1,0,0,1,1,0,21,0,0,
1,1,1,1,1,1,21,1,1,
0,0,0,1,1,1,21,1,1,
1,1,1,1,1,1,21,1,1,
0,0,0,21,0,1,0,1,1,
1,1,1,1,1,1,21,1,1,
0,0,21,1,1,1,0,1,0,
0,1,1,1,1,1,1,1,21,
0,0,0,21,0,1,0,1,0,
1,1,1,1,1,1,21,1,0,
1,1,21,0,0,0,0,0,0,
1,1,21,1,1,1,1,1,1,
1,1,21,1,1,1,1,1,0,
0,0,0,0,0,0,0,0,0,
0,0,0,0,0,0,0,0,0,
0,0,0,0,0,0,0,0,0.
[layer]
type=Tile Layer 2
data=
192,0,0,0,0,192,0,0,0,
191,0,0,191,191,191,191,191,0,
189,189,0,189,189,189,189,189,0,
0,0,0,153,153,153,153,153,153,
134,134,134,0,134,134,134,134,134,
0,129,129,0,0,0,0,0,129,
0,0,0,161,161,161,161,161,161,
148,148,0,0,0,148,148,0,0,
130,130,130,130,130,130,130,130,0,
124,124,0,0,0,124,124,124,0,
155,155,0,155,155,155,0,0,155,
143,143,0,0,0,0,143,143,143,
131,0,0,0,131,0,0,0,0,
120,0,120,0,120,120,120,0,120,
149,0,149,0,0,0,149,0,0,
138,138,138,0,138,0,138,138,138,
0,0,127,0,127,0,127,0,127,
115,0,115,115,115,0,115,0,115,
144,0,0,0,144,0,144,0,0,
133,133,133,0,133,0,133,0,133,
0,0,122,0,0,0,122,0,0,
111,111,0,111,0,111,111,111,0,
132,132,132,132,132,132,132,132,0,
127,0,0,127,127,0,0,0,0,
111,111,111,111,111,111,0,111,111,
0,0,0,107,107,107,0,107,107,
101,101,101,101,101,101,0,101,101,
0,0,0,0,0,96,0,96,96,
90,90,90,90,90,90,0,90,90,
0,0,0,94,94,94,0,94,0,
0,84,84,84,84,84,84,84,0,
0,0,0,0,0,83,0,83,0,
82,82,82,82,82,82,0,82,0,
81,81,0,0,0,0,0,0,0,
77,77,0,77,77,77,77,77,77,
79,79,0,79,79,79,79,79,0,
0,0,0,0,0,0,0,0,0,
0,0,0,0,0,0,0,0,0,
0,0,0,0,0,0,0,0,0.