[layer]
type=Tile Layer 1
data=
1,1,1,21,5,6,6,4,1,
0,21,1,0,4,1,1,5,1,
1,21,1,1,1,1,1,1,1,
0,0,0,0,0,21,1,0,0,
1,1,4,1,1,21,6,0,5,
5,1,1,1,1,0,1,21,0,
1,1,6,21,1,4,1,1,1,
0,0,6,0,0,21,1,0,1,
3,1,1,21,1,1,1,0,1,
5,1,1,0,5,1,1,21,0,
1,1,1,21,1,1,1,0,1,
3,1,4,0,0,0,21,0,1,
1,1,1,21,1,1,1,1,5,
0,21,0,0,4,0,0,0,0,
3,1,1,0,1,21,1,0,3,
1,21,0,0,1,0,0,0,6,
3,1,1,21,1,0,1,1,1,
0,0,0,21,5,0,0,0,1,
1,1,1,1,1,4,1,21,1,
1,0,21,0,0,0,1,0,0,
1,21,3,1,1,0,4,5,1,
4,0,1,0,1,0,1,21,0,
1,0,1,21,1,0,6,5,1,
0,21,1,0,1,0,0,0,1,
0,0,6,21,0,0,0,0,1,
0,0,4,1,1,0,0,21,1,
1,21,1,1,1,0,1,3,1,
1,21,1,1,3,0,1,1,6,
1,0,21,0,0,0,1,1,4,
4,1,1,1,21,1,0,1,1,
5,1,6,1,21,6,0,1,1,
1,1,1,1,21,0,0,0,1,
1,1,1,1,1,4,21,0,0,
1,21,1,1,5,1,3,1,0,
0,0,1,1,1,1,1,6,21,
0,0,1,1,1,5,6,1,21,
1,21,0,1,4,1,1,0,1,
0,0,0,1,5,21,0,0,1,
0,1,1,1,4,21,6,1,0,
0,0,0,0,0,0,0,0,0,
0,0,0,0,0,0,0,0,0,
0,0,0,0,0,0,0,0,0.
[layer]
type=Tile Layer 2
data=
187,187,187,0,187,187,187,187,187,
0,0,195,0,195,195,195,195,195,
184,0,184,184,184,184,184,184,184,
0,0,0,0,0,0,146,0,0,
133,133,133,133,133,0,133,0,133,
166,166,166,166,166,0,166,0,0,
146,146,146,0,146,146,146,146,146,
0,0,141,0,0,0,141,0,141,
129,129,129,0,129,129,129,0,129,
161,161,161,0,161,161,161,0,0,
148,148,148,0,148,148,148,0,148,
136,136,136,0,0,0,0,0,136,
118,118,118,0,118,118,118,118,118,
0,0,0,0,155,0,0,0,0,
143,143,143,0,143,0,143,0,143,
131,0,0,0,131,0,0,0,131,
120,120,120,0,120,0,120,120,120,
0,0,0,0,149,0,0,0,149,
131,131,131,131,131,131,131,0,131,
127,0,0,0,0,0,127,0,0,
115,0,115,115,115,0,115,115,115,
144,0,144,0,144,0,144,0,0,
133,0,133,0,133,0,133,133,133,
0,0,122,0,122,0,0,0,122,
0,0,111,0,0,0,0,0,111,
0,0,138,138,138,0,0,0,138,
127,0,127,127,127,0,127,127,127,
117,0,117,117,117,0,117,117,117,
107,0,0,0,0,0,107,107,107,
106,106,106,106,0,106,0,106,106,
96,96,96,96,0,96,0,96,96,
95,95,95,95,0,0,0,0,95,
94,94,94,94,94,94,0,0,0,
84,0,84,84,84,84,84,84,0,
0,0,83,83,83,83,83,83,0,
0,0,82,82,82,82,82,82,0,
81,0,0,81,81,81,81,0,81,
0,0,0,80,80,0,0,0,80,
0,79,79,79,79,0,79,79,0,
0,0,0,0,0,0,0,0,0,
0,0,0,0,0,0,0,0,0,
0,0,0,0,0,0,0,0,0.