[layer]
type=Tile Layer 1
data=
0,0,0,0,21,0,0,1,0,
0,1,1,3,1,1,0,6,21,
0,0,0,2,2,21,0,2,0,
0,1,21,2,10,2,2,8,0,
0,1,0,2,2,0,21,2,0,
4,5,0,1,21,1,0,1,1,
0,0,0,5,0,1,21,0,0,
0,2,2,1,21,1,1,3,1,
0,20,0,0,21,2,0,0,0,
0,0,19,2,1,2,19,21,0,
20,21,2,7,2,2,2,2,0,
2,2,0,1,1,4,21,0,1,
10,2,21,0,5,0,0,0,1,
2,0,0,0,2,2,21,0,2,
0,0,1,2,10,2,1,21,19,
0,0,0,0,0,0,0,0,0,
0,0,0,0,0,0,0,0,0,
0,0,0,0,0,0,0,0,0.
[layer]
type=Tile Layer 2
data=
0,0,0,0,0,0,0,123,0,
0,121,121,121,121,121,0,121,0,
0,0,0,119,119,0,0,119,0,
0,89,0,89,89,89,89,89,0,
0,81,0,81,81,0,0,81,0,
80,80,0,80,0,80,0,80,80,
0,0,0,72,0,72,0,0,0,
0,67,67,67,0,67,67,67,67,
0,0,0,0,0,70,0,0,0,
0,0,0,62,62,62,0,0,0,
0,0,61,61,61,61,61,61,0,
60,60,0,60,60,60,0,0,60,
59,59,0,0,59,0,0,0,59,
58,0,0,0,58,58,0,0,58,
0,0,57,57,57,57,57,0,0,
0,0,0,0,0,0,0,0,0,
0,0,0,0,0,0,0,0,0,
0,0,0,0,0,0,0,0,0.