[layer]
type=Tile Layer 1
data=
1,0,1,21,1,1,1,0,1,
0,1,1,1,21,1,1,1,1,
0,1,1,1,21,1,0,1,0,
1,1,1,1,21,1,0,1,0,
0,1,1,1,0,1,0,1,21,
0,1,1,1,0,1,0,1,21,
1,0,0,21,1,0,1,0,1,
1,1,1,0,1,0,21,1,0,
1,1,1,0,1,1,0,21,0,
1,0,0,21,0,0,1,1,1,
1,0,1,1,1,1,0,21,0,
1,0,21,0,0,0,0,0,1,
1,1,1,1,0,1,1,21,0,
1,1,1,1,0,21,0,1,0,
1,1,1,1,0,1,1,21,0,
1,0,1,21,1,1,1,0,1,
1,21,1,0,1,1,1,0,1,
1,21,1,1,1,1,1,0,1,
1,21,0,0,0,0,1,0,1,
1,1,1,1,1,21,1,1,1,
1,1,1,1,1,21,0,0,0,
1,1,1,1,1,21,1,1,1,
1,1,1,1,1,0,1,21,0,
1,1,1,1,1,21,1,0,1,
0,1,0,0,0,0,0,0,21,
1,1,21,1,0,1,1,1,1,
1,1,21,1,0,1,1,1,1,
1,1,21,1,1,1,1,1,1,
0,0,0,1,21,0,0,1,0,
1,1,21,1,1,1,1,1,1,
0,1,21,1,1,1,1,1,0,
1,1,21,1,1,1,1,1,0,
1,1,21,1,1,1,1,1,0,
0,1,21,1,0,1,1,1,1,
0,1,21,1,0,1,0,0,1,
1,1,1,1,21,1,1,0,1,
0,1,0,1,0,0,21,0,1,
0,21,1,1,1,1,0,1,1,
0,0,1,0,21,0,0,0,1,
1,1,1,1,0,1,0,21,0,
1,1,0,21,0,0,1,1,0,
1,1,0,1,1,0,0,21,0,
1,1,1,1,21,1,0,1,1,
0,1,1,1,0,1,0,21,0,
0,1,1,1,21,1,1,1,1,
0,0,1,1,1,1,1,21,0,
0,1,1,1,21,1,1,1,0,
0,0,21,1,0,1,1,1,0,
0,0,0,0,0,0,0,0,0,
0,0,0,0,0,0,0,0,0,
0,0,0,0,0,0,0,0,0.
[layer]
type=Tile Layer 2
data=
229,0,229,0,229,229,229,0,229,
0,228,228,228,0,228,228,228,228,
0,226,226,226,0,226,0,226,0,
184,184,184,184,0,184,0,184,0,
0,169,169,169,0,169,0,169,0,
0,155,155,155,0,155,0,155,0,
193,0,0,0,193,0,193,0,193,
179,179,179,0,179,0,0,179,0,
165,165,165,0,165,165,0,0,0,
150,0,0,0,0,0,150,150,150,
188,0,188,188,188,188,0,0,0,
174,0,0,0,0,0,0,0,174,
160,160,160,160,0,160,160,0,0,
146,146,146,146,0,0,0,146,0,
182,182,182,182,0,182,182,0,0,
168,0,168,0,168,168,168,0,168,
155,0,155,0,155,155,155,0,155,
142,0,142,142,142,142,142,0,142,
177,0,0,0,0,0,177,0,177,
155,155,155,155,155,0,155,155,155,
150,150,150,150,150,0,0,0,0,
131,131,131,131,131,0,131,131,131,
171,171,171,171,171,0,171,0,0,
158,158,158,158,158,0,158,0,158,
0,145,0,0,0,0,0,0,0,
133,133,0,133,0,133,133,133,133,
165,165,0,165,0,165,165,165,165,
146,146,0,146,146,146,146,146,146,
0,0,0,141,0,0,0,141,0,
122,122,0,122,122,122,122,122,122,
0,160,0,160,160,160,160,160,0,
148,148,0,148,148,148,148,148,0,
136,136,0,136,136,136,136,136,0,
0,124,0,124,0,124,124,124,124,
0,154,0,154,0,154,0,0,154,
142,142,142,142,0,142,142,0,142,
0,131,0,131,0,0,0,0,131,
0,0,120,120,120,120,0,120,120,
0,0,119,0,0,0,0,0,119,
108,108,108,108,0,108,0,0,0,
107,107,0,0,0,0,107,107,0,
106,106,0,106,106,0,0,0,0,
95,95,95,95,0,95,0,95,95,
0,94,94,94,0,94,0,0,0,
0,93,93,93,0,93,93,93,93,
0,0,92,92,92,92,92,0,0,
0,91,91,91,0,91,91,91,0,
0,0,0,90,0,90,90,90,0,
0,0,0,0,0,0,0,0,0,
0,0,0,0,0,0,0,0,0,
0,0,0,0,0,0,0,0,0.