[layer]
type=Tile Layer 1
data=
1,5,6,21,1,5,1,1,1,
0,0,0,0,1,0,0,21,0,
1,1,1,21,1,1,4,0,1,
3,1,1,21,6,1,1,0,3,
1,1,1,21,1,1,1,1,1,
0,0,1,21,1,0,4,0,0,
1,1,1,21,1,0,1,1,6,
1,0,21,0,0,0,1,1,1,
4,21,4,3,1,1,6,1,1,
1,6,1,1,21,1,3,6,1,
0,0,0,1,21,0,0,0,0,
0,1,1,1,1,4,1,1,21,
0,21,0,0,0,0,0,1,0,
1,1,1,1,1,6,21,5,1,
1,1,1,1,1,1,21,3,1,
1,1,1,1,1,4,21,3,1,
1,1,3,1,1,1,21,1,1,
21,1,1,1,5,1,1,1,5,
21,6,4,1,1,1,1,1,1,
0,0,21,0,0,1,0,0,0,
4,1,1,1,21,5,0,1,1,
0,1,0,21,0,1,0,0,0,
0,1,0,4,1,6,0,1,21,
0,0,0,1,0,0,21,1,0,
21,1,1,1,1,5,4,1,1,
0,0,0,6,0,0,1,21,0,
1,21,1,1,1,0,4,1,0,
1,1,1,1,21,0,0,0,4,
1,1,1,1,3,5,1,21,0,
5,1,0,0,0,0,21,0,0,
0,21,0,5,1,4,1,1,4,
0,21,0,0,1,6,1,1,1,
1,1,21,0,1,1,1,1,1,
4,1,21,0,1,0,1,5,1,
1,1,3,5,1,1,0,21,0,
1,1,1,1,1,1,1,1,21,
0,1,1,21,1,1,1,1,4,
1,1,1,6,21,1,1,5,1,
0,1,21,1,1,4,1,1,1,
1,3,0,0,21,0,1,1,0,
0,21,1,1,1,1,1,6,1,
0,1,1,4,0,21,1,1,6,
0,0,0,0,0,0,0,0,0,
0,0,0,0,0,0,0,0,0,
0,0,0,0,0,0,0,0,0.
[layer]
type=Tile Layer 2
data=
193,193,193,0,193,193,193,193,193,
0,0,0,0,201,0,0,0,0,
200,200,200,0,200,200,200,0,200,
138,138,138,0,138,138,138,0,138,
164,164,164,0,164,164,164,164,164,
0,0,160,0,160,0,160,0,0,
147,147,147,0,147,0,147,147,147,
134,0,0,0,0,0,134,134,134,
159,0,159,159,159,159,159,159,159,
147,147,147,147,0,147,147,147,147,
0,0,0,142,0,0,0,0,0,
0,130,130,130,130,130,130,130,0,
0,0,0,0,0,0,0,162,0,
7,149,149,149,149,149,0,149,7,
6,110,137,137,137,137,0,110,6,
100,100,100,125,125,125,0,100,6,
7,125,125,125,156,125,0,125,7,
0,110,110,110,110,110,110,110,110,
0,101,101,101,126,101,101,101,101,
0,0,0,0,0,121,0,0,0,
150,150,150,150,0,150,0,150,150,
0,139,0,0,0,139,0,0,0,
0,128,0,128,128,128,0,128,0,
0,0,0,116,0,0,0,116,0,
0,138,138,138,138,138,138,138,138,
0,0,0,134,0,0,134,0,0,
123,0,123,123,123,0,123,123,0,
112,112,112,112,0,0,0,0,112,
139,139,139,139,139,139,139,0,0,
128,128,0,0,0,0,0,0,0,
0,0,0,118,118,118,118,118,118,
0,0,0,0,108,108,108,108,108,
107,107,0,0,107,107,107,107,107,
97,97,0,0,4,0,97,97,97,
96,96,96,76,76,4,0,0,0,
90,90,72,72,72,72,72,90,0,
0,4,4,0,4,4,68,68,85,
4,67,67,67,0,67,67,67,67,
0,4,0,66,4,66,66,66,83,
82,82,0,0,0,0,82,82,0,
0,0,81,81,81,81,81,81,81,
0,80,80,80,0,0,80,80,80,
0,0,0,0,0,0,0,0,0,
0,0,0,0,0,0,0,0,0,
0,0,0,0,0,0,0,0,0.