[layer]
type=Tile Layer 1
data=
1,1,1,0,21,0,1,3,1,
1,1,1,5,1,21,1,5,4,
1,3,4,1,1,21,1,1,1,
0,0,1,21,6,0,1,5,1,
1,1,3,21,1,0,1,1,3,
1,0,21,0,0,0,0,0,1,
1,1,1,4,1,3,1,21,3,
0,0,0,21,0,0,1,0,1,
1,1,1,5,1,21,2,0,1,
1,1,1,1,1,21,19,0,0,
2,2,2,2,2,21,2,18,2,
3,6,1,1,1,21,1,0,4,
1,2,2,21,1,0,1,0,1,
6,2,19,2,1,21,1,0,4,
1,2,2,0,3,21,1,0,1,
1,1,1,21,6,4,1,0,1,
0,1,0,1,0,0,0,0,21,
1,1,1,3,21,1,4,1,1,
1,1,1,1,21,1,3,2,2,
2,2,2,2,21,2,0,2,20,
6,5,1,1,0,1,21,2,0,
1,21,4,1,1,1,1,0,1,
1,21,3,6,1,1,1,0,0,
4,21,1,1,3,1,1,0,1,
5,0,0,21,1,0,0,0,1,
1,3,4,1,1,1,1,21,1,
0,0,1,1,1,1,1,21,5,
1,21,1,6,1,1,5,1,1,
1,21,1,1,1,6,1,0,1,
3,21,1,1,1,5,1,0,3,
4,1,1,5,1,21,1,1,1,
0,0,0,21,2,18,2,2,2,
2,2,2,21,2,18,2,2,2,
0,0,0,0,5,0,0,0,21,
6,1,1,1,1,2,2,2,21,
2,2,2,21,2,0,20,0,0,
1,1,1,21,3,2,2,2,4,
0,0,0,21,1,1,5,1,1,
1,1,1,21,1,1,5,1,1,
0,0,21,1,1,1,5,1,1,
0,0,21,1,1,4,1,1,1,
21,1,3,1,1,2,2,2,4,
0,21,0,0,0,0,19,2,1,
1,1,3,1,1,2,21,2,1,
1,1,4,1,1,6,21,0,0,
5,1,1,0,0,0,21,0,24,
1,3,1,21,4,1,1,1,1,
1,1,1,21,1,5,4,1,1,
0,0,1,1,1,21,1,1,5,
0,1,6,1,1,21,1,4,6,
0,0,1,1,2,21,0,1,1,
1,21,0,0,0,24,0,3,5,
2,2,2,21,20,0,2,2,2,
1,1,1,21,0,0,1,1,1,
0,0,0,0,0,0,0,0,0,
0,0,0,0,0,0,0,0,0,
0,0,0,0,0,0,0,0,0.
[layer]
type=Tile Layer 2
data=
239,239,239,0,0,0,239,239,239,
226,226,226,226,226,0,226,226,226,
224,224,224,224,224,0,224,224,224,
0,0,164,0,164,0,164,164,164,
205,205,205,0,205,0,205,205,205,
189,0,0,0,0,0,0,0,189,
166,166,166,166,166,166,166,0,166,
0,0,0,0,0,0,159,0,159,
199,199,199,199,199,0,199,0,199,
184,184,184,184,184,0,0,0,0,
169,169,169,169,169,0,169,0,169,
155,155,155,155,155,0,155,0,155,
193,193,193,0,193,0,193,0,193,
179,179,0,179,179,0,179,0,179,
165,165,165,0,165,0,165,0,165,
150,150,150,0,150,150,150,0,150,
0,188,0,188,0,0,0,0,0,
165,165,165,165,0,165,165,165,165,
152,152,152,152,0,152,152,152,152,
146,146,146,146,0,146,0,146,0,
182,182,182,182,0,182,0,182,0,
168,0,168,168,168,168,168,0,168,
155,0,155,155,155,155,155,0,0,
142,0,142,142,142,142,142,0,142,
177,0,0,0,177,0,0,0,177,
155,155,155,155,155,155,155,0,155,
0,0,150,150,150,150,150,0,150,
131,0,131,131,131,131,131,131,131,
171,0,171,171,171,171,171,0,171,
158,0,158,158,158,158,158,0,158,
138,138,138,138,138,0,138,138,138,
0,0,0,0,133,0,133,133,133,
165,165,165,0,165,0,165,165,165,
0,0,0,0,153,0,0,0,0,
134,134,134,134,134,134,134,134,0,
128,128,128,0,128,0,0,0,0,
152,152,152,0,152,152,152,152,152,
0,0,0,0,148,148,148,148,148,
129,129,129,0,129,129,129,129,129,
0,0,0,124,124,124,124,124,124,
0,0,0,154,154,154,154,154,154,
0,136,136,136,136,136,136,136,136,
0,0,0,0,0,0,0,131,131,
114,114,114,114,114,114,0,114,114,
119,119,119,119,119,119,0,0,0,
108,108,108,0,0,0,0,0,0,
102,102,102,0,102,102,102,102,102,
101,101,101,0,101,101,101,101,101,
0,0,95,95,95,0,95,95,95,
0,94,94,94,94,0,94,94,94,
0,0,93,93,93,0,0,93,93,
92,0,0,0,0,0,0,92,92,
91,91,91,0,0,0,91,91,91,
90,90,90,0,0,0,90,90,90,
0,0,0,0,0,0,0,0,0,
0,0,0,0,0,0,0,0,0,
0,0,0,0,0,0,0,0,0.