[layer]
type=Tile Layer 1
data=
2,2,2,2,2,21,2,2,20,
2,2,2,2,0,0,0,21,20,
1,1,21,0,0,0,0,2,2,
0,4,21,0,0,1,3,1,1,
0,0,2,2,0,0,0,21,0,
1,0,0,19,0,0,0,21,0,
0,0,0,2,2,1,0,1,21,
2,2,21,2,2,2,18,2,2,
0,3,21,0,0,0,0,1,0,
0,4,1,1,1,1,21,1,1,
0,1,0,21,0,3,0,4,1,
0,2,21,2,1,1,0,5,1,
0,2,20,2,2,2,21,0,0,
0,2,0,2,1,2,21,2,5,
0,1,21,0,0,0,24,2,1,
1,1,1,4,1,1,21,0,1,
1,0,0,21,1,1,0,0,1,
6,4,5,0,21,1,1,0,0,
1,1,1,2,0,21,0,0,0,
4,0,0,2,24,21,0,0,1,
3,1,21,1,0,1,1,1,5,
0,0,0,0,0,0,0,0,0,
0,0,0,0,0,0,0,0,0,
0,0,0,0,0,0,0,0,0.
[layer]
type=Tile Layer 2
data=
127,127,127,127,127,0,127,127,0,
132,132,132,132,0,0,0,0,0,
130,130,0,0,0,0,0,130,130,
0,113,0,0,0,113,113,113,113,
0,0,104,104,0,0,0,0,0,
95,0,0,0,0,0,0,0,0,
0,0,0,86,86,86,0,86,0,
102,102,0,102,102,102,0,102,102,
0,98,0,0,0,0,0,98,0,
0,86,86,86,86,86,0,86,86,
0,82,0,0,0,82,0,82,82,
0,81,0,81,81,81,0,81,81,
0,73,0,73,73,73,0,0,0,
0,72,0,72,72,72,0,72,72,
0,71,0,0,0,0,0,71,71,
60,60,60,60,60,60,0,0,60,
62,0,0,0,62,62,0,0,62,
61,61,61,0,0,61,61,0,0,
60,60,60,60,0,0,0,0,0,
59,0,0,59,0,0,0,0,59,
56,56,0,56,0,56,56,56,56,
0,0,0,0,0,0,0,0,0,
0,0,0,0,0,0,0,0,0,
0,0,0,0,0,0,0,0,0.