[layer]
type=Tile Layer 1
data=
2,2,21,2,2,18,2,2,2,
2,2,21,20,2,0,2,2,2,
1,1,2,21,2,0,1,1,1,
0,0,0,21,0,0,0,1,1,
0,21,1,1,1,1,0,2,1,
1,21,0,0,0,0,0,19,0,
1,1,1,1,1,21,2,2,0,
1,1,0,21,1,1,1,1,0,
1,1,1,21,0,0,0,0,0,
0,0,0,1,0,0,0,1,21,
1,1,0,1,21,1,0,2,1,
0,21,0,1,0,1,0,19,0,
0,1,1,1,0,1,2,2,21,
0,0,0,1,0,2,0,21,0,
1,1,21,1,1,2,24,2,1,
0,0,0,0,0,0,0,0,0,
0,0,0,0,0,0,0,0,0,
0,0,0,0,0,0,0,0,0.
[layer]
type=Tile Layer 2
data=
117,117,0,117,117,0,117,117,117,
121,121,0,0,121,0,121,121,121,
113,113,113,0,113,0,113,113,113,
0,0,0,0,0,0,0,89,89,
0,0,81,81,81,81,0,81,81,
80,0,0,0,0,0,0,0,0,
68,68,68,68,68,0,68,68,0,
71,71,0,0,71,71,71,71,0,
70,70,70,0,0,0,0,0,0,
0,0,0,62,0,0,0,62,0,
61,61,0,61,0,61,0,61,61,
0,0,0,60,0,60,0,0,0,
0,59,59,59,0,59,59,59,0,
0,0,0,58,0,58,0,0,0,
55,55,0,55,55,55,0,55,55,
0,0,0,0,0,0,0,0,0,
0,0,0,0,0,0,0,0,0,
0,0,0,0,0,0,0,0,0.