[layer]
type=Tile Layer 1
data=
1,6,21,1,1,1,1,1,1,
0,0,0,21,0,1,0,0,0,
1,6,1,1,21,3,0,5,1,
1,4,0,0,21,1,0,0,0,
1,1,21,1,1,1,0,6,1,
0,0,0,5,0,21,0,1,1,
1,1,21,6,1,1,0,6,1,
5,4,21,1,4,1,0,1,1,
1,1,1,5,1,1,21,1,1,
0,1,1,1,21,1,5,1,1,
0,0,4,0,0,0,0,21,1,
21,1,1,1,1,1,1,5,6,
1,1,4,1,3,1,1,21,1,
0,0,21,0,0,0,0,0,1,
6,1,6,1,1,21,1,1,1,
1,1,3,6,1,0,1,21,0,
1,1,1,1,1,21,3,1,1,
0,21,0,5,0,0,0,0,0,
1,21,1,0,1,1,6,0,3,
0,0,1,0,1,0,21,0,1,
1,5,5,21,1,0,1,0,1,
1,21,0,0,5,0,1,0,1,
3,21,1,1,1,5,1,0,1,
0,21,1,0,0,0,6,0,1,
1,1,6,21,1,0,1,0,1,
1,0,0,0,1,0,21,0,1,
1,21,3,4,1,1,1,6,1,
1,6,5,1,21,1,0,1,1,
1,1,1,1,21,3,0,0,0,
1,1,3,1,0,1,1,21,0,
3,4,1,0,21,0,0,1,1,
6,1,1,21,1,1,0,1,1,
1,1,6,0,21,1,0,1,1,
1,21,0,0,0,1,0,0,0,
1,21,0,1,1,4,1,5,0,
1,1,21,1,3,1,1,5,0,
0,1,1,1,1,21,1,1,1,
6,5,1,0,0,21,0,0,0,
1,1,3,21,1,6,1,1,0,
1,4,1,1,0,0,21,0,0,
1,4,21,0,1,1,0,0,1,
0,0,21,3,1,5,1,1,1,
0,0,0,0,0,0,0,0,0,
0,0,0,0,0,0,0,0,0,
0,0,0,0,0,0,0,0,0.
[layer]
type=Tile Layer 2
data=
193,193,0,193,193,193,193,193,193,
0,0,0,0,0,201,0,0,0,
200,200,200,200,0,200,0,200,200,
138,138,0,0,0,138,0,0,0,
173,173,0,173,173,173,0,173,173,
0,0,0,160,0,0,0,160,160,
147,147,0,147,147,147,0,147,147,
134,134,0,134,134,134,0,134,134,
159,159,159,159,159,159,0,159,159,
0,154,154,154,0,154,154,154,154,
0,0,142,0,0,0,0,0,142,
0,123,123,123,123,123,123,123,123,
154,154,154,154,154,154,154,0,154,
0,0,0,0,0,0,0,0,149,
131,131,131,131,131,0,131,131,131,
125,125,125,125,125,0,125,0,0,
148,148,148,148,148,0,148,148,148,
0,0,0,144,0,0,0,0,0,
132,0,132,0,132,132,132,0,132,
0,0,121,0,121,0,0,0,121,
150,150,150,0,150,0,150,0,150,
139,0,0,0,139,0,139,0,139,
128,0,128,128,128,128,128,0,128,
0,0,116,0,0,0,116,0,116,
145,145,145,0,145,0,145,0,145,
134,0,0,0,134,0,0,0,134,
117,0,117,117,117,117,117,117,117,
112,112,112,112,0,112,0,112,112,
139,139,139,139,0,139,0,0,0,
128,128,128,128,0,128,128,0,0,
118,118,118,0,0,0,0,118,118,
108,108,108,0,108,108,0,108,108,
107,107,107,0,0,107,0,107,107,
97,0,0,0,0,97,0,0,0,
96,0,0,96,96,96,96,96,0,
95,95,0,95,95,95,95,95,0,
0,85,85,85,85,0,85,85,85,
84,84,84,0,0,0,0,0,0,
83,83,83,0,83,83,83,83,0,
82,82,82,82,0,0,0,0,0,
81,81,0,0,81,81,0,0,81,
0,0,0,80,80,80,80,80,80,
0,0,0,0,0,0,0,0,0,
0,0,0,0,0,0,0,0,0,
0,0,0,0,0,0,0,0,0.