[layer]
type=Tile Layer 1
data=
1,3,4,1,0,1,1,4,21,
1,1,0,6,0,1,0,0,21,
1,5,0,4,1,1,21,1,1,
1,1,0,1,0,21,0,3,0,
0,1,21,6,0,1,1,1,0,
0,5,21,1,1,1,0,1,0,
1,21,0,0,1,1,6,1,1,
1,1,21,1,0,0,1,1,1,
0,0,1,1,1,3,21,4,1,
1,21,1,0,0,1,0,0,4,
1,1,21,1,0,1,0,1,6,
5,21,0,1,4,1,0,1,1,
0,0,0,0,0,0,0,0,0,
0,0,0,0,0,0,0,0,0,
0,0,0,0,0,0,0,0,0.
[layer]
type=Tile Layer 2
data=
84,84,84,84,0,84,84,84,0,
63,63,0,63,0,63,0,0,0,
59,59,0,59,59,59,0,59,59,
61,61,0,61,0,0,0,61,0,
0,54,0,54,0,54,54,54,0,
0,53,0,53,53,53,0,53,0,
52,0,0,0,52,52,52,52,52,
51,51,0,51,0,0,51,51,51,
0,0,50,50,50,50,0,50,50,
49,0,49,0,0,49,0,0,49,
48,48,0,48,0,48,0,48,48,
47,0,0,47,47,47,0,47,47,
0,0,0,0,0,0,0,0,0,
0,0,0,0,0,0,0,0,0,
0,0,0,0,0,0,0,0,0.