[layer]
type=Tile Layer 1
data=
24,2,6,1,1,1,21,1,1,
0,2,1,1,3,1,21,0,0,
20,2,2,2,2,2,21,2,2,
0,0,0,21,0,1,0,0,0,
1,5,21,1,0,1,1,4,0,
2,2,0,1,21,6,1,1,0,
19,0,0,0,0,21,6,1,1,
2,21,1,1,1,0,1,3,1,
4,21,1,0,0,0,2,1,1,
1,21,4,1,2,24,2,1,6,
1,21,1,1,1,0,0,0,1,
1,21,2,2,2,6,1,1,5,
0,0,21,19,0,0,1,0,0,
1,1,2,2,2,21,2,0,3,
2,2,2,2,2,21,2,20,2,
6,21,0,0,0,0,2,0,3,
1,21,1,1,1,1,1,1,5,
0,21,1,0,0,0,0,0,1,
1,1,6,0,4,21,1,0,1,
1,0,1,0,3,21,4,0,1,
1,0,1,21,1,0,1,0,1,
1,0,21,0,1,0,4,0,0,
1,1,5,3,1,21,1,1,1,
0,0,1,0,0,21,1,0,0,
0,0,21,0,1,5,1,3,1,
0,1,1,21,1,1,6,1,5,
0,1,0,0,21,1,1,1,1,
0,21,1,1,0,0,2,2,1,
6,21,1,1,1,0,24,2,1,
5,21,3,1,1,2,24,2,1,
2,2,2,18,0,21,0,2,2,
0,21,19,0,0,0,1,1,1,
0,21,0,0,4,1,1,3,1,
1,1,3,1,21,0,0,2,3,
1,1,1,1,21,5,0,19,1,
1,1,1,0,21,1,2,0,6,
1,1,1,0,0,1,21,0,1,
3,1,21,1,0,1,0,3,1,
1,1,21,1,1,6,0,1,4,
0,0,0,0,0,0,0,0,0,
0,0,0,0,0,0,0,0,0,
0,0,0,0,0,0,0,0,0.
[layer]
type=Tile Layer 2
data=
0,197,197,197,197,197,0,197,197,
0,195,195,195,195,195,0,0,0,
0,194,194,194,194,194,0,194,194,
0,0,0,0,0,146,0,0,0,
133,133,0,133,0,133,133,133,0,
166,166,0,166,0,166,166,166,0,
0,0,0,0,0,0,153,153,153,
141,0,141,141,141,0,141,141,141,
129,0,129,0,0,0,129,129,129,
161,0,161,161,161,0,161,161,161,
148,0,148,148,148,0,0,0,148,
130,0,130,130,130,130,130,130,130,
0,0,0,0,0,0,124,0,0,
155,155,155,155,155,0,155,0,155,
143,143,143,143,143,0,143,0,143,
131,0,0,0,0,0,131,0,131,
114,0,114,114,114,114,114,114,114,
0,0,149,0,0,0,0,0,149,
138,138,138,0,138,0,138,0,138,
127,0,127,0,127,0,127,0,127,
115,0,115,0,115,0,115,0,115,
144,0,0,0,144,0,144,0,0,
126,126,126,126,126,0,126,126,126,
0,0,122,0,0,0,122,0,0,
0,0,0,0,111,111,111,111,111,
0,138,138,0,138,138,138,138,138,
0,127,0,0,0,127,127,127,127,
0,0,117,117,0,0,117,117,117,
107,0,107,107,107,0,0,107,107,
106,0,106,106,106,106,0,106,106,
96,96,96,0,0,0,0,96,96,
0,0,0,0,0,0,95,95,95,
0,0,0,0,94,94,94,94,94,
84,84,84,84,0,0,0,84,84,
83,83,83,83,0,83,0,0,83,
82,82,82,0,0,82,82,0,82,
81,81,81,0,0,81,0,0,81,
80,80,0,80,0,80,0,80,80,
79,79,0,79,79,79,0,79,79,
0,0,0,0,0,0,0,0,0,
0,0,0,0,0,0,0,0,0,
0,0,0,0,0,0,0,0,0.