[layer]
type=Tile Layer 1
data=
1,1,1,0,21,0,1,1,0,
1,1,1,0,21,1,1,0,0,
1,1,1,1,21,1,1,0,1,
1,1,1,1,21,1,0,0,1,
1,1,1,1,21,1,0,1,1,
2,2,2,2,2,2,21,18,2,
1,1,0,0,21,0,1,0,1,
1,1,21,1,1,1,1,0,1,
1,1,0,0,0,0,0,21,0,
0,1,1,1,0,1,0,1,21,
0,1,1,1,21,1,0,1,0,
0,1,21,1,0,1,0,1,0,
1,2,2,2,21,1,0,1,0,
0,0,20,21,0,2,0,2,0,
1,2,2,2,1,1,1,1,21,
1,1,1,21,1,1,1,1,1,
0,0,1,0,1,21,1,1,1,
1,21,2,2,1,0,1,1,1,
1,21,19,2,1,1,1,1,1,
1,0,2,0,0,0,21,0,0,
1,21,1,1,1,1,1,1,1,
1,0,0,0,2,21,0,0,1,
2,0,2,21,2,20,2,2,2,
1,0,1,21,2,0,2,0,0,
1,1,2,0,2,21,1,0,1,
2,21,0,20,2,0,2,0,2,
1,0,2,2,2,21,1,0,1,
0,1,1,1,1,1,21,1,0,
1,1,1,1,1,1,21,1,0,
0,0,21,1,0,0,0,1,0,
2,2,21,2,18,2,2,2,2,
1,1,0,1,0,21,0,19,0,
2,2,2,2,21,2,2,2,18,
0,0,0,0,0,0,0,0,0,
0,0,0,0,0,0,0,0,0,
0,0,0,0,0,0,0,0,0.
[layer]
type=Tile Layer 2
data=
170,170,170,0,0,0,170,170,0,
169,169,169,0,0,169,169,0,0,
167,167,167,167,0,167,167,0,167,
146,146,146,146,0,146,0,0,146,
134,134,134,134,0,134,0,134,134,
123,123,123,123,123,123,0,0,123,
112,112,0,0,0,0,112,0,112,
140,140,0,140,140,140,140,0,140,
129,129,0,0,0,0,0,0,0,
0,118,118,118,0,118,0,118,0,
0,108,108,108,0,108,0,108,0,
0,134,0,134,0,134,0,134,0,
124,124,124,124,0,124,0,124,0,
0,0,0,0,0,114,0,114,0,
99,99,99,99,99,99,99,99,0,
123,123,123,0,123,123,123,123,123,
0,0,119,0,119,0,119,119,119,
109,0,109,109,109,0,109,109,109,
99,0,0,99,99,99,99,99,99,
123,0,123,0,0,0,0,0,0,
108,0,108,108,108,108,108,108,108,
104,0,0,0,104,0,0,0,104,
95,0,95,0,95,0,95,95,95,
94,0,94,0,94,0,94,0,0,
85,85,85,0,85,0,85,0,85,
84,0,0,0,84,0,84,0,84,
83,0,83,83,83,0,83,0,83,
0,74,74,74,74,74,0,74,0,
73,73,73,73,73,73,0,73,0,
0,0,0,72,0,0,0,72,0,
71,71,0,71,0,71,71,71,71,
70,70,0,70,0,0,0,0,0,
69,69,69,69,0,69,69,69,0,
0,0,0,0,0,0,0,0,0,
0,0,0,0,0,0,0,0,0,
0,0,0,0,0,0,0,0,0.