[layer]
type=Tile Layer 1
data=
0,24,2,1,21,0,1,1,1,
1,0,0,0,1,0,0,21,1,
1,1,1,21,1,1,1,0,1,
1,1,1,0,0,21,1,1,0,
2,2,2,2,2,18,21,2,0,
1,1,1,1,1,0,21,1,0,
1,1,1,2,21,0,1,1,0,
1,0,0,21,24,2,1,1,1,
1,0,21,2,0,0,1,0,0,
0,1,0,1,1,1,1,1,21,
0,2,18,2,0,21,0,2,2,
1,1,21,1,0,1,0,1,0,
1,1,1,1,21,1,1,1,0,
20,2,21,2,0,2,2,2,2,
0,2,21,1,0,0,0,0,0,
0,0,0,0,0,0,0,0,0,
0,0,0,0,0,0,0,0,0,
0,0,0,0,0,0,0,0,0.
[layer]
type=Tile Layer 2
data=
0,0,94,94,0,0,94,94,94,
73,0,0,0,73,0,0,0,73,
68,68,68,0,68,68,68,0,68,
71,71,71,0,0,0,71,71,0,
64,64,64,64,64,0,0,64,0,
63,63,63,63,63,0,0,63,0,
62,62,62,62,0,0,62,62,0,
55,0,0,0,0,55,55,55,55,
54,0,0,54,0,0,54,0,0,
0,53,0,53,53,53,53,53,0,
0,52,0,52,0,0,0,52,52,
51,51,0,51,0,51,0,51,0,
48,48,48,48,0,48,48,48,0,
0,49,0,49,0,49,49,49,49,
0,48,0,48,0,0,0,0,0,
0,0,0,0,0,0,0,0,0,
0,0,0,0,0,0,0,0,0,
0,0,0,0,0,0,0,0,0.