[layer]
type=Tile Layer 1
data=
1,1,0,0,0,0,0,1,21,
1,1,1,1,1,1,1,2,21,
1,1,0,1,0,21,0,8,0,
1,1,0,1,21,1,0,2,2,
0,0,1,1,1,1,0,21,0,
0,1,2,1,21,1,1,1,1,
0,0,0,1,0,1,21,0,0,
2,7,2,2,21,2,2,2,0,
0,0,2,8,2,2,21,1,0,
2,2,2,2,9,2,21,2,0,
1,1,1,21,2,0,1,1,1,
1,1,21,0,1,1,1,1,1,
2,2,2,0,0,0,21,0,0,
2,10,2,1,1,1,21,0,0,
0,21,0,0,0,0,0,1,1,
0,0,0,0,0,0,0,0,0,
0,0,0,0,0,0,0,0,0,
0,0,0,0,0,0,0,0,0.
[layer]
type=Tile Layer 2
data=
94,94,0,0,0,0,0,94,0,
66,66,66,66,66,66,66,66,0,
72,72,0,72,0,0,0,72,0,
71,71,0,71,0,71,0,71,71,
0,0,64,64,64,64,0,0,0,
0,60,60,60,0,60,60,60,60,
0,0,0,62,0,62,0,0,0,
55,55,55,55,0,55,55,55,0,
0,0,54,54,54,54,0,54,0,
53,53,53,53,53,53,0,53,0,
50,50,50,0,50,0,50,50,50,
49,49,0,0,49,49,49,49,49,
50,50,50,0,0,0,0,0,0,
49,49,49,49,49,49,0,0,0,
0,0,0,0,0,0,0,48,48,
0,0,0,0,0,0,0,0,0,
0,0,0,0,0,0,0,0,0,
0,0,0,0,0,0,0,0,0.