[layer]
type=Tile Layer 1
data=
0,1,1,0,1,0,5,21,4,
1,21,5,6,0,1,3,1,1,
1,3,21,0,0,6,1,1,5,
0,21,0,1,0,0,0,0,0,
1,3,21,5,0,4,1,3,0,
0,1,0,1,1,1,21,1,0,
0,1,0,1,21,4,1,1,0,
0,0,0,1,1,1,0,1,21,
0,3,1,1,21,1,0,5,0,
0,0,0,0,0,0,0,0,0,
0,0,0,0,0,0,0,0,0,
0,0,0,0,0,0,0,0,0.
[layer]
type=Tile Layer 2
data=
0,75,75,0,75,0,75,0,75,
45,0,45,45,0,45,45,45,45,
47,47,0,0,0,47,47,47,47,
0,0,0,46,0,0,0,0,0,
45,45,0,45,0,45,45,45,0,
0,44,0,44,44,44,0,44,0,
0,43,0,43,0,43,43,43,0,
0,0,0,43,43,43,0,43,0,
0,42,42,42,0,42,0,42,0,
0,0,0,0,0,0,0,0,0,
0,0,0,0,0,0,0,0,0,
0,0,0,0,0,0,0,0,0.