[layer]
type=Tile Layer 1
data=
0,1,1,1,1,1,1,0,21,
0,21,2,1,1,1,1,1,0,
0,24,2,1,1,1,1,0,21,
0,0,21,2,2,2,1,0,0,
1,1,21,0,19,0,0,0,1,
1,1,1,2,2,0,0,21,0,
0,21,1,1,1,1,0,0,0,
0,1,2,2,2,1,21,1,1,
0,1,2,19,2,1,21,1,1,
1,1,2,2,0,21,0,0,1,
1,2,2,0,21,1,1,0,0,
0,0,19,21,1,1,1,1,0,
1,2,2,0,21,0,1,1,1,
1,1,0,0,21,0,0,0,1,
1,0,0,1,1,1,1,21,0,
1,21,1,1,1,0,1,0,1,
1,0,0,21,1,0,1,0,1,
1,0,1,0,1,21,1,0,1,
1,0,1,0,1,21,1,0,1,
2,21,2,0,2,0,2,18,2,
1,0,1,21,1,0,2,0,0,
1,1,1,21,1,0,19,2,1,
0,0,1,0,1,0,2,21,0,
1,21,1,0,1,0,1,0,1,
0,0,0,0,18,21,2,2,2,
1,1,21,1,1,1,1,1,1,
1,21,0,1,1,1,0,0,1,
1,21,1,1,1,1,1,2,2,
0,0,0,0,1,21,1,0,24,
2,2,2,21,2,18,2,2,2,
19,2,1,21,1,0,1,1,1,
2,2,1,21,1,0,1,1,1,
1,21,0,0,1,0,0,0,0,
1,21,1,1,1,0,1,1,1,
1,0,0,0,0,0,1,21,0,
1,1,1,1,1,1,1,21,1,
0,21,1,1,1,1,1,0,1,
1,1,1,1,1,2,2,21,1,
0,0,0,21,0,0,20,0,2,
0,0,0,0,0,0,0,0,0,
0,0,0,0,0,0,0,0,0,
0,0,0,0,0,0,0,0,0.
[layer]
type=Tile Layer 2
data=
0,198,198,198,198,198,198,0,0,
0,0,196,196,196,196,196,196,0,
0,0,195,195,195,195,195,0,0,
0,0,0,147,147,147,147,0,0,
134,134,0,0,0,0,0,0,134,
167,167,167,167,167,0,0,0,0,
0,0,154,154,154,154,0,0,0,
0,142,142,142,142,142,0,142,142,
0,130,130,0,130,130,0,130,130,
162,162,162,162,0,0,0,0,162,
149,149,149,0,0,149,149,0,0,
0,0,0,0,137,137,137,137,0,
125,125,125,0,0,0,125,125,125,
156,156,0,0,0,0,0,0,156,
144,0,0,144,144,144,144,0,0,
132,0,132,132,132,0,132,0,132,
121,0,0,0,121,0,121,0,121,
150,0,150,0,150,0,150,0,150,
139,0,139,0,139,0,139,0,139,
128,0,128,0,128,0,128,0,128,
116,0,116,0,116,0,116,0,0,
145,145,145,0,145,0,0,145,145,
0,0,134,0,134,0,134,0,0,
123,0,123,0,123,0,123,0,123,
0,0,0,0,0,0,112,112,112,
133,133,0,133,133,133,133,133,133,
128,0,0,128,128,128,0,0,128,
112,0,112,112,112,112,112,112,112,
0,0,0,0,108,0,108,0,0,
107,107,107,0,107,0,107,107,107,
0,97,97,0,97,0,97,97,97,
96,96,96,0,96,0,96,96,96,
95,0,0,0,95,0,0,0,0,
85,0,85,85,85,0,85,85,85,
84,0,0,0,0,0,84,0,0,
79,79,79,79,79,79,79,0,79,
0,0,82,82,82,82,82,0,82,
78,78,78,78,78,78,78,0,78,
0,0,0,0,0,0,0,0,80,
0,0,0,0,0,0,0,0,0,
0,0,0,0,0,0,0,0,0,
0,0,0,0,0,0,0,0,0.