[layer]
type=Tile Layer 1
data=
0,4,1,6,0,1,0,1,21,
0,1,0,1,0,1,21,1,0,
0,1,21,3,0,1,0,1,0,
0,1,0,21,0,1,0,1,0,
0,4,21,1,3,1,0,1,1,
0,5,21,0,0,1,0,0,0,
0,1,5,1,1,6,6,1,21,
0,0,0,1,0,0,21,0,0,
1,1,21,1,0,1,1,3,1,
1,1,1,6,21,0,0,0,0,
1,1,4,0,21,1,1,0,0,
1,1,3,1,21,1,6,1,0,
1,1,1,5,21,0,0,0,0,
1,5,1,0,21,4,1,0,3,
1,1,1,0,1,0,21,0,1,
0,0,0,0,0,0,0,0,0,
0,0,0,0,0,0,0,0,0,
0,0,0,0,0,0,0,0,0.
[layer]
type=Tile Layer 2
data=
0,123,123,123,0,123,0,123,0,
0,121,0,121,0,121,0,121,0,
0,119,0,119,0,119,0,119,0,
0,89,0,0,0,89,0,89,0,
0,81,0,81,81,81,0,81,81,
0,80,0,0,0,80,0,0,0,
0,68,68,68,68,68,68,68,0,
0,0,0,71,0,0,0,0,0,
66,66,0,66,0,66,66,66,66,
62,62,62,62,0,0,0,0,0,
61,61,61,0,0,61,61,0,0,
57,57,57,57,0,57,57,57,0,
59,59,59,59,0,0,0,0,0,
58,58,58,0,0,58,58,0,58,
57,57,57,0,57,0,0,0,57,
0,0,0,0,0,0,0,0,0,
0,0,0,0,0,0,0,0,0,
0,0,0,0,0,0,0,0,0.