[layer]
type=Tile Layer 1
data=
0,21,1,1,1,1,1,1,1,
0,21,1,1,1,1,1,1,1,
0,21,1,1,1,1,1,1,1,
0,21,0,0,0,1,1,1,1,
1,1,1,21,0,1,1,1,1,
1,2,2,0,0,0,21,0,0,
1,8,2,1,21,0,0,0,2,
1,2,2,1,0,21,0,2,8,
1,1,1,1,1,1,1,21,2,
0,1,1,1,21,1,1,1,1,
0,1,0,21,0,1,1,1,0,
0,1,1,1,0,2,2,2,21,
0,2,21,2,2,2,9,2,2,
0,1,0,1,0,2,2,2,21,
0,0,0,1,21,0,2,2,0,
1,1,1,1,21,2,8,2,1,
1,0,0,2,2,2,2,21,0,
2,2,21,9,2,2,2,2,2,
1,1,2,2,2,0,0,21,0,
1,1,1,1,1,1,1,21,0,
0,0,0,0,0,21,0,0,1,
21,1,1,1,1,1,1,1,1,
0,0,21,1,1,2,2,2,1,
2,2,21,2,0,2,9,2,2,
0,0,21,0,0,2,10,2,1,
21,1,1,1,1,2,2,2,1,
21,1,1,1,1,1,1,1,1,
2,2,7,2,2,2,21,0,2,
9,2,2,21,2,2,2,2,0,
2,2,1,21,1,1,1,1,0,
8,2,2,21,1,1,1,1,0,
2,9,2,21,2,2,2,2,0,
2,2,9,2,2,21,2,2,0,
0,2,21,0,1,1,0,1,0,
0,0,1,1,1,1,21,0,0,
1,21,1,1,1,1,1,1,0,
1,1,21,1,1,1,0,1,1,
0,2,2,0,0,0,0,21,0,
0,2,8,2,1,1,1,1,21,
0,2,2,2,1,1,21,1,0,
0,1,1,1,1,1,21,2,0,
0,0,0,0,0,0,0,10,21,
1,1,1,1,1,1,2,2,21,
1,1,0,0,0,0,0,21,0,
1,1,1,1,1,1,1,1,21,
0,21,2,2,2,7,2,2,2,
0,0,21,0,1,1,1,1,1,
0,1,2,2,2,21,0,1,1,
0,21,2,9,2,2,2,2,2,
0,1,0,2,2,1,1,0,21,
0,0,0,1,1,1,1,1,21,
0,0,0,0,0,0,0,0,0,
0,0,0,0,0,0,0,0,0,
0,0,0,0,0,0,0,0,0.
[layer]
type=Tile Layer 2
data=
0,0,234,234,234,234,234,234,234,
0,0,233,233,233,233,233,233,233,
0,0,231,231,231,231,231,231,231,
0,0,0,0,0,174,174,174,174,
159,159,159,0,0,159,159,159,159,
199,199,199,0,0,0,0,0,0,
184,184,184,184,0,0,0,0,184,
169,169,169,169,0,0,0,169,169,
147,147,147,147,147,147,147,0,147,
0,193,193,193,0,193,193,193,193,
0,179,0,0,0,179,179,179,0,
0,165,165,165,0,165,165,165,0,
0,150,0,150,150,150,150,150,150,
0,188,0,188,0,188,188,188,0,
0,0,0,174,0,0,174,174,0,
160,160,160,160,0,160,160,160,160,
146,0,0,146,146,146,146,0,0,
182,182,0,182,182,182,182,182,182,
168,168,168,168,168,0,0,0,0,
155,155,155,155,155,155,155,0,0,
0,0,0,0,0,0,0,0,142,
0,168,168,168,168,168,168,168,168,
0,0,0,163,163,163,163,163,163,
150,150,0,150,0,150,150,150,150,
0,0,0,0,0,137,137,137,137,
0,163,163,163,163,163,163,163,163,
0,151,151,151,151,151,151,151,151,
145,145,145,145,145,145,0,0,145,
133,133,133,0,133,133,133,133,0,
165,165,165,0,165,165,165,165,0,
153,153,153,0,153,153,153,153,0,
141,141,141,0,141,141,141,141,0,
128,128,128,128,128,0,128,128,0,
0,160,0,0,160,160,0,160,0,
0,0,148,148,148,148,0,0,0,
136,0,136,136,136,136,136,136,0,
124,124,0,124,124,124,0,124,124,
0,154,154,0,0,0,0,0,0,
0,142,142,142,142,142,142,142,0,
0,131,131,131,131,131,0,131,0,
0,120,120,120,120,120,0,120,0,
0,0,0,0,0,0,0,119,0,
103,103,103,103,103,103,103,103,0,
107,107,0,0,0,0,0,0,0,
101,101,101,101,101,101,101,101,0,
0,0,95,95,95,95,95,95,95,
0,0,0,0,94,94,94,94,94,
0,93,93,93,93,0,0,93,93,
0,0,92,92,92,92,92,92,92,
0,91,0,91,91,91,91,0,0,
0,0,0,90,90,90,90,90,0,
0,0,0,0,0,0,0,0,0,
0,0,0,0,0,0,0,0,0,
0,0,0,0,0,0,0,0,0.