[layer]
type=Tile Layer 1
data=
0,2,2,2,9,2,21,2,2,
1,1,1,2,2,2,1,1,21,
2,7,2,2,2,21,2,2,0,
1,1,1,21,1,1,2,2,1,
0,21,0,0,1,1,2,8,1,
1,1,1,21,1,1,2,2,1,
1,2,2,1,1,1,1,1,21,
1,10,2,21,0,0,0,0,0,
1,2,2,21,1,1,1,1,1,
0,0,21,0,1,1,1,1,1,
1,1,1,21,1,1,1,1,1,
7,2,2,2,2,21,2,0,2,
1,21,1,1,1,0,1,1,1,
0,0,21,0,1,0,1,0,1,
1,2,2,2,1,21,1,0,1,
2,21,8,2,1,0,1,0,1,
10,2,2,0,0,21,1,0,0,
2,21,1,1,1,1,1,1,1,
0,0,1,0,0,0,0,21,0,
1,1,1,21,1,1,1,1,1,
0,0,0,21,1,0,1,0,0,
1,1,1,1,1,21,1,0,1,
1,0,0,21,0,0,1,0,1,
1,1,1,21,1,1,1,0,1,
0,1,21,0,1,1,1,1,1,
1,1,21,1,0,1,1,1,1,
1,1,21,1,0,1,1,1,1,
1,0,21,1,0,0,0,1,1,
1,0,1,21,0,1,0,1,1,
2,21,2,2,0,2,2,2,7,
0,21,1,1,0,1,1,1,1,
0,21,0,0,0,0,1,1,0,
2,9,2,21,2,2,2,2,0,
1,2,21,1,0,0,2,2,1,
0,0,21,0,0,2,8,2,1,
0,0,1,0,21,2,2,2,2,
2,2,21,2,2,0,2,2,9,
1,1,21,0,0,0,1,2,2,
2,2,21,2,2,2,2,2,9,
0,0,0,0,0,0,0,0,0,
0,0,0,0,0,0,0,0,0,
0,0,0,0,0,0,0,0,0.
[layer]
type=Tile Layer 2
data=
0,197,197,197,197,197,0,197,197,
186,186,186,186,186,186,186,186,0,
194,194,194,194,194,0,194,194,0,
139,139,139,0,139,139,139,139,139,
0,0,0,0,133,133,133,133,133,
158,158,158,0,158,158,158,158,158,
146,146,146,146,146,146,146,146,0,
141,141,141,0,0,0,0,0,0,
122,122,122,0,122,122,122,122,122,
0,0,0,0,161,161,161,161,161,
141,141,141,0,141,141,141,141,141,
136,136,136,136,136,0,136,0,136,
124,0,124,124,124,0,124,124,124,
0,0,0,0,155,0,155,0,155,
143,143,143,143,143,0,143,0,143,
131,0,131,131,131,0,131,0,131,
120,120,120,0,0,0,120,0,0,
142,0,142,142,142,142,142,142,142,
0,0,138,0,0,0,0,0,0,
121,121,121,0,121,121,121,121,121,
0,0,0,0,115,0,115,0,0,
144,144,144,144,144,0,144,0,144,
133,0,0,0,0,0,133,0,133,
122,122,122,0,122,122,122,0,122,
0,111,0,0,111,111,111,111,111,
138,138,0,138,0,138,138,138,138,
127,127,0,127,0,127,127,127,127,
117,0,0,117,0,0,0,117,117,
107,0,107,0,0,107,0,107,107,
106,0,106,106,0,106,106,106,106,
0,0,96,96,0,96,96,96,96,
0,0,0,0,0,0,95,95,0,
94,94,94,0,94,94,94,94,0,
84,84,0,84,0,0,84,84,84,
0,0,0,0,0,83,83,83,83,
0,0,82,0,0,82,82,82,82,
81,81,0,81,81,0,81,81,81,
80,80,0,0,0,0,80,80,80,
79,79,0,79,79,79,79,79,79,
0,0,0,0,0,0,0,0,0,
0,0,0,0,0,0,0,0,0,
0,0,0,0,0,0,0,0,0.