[layer]
type=Tile Layer 1
data=
1,1,1,6,1,1,21,1,5,
0,0,0,0,0,0,0,1,21,
0,1,1,1,5,1,0,4,21,
5,1,1,4,21,1,1,0,1,
3,1,1,1,0,21,0,0,1,
1,0,0,21,0,5,1,0,0,
1,21,1,1,6,1,1,1,0,
3,21,0,5,1,1,1,0,0,
1,0,21,1,1,1,1,0,6,
1,0,1,1,21,0,0,3,1,
1,0,21,1,1,1,0,1,1,
5,1,0,6,1,6,0,21,0,
0,0,21,0,0,0,0,1,0,
0,6,1,1,1,1,0,3,21,
0,1,0,21,0,1,0,0,0,
0,1,21,1,1,5,5,1,6,
0,1,0,0,0,0,0,21,0,
1,1,21,1,3,1,1,1,1,
0,0,0,0,0,0,0,0,0,
0,0,0,0,0,0,0,0,0,
0,0,0,0,0,0,0,0,0.
[layer]
type=Tile Layer 2
data=
116,116,116,116,116,116,0,116,116,
0,0,0,0,0,0,0,127,0,
0,125,125,125,125,125,0,125,0,
82,82,82,82,0,82,82,0,82,
107,107,107,107,0,0,0,0,107,
98,0,0,0,0,98,98,0,0,
86,0,86,86,86,86,86,86,0,
82,0,0,82,82,82,82,0,0,
81,0,0,81,81,81,81,0,81,
73,0,73,73,0,0,0,73,73,
72,0,0,72,72,72,0,72,72,
71,71,0,71,71,71,0,0,0,
0,0,0,0,0,0,0,63,0,
0,62,62,62,62,62,0,62,0,
0,61,0,0,0,61,0,0,0,
0,57,0,57,57,57,57,57,57,
0,59,0,0,0,0,0,0,0,
53,53,0,53,53,53,53,53,53,
0,0,0,0,0,0,0,0,0,
0,0,0,0,0,0,0,0,0,
0,0,0,0,0,0,0,0,0.