[layer]
type=Tile Layer 1
data=
1,21,0,0,0,1,0,0,0,
0,0,0,0,0,0,21,0,0,
0,0,21,1,0,0,1,0,0,
1,21,0,0,0,0,0,0,0,
0,21,1,0,0,0,0,0,0,
0,0,0,0,0,0,0,0,0,
0,0,0,0,0,0,0,0,0,
0,0,0,0,0,0,0,0,0,
0,0,0,0,0,0,0,0,0.
[layer]
type=Tile Layer 2
data=
30,0,0,0,0,30,0,0,0,
0,0,0,0,0,0,0,0,0,
0,0,0,30,0,0,20,0,0,
30,0,0,0,0,0,0,0,0,
0,0,30,0,0,0,0,0,0,
0,0,0,0,0,0,0,0,0,
0,0,0,0,0,0,0,0,0,
0,0,0,0,0,0,0,0,0,
0,0,0,0,0,0,0,0,0.