[layer]
type=Tile Layer 1
data=
1,1,1,21,1,1,1,1,1,
1,1,1,0,1,21,0,0,0,
1,1,1,21,1,1,1,0,1,
2,18,2,2,2,2,2,21,0,
1,21,1,1,1,1,1,1,1,
0,0,0,0,21,0,0,0,1,
1,1,1,1,1,21,1,1,1,
1,1,1,1,1,21,1,0,0,
1,1,1,1,1,21,1,1,1,
1,21,0,0,0,0,0,0,0,
1,21,1,1,1,2,2,2,1,
2,21,2,2,2,0,20,0,2,
1,0,1,0,1,0,2,21,0,
1,0,1,0,1,21,1,0,1,
0,0,1,0,1,0,1,0,21,
1,1,1,21,1,0,1,1,1,
0,21,1,0,1,0,2,0,1,
2,0,2,0,2,21,2,20,2,
1,0,2,21,1,0,0,0,1,
2,20,2,21,2,2,2,0,2,
1,0,2,21,1,0,1,0,1,
0,1,1,1,1,21,1,1,1,
1,1,1,2,0,0,21,0,0,
2,2,21,0,20,2,2,2,0,
1,1,0,2,0,0,0,21,24,
1,21,0,1,0,1,1,1,1,
2,21,2,2,18,2,2,2,2,
1,0,21,1,0,1,1,1,1,
1,1,21,1,0,1,1,1,1,
2,2,21,0,18,2,2,2,2,
1,1,21,2,2,24,2,1,1,
1,2,0,21,24,0,0,1,1,
1,19,2,21,0,0,0,0,1,
1,2,2,1,1,21,1,0,1,
1,1,1,1,1,21,1,0,1,
1,1,1,0,21,0,0,0,0,
0,0,0,0,0,0,0,0,0,
0,0,0,0,0,0,0,0,0,
0,0,0,0,0,0,0,0,0.
[layer]
type=Tile Layer 2
data=
183,183,183,0,183,183,183,183,183,
191,191,191,0,191,0,0,0,0,
189,189,189,0,189,189,189,0,189,
153,0,153,153,153,153,153,0,0,
134,0,134,134,134,134,134,134,134,
0,0,0,0,0,0,0,0,129,
153,153,153,153,153,0,153,153,153,
148,148,148,148,148,0,148,0,0,
130,130,130,130,130,0,130,130,130,
124,0,0,0,0,0,0,0,0,
147,0,147,147,147,147,147,147,147,
143,0,143,143,143,0,0,0,143,
131,0,131,0,131,0,131,0,0,
120,0,120,0,120,0,120,0,120,
0,0,149,0,149,0,149,0,0,
138,138,138,0,138,0,138,138,138,
0,0,127,0,127,0,127,0,127,
115,0,115,0,115,0,115,0,115,
144,0,144,0,144,0,0,0,144,
133,0,133,0,133,133,133,0,133,
122,0,122,0,122,0,122,0,122,
0,111,111,111,111,0,111,111,111,
138,138,138,138,0,0,0,0,0,
127,127,0,0,0,127,127,127,0,
117,117,0,117,0,0,0,0,0,
107,0,0,107,0,107,107,107,107,
106,0,106,106,0,106,106,106,106,
96,0,0,96,0,96,96,96,96,
95,95,0,95,0,95,95,95,95,
94,94,0,0,0,94,94,94,94,
84,84,0,84,84,0,84,84,84,
83,83,0,0,0,0,0,83,83,
82,0,82,0,0,0,0,0,82,
81,81,81,81,81,0,81,0,81,
80,80,80,80,80,0,80,0,80,
79,79,79,0,0,0,0,0,0,
0,0,0,0,0,0,0,0,0,
0,0,0,0,0,0,0,0,0,
0,0,0,0,0,0,0,0,0.