[layer]
type=Tile Layer 1
data=
1,21,1,1,1,1,1,0,1,
0,0,1,1,1,1,1,21,1,
1,1,1,1,1,1,1,21,1,
1,1,1,1,1,21,1,1,1,
0,0,1,21,1,0,1,1,1,
1,1,1,21,1,0,1,1,1,
1,0,0,0,1,0,1,21,0,
1,21,1,1,1,1,1,1,1,
1,21,1,1,1,0,1,1,1,
1,21,1,1,1,0,1,1,1,
0,21,0,0,0,0,1,0,0,
1,1,1,1,1,21,1,1,1,
1,0,0,0,21,0,0,0,0,
1,21,1,1,1,1,1,1,1,
1,0,21,0,1,0,0,0,1,
1,21,1,0,1,0,1,1,1,
1,0,1,21,1,0,0,0,1,
1,0,1,21,1,1,1,0,1,
1,0,1,0,0,0,1,21,0,
1,21,1,1,1,0,1,0,1,
1,0,1,0,21,0,1,0,1,
1,1,1,1,1,0,0,21,0,
1,1,1,1,1,1,1,1,21,
1,1,1,1,1,1,1,1,21,
1,1,1,1,1,1,21,0,0,
0,21,0,0,0,0,0,1,1,
0,1,1,21,1,1,1,1,1,
0,1,1,21,1,1,1,1,1,
0,0,1,21,0,0,0,0,0,
1,1,1,1,1,1,1,1,21,
1,1,1,0,21,1,1,1,0,
1,1,1,1,21,1,1,0,0,
1,1,1,1,21,0,1,0,0,
1,1,1,1,1,21,0,1,0,
0,0,21,0,0,0,0,1,0,
0,1,1,1,1,1,1,1,21,
0,0,0,0,0,0,0,0,0,
0,0,0,0,0,0,0,0,0,
0,0,0,0,0,0,0,0,0.
[layer]
type=Tile Layer 2
data=
176,0,176,176,176,176,176,0,176,
0,0,175,175,175,175,175,0,175,
165,165,165,165,165,165,165,0,165,
134,134,134,134,134,0,134,134,134,
0,0,129,0,129,0,129,129,129,
118,118,118,0,118,0,118,118,118,
147,0,0,0,147,0,147,0,0,
129,0,129,129,129,129,129,129,129,
124,0,124,124,124,0,124,124,124,
113,0,113,113,113,0,113,113,113,
0,0,0,0,0,0,141,0,0,
124,124,124,124,124,0,124,124,124,
119,0,0,0,0,0,0,0,0,
104,0,104,104,104,104,104,104,104,
135,0,0,0,135,0,0,0,135,
125,0,125,0,125,0,125,125,125,
115,0,115,0,115,0,0,0,115,
104,0,104,0,104,104,104,0,104,
130,0,130,0,0,0,130,0,0,
120,0,120,120,120,0,120,0,120,
110,0,110,0,0,0,110,0,110,
100,100,100,100,100,0,0,0,0,
118,118,118,118,118,118,118,118,0,
109,109,109,109,109,109,109,109,0,
105,105,105,105,105,105,0,0,0,
0,0,0,0,0,0,0,96,96,
0,95,95,0,95,95,95,95,95,
0,86,86,0,86,86,86,86,86,
0,0,85,0,0,0,0,0,0,
80,80,80,80,80,80,80,80,0,
75,75,75,0,0,75,75,75,0,
74,74,74,74,0,74,74,0,0,
73,73,73,73,0,0,73,0,0,
72,72,72,72,72,0,0,72,0,
0,0,0,0,0,0,0,71,0,
0,70,70,70,70,70,70,70,0,
0,0,0,0,0,0,0,0,0,
0,0,0,0,0,0,0,0,0,
0,0,0,0,0,0,0,0,0.