[layer]
type=Tile Layer 1
data=
1,1,1,21,1,1,0,1,1,
3,1,1,21,0,1,0,0,5,
1,1,4,3,21,0,1,0,1,
1,1,1,21,1,0,1,1,1,
0,21,0,0,1,0,1,4,5,
1,1,1,21,6,0,6,1,1,
0,0,1,21,0,0,0,0,0,
1,21,1,1,3,5,1,1,1,
4,21,5,1,1,1,1,0,0,
1,21,1,1,5,1,6,1,1,
1,1,1,1,4,1,1,1,21,
1,1,1,1,1,6,1,21,1,
1,1,1,1,1,3,21,1,1,
6,1,5,1,1,1,21,0,5,
1,1,21,0,0,1,0,0,1,
6,1,1,1,21,0,0,1,1,
1,1,1,1,0,21,0,4,1,
1,1,1,5,21,1,0,0,5,
3,1,1,3,21,0,0,0,0,
1,6,4,1,1,1,0,21,0,
1,1,1,1,0,0,21,0,0,
1,1,1,0,21,0,0,1,3,
1,3,1,0,21,1,0,0,0,
1,6,1,0,21,1,5,1,0,
1,1,5,21,3,1,1,1,0,
1,1,1,0,21,0,3,6,1,
1,1,1,6,21,0,1,1,0,
1,0,0,21,0,1,1,1,0,
1,21,1,5,1,5,1,1,0,
3,0,1,1,1,4,1,21,0,
0,0,0,21,0,3,1,4,0,
1,1,5,1,21,1,1,1,0,
0,1,1,1,0,0,0,21,0,
0,3,1,5,6,1,1,1,21,
0,1,1,1,0,1,0,1,21,
0,5,1,1,0,1,21,1,0,
0,0,0,21,0,1,0,0,0,
0,1,1,3,21,1,1,1,1,
0,1,21,5,0,1,1,6,0,
0,1,21,0,1,1,1,6,1,
1,1,1,21,0,1,1,1,1,
1,5,1,5,0,21,1,1,3,
0,21,1,6,1,1,5,1,1,
1,21,1,1,0,3,1,1,1,
0,1,1,1,21,0,0,0,5,
0,0,0,0,0,0,0,0,0,
0,0,0,0,0,0,0,0,0,
0,0,0,0,0,0,0,0,0.
[layer]
type=Tile Layer 2
data=
208,208,208,0,208,208,0,208,208,
206,206,206,0,0,206,0,0,206,
204,204,204,204,0,0,204,0,204,
178,178,178,0,178,0,178,178,178,
0,0,0,0,165,0,165,165,165,
152,152,152,0,152,0,152,152,152,
0,0,138,0,0,0,0,0,0,
164,0,164,131,164,131,164,164,164,
160,0,160,128,160,8,160,0,0,
147,0,117,117,117,7,117,147,147,
6,6,6,6,134,6,6,6,0,
159,159,127,159,159,159,127,0,159,
123,123,123,123,154,123,0,7,7,
142,142,142,142,142,142,0,0,142,
130,130,0,0,0,130,0,0,130,
162,162,162,162,0,0,0,162,162,
149,149,149,149,0,0,0,149,149,
137,137,137,137,0,137,0,0,137,
125,125,125,125,0,0,0,0,0,
156,156,156,156,156,156,0,0,0,
144,144,144,144,0,0,0,0,0,
132,132,132,0,0,0,0,132,132,
121,121,121,0,0,121,0,0,0,
150,150,150,0,0,150,150,150,0,
139,139,139,0,139,139,139,139,0,
128,128,128,0,0,0,128,128,128,
116,116,116,116,0,0,116,116,0,
145,0,0,0,0,145,145,145,0,
134,0,134,134,134,134,134,134,0,
123,0,123,123,123,123,123,0,0,
0,0,0,0,0,112,112,112,0,
139,139,139,139,0,139,139,139,0,
0,128,128,128,0,0,0,0,0,
0,118,118,118,118,118,118,118,0,
0,108,108,108,0,108,0,108,0,
0,107,107,107,0,107,0,107,0,
0,0,0,0,0,97,0,0,0,
0,96,96,96,0,96,96,96,96,
0,95,0,76,0,4,4,95,0,
0,4,0,0,85,85,68,68,85,
4,67,67,0,0,67,67,67,67,
4,83,66,83,0,0,66,83,66,
0,0,66,66,4,4,66,82,82,
4,0,65,81,0,81,65,81,65,
0,80,80,80,0,0,0,0,80,
0,0,0,0,0,0,0,0,0,
0,0,0,0,0,0,0,0,0,
0,0,0,0,0,0,0,0,0.