[layer]
type=Tile Layer 1
data=
4,1,21,1,3,0,1,2,8,
1,1,0,0,21,0,0,2,2,
1,1,1,5,1,1,4,21,1,
1,1,0,21,6,1,1,0,1,
1,1,0,5,0,21,0,1,1,
0,21,0,0,2,2,4,1,5,
2,21,2,2,9,2,2,2,0,
1,21,1,2,2,2,1,6,0,
5,0,0,21,1,2,2,2,0,
2,2,2,2,2,2,9,21,0,
2,2,2,2,2,2,9,21,0,
1,1,21,0,0,2,2,0,0,
1,1,21,3,2,8,2,0,1,
1,4,21,0,2,2,2,0,1,
1,1,3,21,6,1,0,1,1,
4,21,1,0,1,0,1,1,5,
2,2,2,2,2,2,7,21,0,
1,21,1,1,1,0,1,6,1,
4,0,0,0,0,21,2,2,0,
1,1,1,5,1,2,10,21,1,
0,0,0,21,1,2,2,0,1,
1,6,1,21,1,2,2,2,4,
2,2,2,2,2,2,9,21,0,
1,1,2,8,2,21,2,0,1,
1,21,2,2,2,3,1,5,1,
0,21,0,1,0,1,4,1,1,
0,1,0,1,21,3,1,1,1,
0,1,21,0,0,1,6,1,1,
6,3,1,1,21,5,1,1,1,
1,1,1,1,0,21,0,0,0,
1,1,1,1,21,1,6,1,3,
0,21,0,0,0,2,2,0,0,
0,2,2,2,2,9,21,2,2,
1,1,0,0,21,2,2,1,0,
1,1,1,4,3,1,21,1,0,
1,1,0,2,2,6,21,6,0,
6,5,21,8,2,4,1,1,0,
0,1,2,2,2,1,0,1,21,
0,1,21,1,1,1,0,1,0,
0,0,0,0,0,0,0,0,0,
0,0,0,0,0,0,0,0,0,
0,0,0,0,0,0,0,0,0.
[layer]
type=Tile Layer 2
data=
197,197,0,197,197,0,197,197,197,
195,195,0,0,0,0,0,195,195,
184,184,184,184,184,184,184,0,184,
146,146,0,0,146,146,146,0,146,
133,133,0,133,0,0,0,133,133,
0,0,0,0,166,166,166,166,166,
153,0,153,153,153,153,153,153,0,
141,0,141,141,141,141,141,141,0,
129,0,0,0,129,129,129,129,0,
161,161,161,161,161,161,161,0,0,
148,148,148,148,148,148,148,0,0,
136,136,0,0,0,136,136,0,0,
124,124,0,124,124,124,124,0,124,
155,155,0,0,155,155,155,0,155,
143,143,143,0,143,143,0,143,143,
131,0,131,0,131,0,131,131,131,
120,120,120,120,120,120,120,0,0,
149,0,149,149,149,0,149,149,149,
138,0,0,0,0,0,138,138,0,
127,127,127,127,127,127,127,0,127,
0,0,0,0,115,115,115,0,115,
137,137,137,0,137,137,137,137,137,
133,133,133,133,133,133,133,0,0,
122,122,122,122,122,0,122,0,122,
106,0,106,106,106,106,106,106,106,
0,0,0,138,0,138,138,138,138,
0,127,0,127,0,127,127,127,127,
0,117,0,0,0,117,117,117,117,
102,102,102,102,0,102,102,102,102,
106,106,106,106,0,0,0,0,0,
91,91,91,91,0,91,91,91,91,
0,0,0,0,0,95,95,0,0,
0,94,94,94,94,94,0,94,94,
84,84,0,0,0,84,84,84,0,
83,83,83,83,83,83,0,83,0,
82,82,0,82,82,82,0,82,0,
81,81,0,81,81,81,81,81,0,
0,80,80,80,80,80,0,80,0,
0,79,0,79,79,79,0,79,0,
0,0,0,0,0,0,0,0,0,
0,0,0,0,0,0,0,0,0,
0,0,0,0,0,0,0,0,0.