[layer]
type=Tile Layer 1
data=
1,5,1,1,1,21,3,3,1,
4,1,4,5,1,21,1,1,1,
1,1,1,1,1,21,1,1,1,
0,0,0,0,0,0,1,0,21,
1,1,1,1,5,21,3,1,1,
1,0,0,21,1,0,6,0,0,
1,1,21,1,1,1,1,1,3,
0,4,0,6,4,1,0,21,0,
0,1,0,1,1,1,0,1,21,
0,1,0,1,1,1,0,5,21,
0,6,21,4,1,1,0,1,1,
0,4,21,1,0,0,0,1,0,
0,1,1,1,4,1,4,1,21,
0,0,0,1,1,3,1,1,21,
0,1,1,6,3,1,1,1,21,
6,1,1,21,5,1,1,6,1,
0,0,21,0,0,0,0,0,1,
1,1,4,1,1,1,21,1,1,
0,0,0,21,1,0,0,0,1,
1,6,3,21,1,0,1,0,1,
1,21,0,0,4,0,1,0,0,
1,21,1,5,1,0,3,1,4,
0,0,3,21,0,0,1,0,0,
1,1,1,21,1,1,1,0,1,
3,5,1,21,0,0,1,3,0,
1,1,1,0,0,1,1,21,0,
1,1,1,6,21,1,1,0,1,
1,1,1,5,21,1,0,0,3,
1,1,1,4,21,4,0,1,3,
1,1,1,1,1,1,21,0,1,
1,1,0,0,21,0,1,0,1,
1,6,21,5,1,1,1,0,4,
1,1,21,0,0,0,0,0,0,
1,1,1,0,21,0,0,0,1,
5,1,1,21,1,1,1,0,1,
4,4,1,0,0,21,0,0,6,
5,1,1,6,21,1,1,0,0,
1,21,1,1,1,1,4,0,0,
1,0,0,1,1,1,5,21,0,
0,0,0,0,0,0,0,0,0,
0,0,0,0,0,0,0,0,0,
0,0,0,0,0,0,0,0,0.
[layer]
type=Tile Layer 2
data=
187,187,187,187,187,0,187,187,187,
186,186,186,186,186,0,186,186,186,
184,184,184,184,184,0,184,184,184,
0,0,0,0,0,0,146,0,0,
127,127,127,127,127,0,127,127,127,
166,0,0,0,166,0,166,0,0,
146,146,0,146,146,146,146,146,146,
0,141,0,141,141,141,0,0,0,
0,129,0,129,129,129,0,129,0,
0,161,0,161,161,161,0,161,0,
0,148,0,148,148,148,0,148,148,
0,136,0,136,0,0,0,136,0,
0,124,124,124,124,124,124,124,0,
0,0,0,155,155,155,155,155,0,
0,143,143,143,143,143,143,143,0,
125,125,125,0,125,125,125,125,125,
0,0,0,0,0,0,0,0,120,
142,142,142,142,142,142,0,142,142,
0,0,0,0,138,0,0,0,138,
127,127,127,0,127,0,127,0,127,
115,0,0,0,115,0,115,0,0,
144,0,144,144,144,0,144,144,144,
0,0,133,0,0,0,133,0,0,
122,122,122,0,122,122,122,0,122,
111,111,111,0,0,0,111,111,0,
138,138,138,0,0,138,138,0,0,
127,127,127,127,0,127,127,0,127,
117,117,117,117,0,117,0,0,117,
107,107,107,107,0,107,0,107,107,
106,106,106,106,106,106,0,0,106,
96,96,0,0,0,0,96,0,96,
95,95,0,95,95,95,95,0,95,
94,94,0,0,0,0,0,0,0,
84,84,84,0,0,0,0,0,84,
83,83,83,0,83,83,83,0,83,
82,82,82,0,0,0,0,0,82,
81,81,81,81,0,81,81,0,0,
80,0,80,80,80,80,80,0,0,
79,0,0,79,79,79,79,0,0,
0,0,0,0,0,0,0,0,0,
0,0,0,0,0,0,0,0,0,
0,0,0,0,0,0,0,0,0.