[layer]
type=Tile Layer 1
data=
1,1,1,21,1,1,1,1,1,
0,0,21,0,1,1,1,1,1,
1,21,1,1,1,1,1,1,1,
0,0,0,0,0,0,1,21,1,
1,21,2,2,1,1,1,0,1,
1,21,10,2,1,1,1,0,1,
0,2,2,21,2,2,2,7,2,
1,1,0,0,1,21,0,1,0,
0,0,0,21,1,1,0,0,1,
1,21,1,1,1,1,1,0,1,
1,21,0,0,1,1,1,0,0,
0,0,1,1,0,0,0,1,21,
1,1,0,21,0,1,0,0,0,
1,2,2,2,0,1,21,0,1,
1,2,8,2,21,0,0,1,1,
0,2,2,2,1,1,21,1,1,
0,2,2,2,7,2,21,2,2,
21,1,1,1,1,1,1,1,1,
0,0,0,1,0,0,21,1,1,
2,7,21,2,2,2,2,2,2,
1,1,0,1,0,0,0,21,0,
1,1,21,1,0,1,1,1,1,
1,1,21,1,0,1,0,1,1,
7,2,2,2,21,2,0,2,2,
1,0,0,0,21,0,1,0,0,
1,1,1,21,1,1,1,1,1,
0,0,1,21,1,1,1,0,1,
2,2,1,21,1,1,1,0,1,
8,2,21,0,0,0,1,0,2,
2,2,1,21,1,0,1,2,10,
1,1,1,21,1,0,1,2,2,
1,2,2,21,1,1,1,1,1,
2,21,9,2,2,0,2,2,2,
0,21,2,2,2,2,7,2,2,
1,21,0,1,0,2,10,2,1,
1,1,21,0,0,2,2,0,0,
2,2,2,2,2,7,2,2,21,
1,1,0,21,0,1,1,1,0,
1,0,0,1,21,2,2,0,0,
2,0,2,21,2,9,2,2,2,
1,0,1,0,2,21,0,1,1,
2,2,2,2,21,2,0,7,2,
21,2,2,1,1,1,1,1,1,
0,10,21,1,1,1,1,1,0,
0,2,0,1,1,1,1,1,21,
0,21,0,1,1,1,1,1,0,
1,1,21,1,1,1,1,1,0,
1,1,21,0,0,0,0,0,0,
0,0,0,0,0,0,0,0,0,
0,0,0,0,0,0,0,0,0,
0,0,0,0,0,0,0,0,0.
[layer]
type=Tile Layer 2
data=
218,218,218,0,218,218,218,218,218,
0,0,0,0,228,228,228,228,228,
215,0,215,215,215,215,215,215,215,
0,0,0,0,0,0,184,0,184,
169,0,169,169,169,169,169,0,169,
155,0,155,155,155,155,155,0,155,
0,193,193,0,193,193,193,193,193,
179,179,0,0,179,0,0,179,0,
0,0,0,0,165,165,0,0,165,
150,0,150,150,150,150,150,0,150,
188,0,0,0,188,188,188,0,0,
0,0,174,174,0,0,0,174,0,
160,160,0,0,0,160,0,0,0,
146,146,146,146,0,146,0,0,146,
182,182,182,182,0,0,0,182,182,
0,168,168,168,168,168,0,168,168,
0,155,155,155,155,155,0,155,155,
0,135,135,135,135,135,135,135,135,
0,0,0,177,0,0,0,177,177,
163,163,0,163,163,163,163,163,163,
150,150,0,150,0,0,0,0,0,
137,137,0,137,0,137,137,137,137,
171,171,0,171,0,171,0,171,171,
158,158,158,158,0,158,0,158,158,
145,0,0,0,0,0,145,0,0,
127,127,127,0,127,127,127,127,127,
0,0,165,0,165,165,165,0,165,
153,153,153,0,153,153,153,0,153,
141,141,0,0,0,0,141,0,141,
128,128,128,0,128,0,128,128,128,
160,160,160,0,160,0,160,160,160,
141,141,141,0,141,141,141,141,141,
136,0,136,136,136,0,136,136,136,
0,0,124,124,124,124,124,124,124,
154,0,0,154,0,154,154,154,154,
142,142,0,0,0,142,142,0,0,
131,131,131,131,131,131,131,131,0,
120,120,0,0,0,120,120,120,0,
119,0,0,119,0,119,119,0,0,
108,0,108,0,108,108,108,108,108,
107,0,107,0,107,0,0,107,107,
106,106,106,106,0,106,0,106,106,
0,91,91,91,91,91,91,91,91,
0,94,0,94,94,94,94,94,0,
0,93,0,93,93,93,93,93,0,
0,0,0,92,92,92,92,92,0,
91,91,0,91,91,91,91,91,0,
90,90,0,0,0,0,0,0,0,
0,0,0,0,0,0,0,0,0,
0,0,0,0,0,0,0,0,0,
0,0,0,0,0,0,0,0,0.