[layer]
type=Tile Layer 1
data=
0,3,1,1,1,21,5,1,1,
0,1,6,1,1,21,1,1,1,
21,1,1,1,1,1,3,5,6,
0,0,0,21,0,0,1,1,1,
1,4,1,21,1,0,1,3,4,
1,5,1,21,1,0,1,0,0,
6,4,1,1,5,21,1,1,1,
1,1,5,21,4,0,1,1,6,
1,1,1,21,1,0,1,1,1,
1,4,0,0,21,1,0,1,3,
1,1,0,0,1,4,0,21,0,
1,1,21,0,1,0,6,1,0,
1,1,0,0,6,0,0,21,0,
1,3,0,4,1,1,21,0,1,
0,0,0,1,1,1,1,21,0,
0,0,21,0,0,1,1,0,0,
1,6,4,1,0,0,1,21,0,
1,1,1,3,1,21,0,1,0,
0,21,1,6,1,0,3,1,1,
1,21,1,4,1,0,4,1,1,
1,0,0,0,21,0,1,1,1,
1,1,1,21,1,1,1,4,1,
1,1,5,21,0,0,1,0,0,
4,1,6,21,1,1,1,5,1,
0,0,1,21,1,5,1,1,1,
1,1,1,21,1,1,3,3,1,
4,1,1,0,0,0,0,21,0,
1,1,1,1,21,1,0,1,1,
0,1,0,0,21,1,0,3,6,
0,1,1,1,21,4,0,1,3,
0,1,1,4,0,21,0,0,0,
1,4,1,1,21,1,1,5,1,
0,1,1,6,21,1,1,1,1,
0,1,5,1,21,1,1,1,1,
0,0,0,0,21,1,1,3,1,
21,1,1,1,1,1,4,3,5,
1,3,1,0,1,0,0,21,0,
4,1,1,21,0,0,1,0,1,
6,1,0,0,1,21,1,0,0,
1,1,21,0,1,0,0,1,0,
1,1,1,21,6,3,0,0,6,
5,1,0,21,0,0,1,0,1,
5,1,0,0,1,0,1,21,0,
4,6,1,0,1,0,21,0,0,
0,21,0,0,1,0,1,1,0,
0,6,5,1,3,1,1,1,21,
0,0,0,0,0,0,0,3,21,
1,1,1,1,1,1,21,1,1,
1,4,1,1,0,21,0,1,1,
1,1,6,1,3,1,21,1,1,
3,1,1,4,0,1,0,21,0,
0,0,0,0,0,0,0,0,0,
0,0,0,0,0,0,0,0,0,
0,0,0,0,0,0,0,0,0.
[layer]
type=Tile Layer 2
data=
0,234,234,234,234,0,234,234,234,
0,233,233,233,233,0,233,233,233,
0,220,220,220,220,220,220,220,220,
0,0,0,0,0,0,174,174,174,
159,159,159,0,159,0,159,159,159,
199,199,199,0,199,0,199,0,0,
175,175,175,175,175,0,175,175,175,
169,169,169,0,169,0,169,169,169,
155,155,155,0,155,0,155,155,155,
193,193,0,0,0,193,0,193,193,
179,179,0,0,179,179,0,0,0,
165,165,0,0,165,0,165,165,0,
150,150,0,0,150,0,0,0,0,
188,188,0,188,188,188,0,0,188,
0,0,0,174,174,174,174,0,0,
0,0,0,0,0,160,160,0,0,
146,146,146,146,0,0,146,0,0,
182,182,182,182,182,0,0,182,0,
0,0,168,168,168,0,168,168,168,
155,0,155,155,155,0,155,155,155,
142,0,0,0,0,0,142,142,142,
168,168,168,0,168,168,168,168,168,
163,163,163,0,0,0,163,0,0,
143,143,143,0,143,143,143,143,143,
0,0,137,0,137,137,137,137,137,
163,163,163,0,163,163,163,163,163,
158,158,158,0,0,0,0,0,0,
145,145,145,145,0,145,0,145,145,
0,133,0,0,0,133,0,133,133,
0,165,165,165,0,165,0,165,165,
0,153,153,153,0,0,0,0,0,
134,134,134,134,0,134,134,134,134,
0,128,128,128,0,128,128,128,128,
0,160,160,160,0,160,160,160,160,
0,0,0,0,0,148,148,148,148,
0,129,129,129,129,129,129,129,129,
124,124,124,0,124,0,0,0,0,
154,154,154,0,0,0,154,0,154,
142,142,0,0,142,0,142,0,0,
131,131,0,0,131,0,0,131,0,
120,120,120,0,120,120,0,0,120,
119,119,0,0,0,0,119,0,119,
108,108,0,0,108,0,108,0,0,
107,107,107,0,107,0,0,0,0,
0,0,0,0,106,0,106,106,0,
0,95,95,95,95,95,95,95,0,
0,0,0,0,0,0,0,94,0,
89,89,89,89,89,89,0,89,89,
92,92,92,92,0,0,0,92,92,
87,87,87,87,87,87,0,87,87,
90,90,90,90,0,90,0,0,0,
0,0,0,0,0,0,0,0,0,
0,0,0,0,0,0,0,0,0,
0,0,0,0,0,0,0,0,0.