[layer]
type=Tile Layer 1
data=
0,1,0,1,1,1,0,0,21,
0,1,0,3,1,1,5,1,21,
0,1,0,1,6,3,0,1,21,
0,1,0,4,3,1,21,1,0,
0,21,0,1,1,1,1,0,0,
4,1,1,5,1,1,1,1,21,
0,0,0,21,0,0,0,1,0,
5,1,21,3,1,1,0,1,1,
1,1,0,4,1,1,0,21,0,
1,21,1,1,1,0,0,0,5,
1,21,4,1,1,0,6,1,1,
0,0,1,1,6,0,0,21,0,
0,1,3,1,6,6,1,5,21,
0,21,0,0,1,1,1,1,0,
1,1,1,0,0,0,21,0,0,
1,1,3,1,1,1,4,1,21,
6,1,1,1,1,21,1,4,0,
1,1,1,3,1,21,0,0,1,
0,0,0,0,0,21,0,1,0,
0,1,1,1,21,1,5,1,1,
0,0,0,3,21,0,0,0,0,
1,3,21,1,1,1,4,4,1,
0,1,0,1,0,0,0,21,0,
0,1,0,1,0,1,1,5,21,
0,0,0,0,0,0,0,0,0,
0,0,0,0,0,0,0,0,0,
0,0,0,0,0,0,0,0,0.
[layer]
type=Tile Layer 2
data=
0,139,0,139,139,139,0,0,0,
0,137,0,137,137,137,137,137,0,
0,136,0,136,136,136,0,136,0,
0,110,0,110,110,110,0,110,0,
0,0,0,101,101,101,101,0,0,
83,83,83,83,83,83,83,83,0,
0,0,0,0,0,0,0,114,0,
100,100,0,100,100,100,0,100,100,
96,96,0,96,96,96,0,0,0,
87,0,87,87,87,0,0,0,87,
103,0,103,103,103,0,103,103,103,
0,0,99,99,99,0,0,0,0,
0,87,87,87,87,87,87,87,0,
0,0,0,0,83,83,83,83,0,
82,82,82,0,0,0,0,0,0,
67,67,67,67,67,67,67,67,0,
69,69,69,69,69,0,69,69,0,
72,72,72,72,72,0,0,0,72,
0,0,0,0,0,0,0,64,0,
0,60,60,60,0,60,60,60,60,
0,0,0,62,0,0,0,0,0,
56,56,0,56,56,56,56,56,56,
0,60,0,60,0,0,0,0,0,
0,59,0,59,0,59,59,59,0,
0,0,0,0,0,0,0,0,0,
0,0,0,0,0,0,0,0,0,
0,0,0,0,0,0,0,0,0.