[layer]
type=Tile Layer 1
data=
0,6,1,1,1,1,1,1,21,
1,1,1,1,1,1,21,1,0,
3,1,4,0,0,21,0,4,0,
1,1,0,0,0,1,5,21,0,
1,1,0,21,1,1,5,0,4,
1,1,1,0,0,21,6,0,1,
3,1,4,1,1,0,1,21,0,
1,1,1,21,0,0,0,0,0,
1,6,1,21,6,1,0,1,1,
21,1,4,1,1,1,1,1,1,
0,0,0,0,0,0,21,1,1,
1,1,1,5,21,4,0,1,6,
1,0,4,0,21,0,1,0,5,
1,21,1,1,1,0,1,0,1,
1,0,21,0,5,0,3,0,1,
1,0,1,21,1,0,5,0,1,
1,0,1,0,21,0,6,0,4,
1,21,1,1,1,6,1,0,1,
0,0,5,0,21,0,1,0,1,
1,1,6,21,1,0,1,1,1,
0,0,21,0,1,0,0,0,4,
0,0,21,1,1,3,1,6,0,
1,3,21,1,1,5,1,1,0,
0,1,21,1,0,0,0,0,0,
0,1,1,5,1,1,21,1,6,
0,1,1,1,1,1,21,1,0,
0,5,3,1,1,1,0,3,21,
0,1,1,3,1,1,0,1,21,
0,1,1,1,6,1,0,1,21,
0,1,0,4,0,0,21,4,0,
1,1,1,21,1,0,1,0,1,
1,5,1,21,0,0,1,0,0,
6,1,3,21,6,1,1,1,1,
0,21,0,0,0,0,0,0,1,
1,1,1,21,3,1,4,1,1,
6,1,1,21,1,4,1,0,1,
0,0,0,0,0,0,0,0,0,
0,0,0,0,0,0,0,0,0,
0,0,0,0,0,0,0,0,0.
[layer]
type=Tile Layer 2
data=
0,192,192,192,192,192,192,192,0,
191,191,191,191,191,191,0,191,0,
189,189,189,0,0,0,0,189,0,
153,153,0,0,0,153,153,0,0,
141,141,0,0,141,141,141,0,141,
129,129,129,0,0,0,129,0,129,
161,161,161,161,161,0,161,0,0,
148,148,148,0,0,0,0,0,0,
136,136,136,0,136,136,0,136,136,
0,118,118,118,118,118,118,118,118,
0,0,0,0,0,0,0,155,155,
143,143,143,143,0,143,0,143,143,
131,0,131,0,0,0,131,0,131,
120,0,120,120,120,0,120,0,120,
149,0,0,0,149,0,149,0,149,
138,0,138,0,138,0,138,0,138,
127,0,127,0,0,0,127,0,127,
115,0,115,115,115,115,115,0,115,
0,0,144,0,0,0,144,0,144,
133,133,133,0,133,0,133,133,133,
0,0,0,0,122,0,0,0,122,
0,0,0,111,111,111,111,111,0,
138,138,0,138,138,138,138,138,0,
0,127,0,127,0,0,0,0,0,
0,117,117,117,117,117,0,117,117,
0,107,107,107,107,107,0,107,0,
0,106,106,106,106,106,0,106,0,
0,96,96,96,96,96,0,96,0,
0,95,95,95,95,95,0,95,0,
0,94,0,94,0,0,0,94,0,
84,84,84,0,84,0,84,0,84,
83,83,83,0,0,0,83,0,0,
78,78,78,0,78,78,78,78,78,
0,0,0,0,0,0,0,0,81,
77,77,77,0,77,77,77,77,77,
79,79,79,0,79,79,79,0,79,
0,0,0,0,0,0,0,0,0,
0,0,0,0,0,0,0,0,0,
0,0,0,0,0,0,0,0,0.