[layer]
type=Tile Layer 1
data=
0,0,21,1,1,1,0,1,1,
1,1,21,1,1,1,1,1,1,
1,1,21,0,0,1,0,1,0,
1,1,21,1,1,1,1,1,0,
1,1,21,1,1,1,1,1,0,
1,1,21,1,1,1,1,1,0,
0,1,1,21,0,1,1,1,1,
0,0,0,1,21,0,0,1,1,
0,1,0,1,1,1,21,1,1,
0,0,21,0,1,1,1,1,0,
1,1,0,0,1,1,21,0,0,
1,1,21,0,0,0,1,1,0,
1,1,1,21,1,1,1,1,0,
1,1,1,21,0,0,0,0,0,
1,1,21,0,0,1,1,1,1,
0,1,21,1,1,1,1,1,0,
0,1,1,1,1,1,1,1,21,
1,0,21,0,0,0,0,1,0,
1,1,1,1,1,1,21,1,1,
1,1,1,1,21,1,0,1,1,
1,1,1,1,21,1,0,1,1,
1,1,1,1,21,1,0,1,1,
1,1,1,1,21,1,0,1,1,
0,0,0,0,0,1,0,21,0,
0,0,0,21,0,0,1,0,0,
1,1,1,1,1,21,1,1,1,
1,1,1,1,1,21,0,0,1,
1,1,1,1,1,21,1,0,1,
0,21,0,0,1,0,1,0,1,
1,1,1,1,1,1,1,21,1,
1,1,1,1,1,1,1,21,1,
1,21,0,0,1,1,0,1,1,
1,1,1,1,1,1,21,1,1,
1,1,1,1,1,0,1,21,0,
1,1,1,1,1,1,21,0,1,
1,1,1,0,21,0,1,0,1,
0,0,0,0,1,21,1,0,0,
1,0,1,0,21,0,1,0,0,
0,21,1,1,1,0,0,0,1,
1,0,0,0,0,21,1,0,0,
1,1,1,0,1,0,21,0,1,
1,1,1,0,1,21,1,0,0,
0,0,1,0,21,0,1,0,1,
1,21,1,1,1,0,1,0,1,
1,0,0,0,1,21,1,0,0,
1,21,1,1,1,1,1,0,1,
1,21,1,1,1,1,1,0,1,
1,21,1,1,1,1,1,0,1,
0,0,0,0,0,0,0,0,0,
0,0,0,0,0,0,0,0,0,
0,0,0,0,0,0,0,0,0.
[layer]
type=Tile Layer 2
data=
0,0,0,228,228,228,0,228,228,
216,216,0,216,216,216,216,216,216,
225,225,0,0,0,225,0,225,0,
183,183,0,183,183,183,183,183,0,
168,168,0,168,168,168,168,168,0,
154,154,0,154,154,154,154,154,0,
0,192,192,0,0,192,192,192,192,
0,0,0,178,0,0,0,178,178,
0,164,0,164,164,164,0,164,164,
0,0,0,0,149,149,149,149,0,
187,187,0,0,187,187,0,0,0,
173,173,0,0,0,0,173,173,0,
159,159,159,0,159,159,159,159,0,
145,145,145,0,0,0,0,0,0,
181,181,0,0,0,181,181,181,181,
0,167,0,167,167,167,167,167,0,
0,154,154,154,154,154,154,154,0,
141,0,0,0,0,0,0,141,0,
167,167,167,167,167,167,0,167,167,
162,162,162,162,0,162,0,162,162,
149,149,149,149,0,149,0,149,149,
136,136,136,136,0,136,0,136,136,
170,170,170,170,0,170,0,170,170,
0,0,0,0,0,157,0,0,0,
0,0,0,0,0,0,144,0,0,
126,126,126,126,126,0,126,126,126,
164,164,164,164,164,0,0,0,164,
152,152,152,152,152,0,152,0,152,
0,0,0,0,140,0,140,0,140,
121,121,121,121,121,121,121,0,121,
151,151,151,151,151,151,151,0,151,
147,0,0,0,147,147,0,147,147,
128,128,128,128,128,128,0,128,128,
123,123,123,123,123,0,123,0,0,
153,153,153,153,153,153,0,0,153,
141,141,141,0,0,0,141,0,141,
0,0,0,0,130,0,130,0,0,
119,0,119,0,0,0,119,0,0,
0,0,118,118,118,0,0,0,118,
107,0,0,0,0,0,107,0,0,
106,106,106,0,106,0,0,0,106,
105,105,105,0,105,0,105,0,0,
0,0,94,0,0,0,94,0,94,
93,0,93,93,93,0,93,0,93,
92,0,0,0,92,0,92,0,0,
91,0,91,91,91,91,91,0,91,
90,0,90,90,90,90,90,0,90,
89,0,89,89,89,89,89,0,89,
0,0,0,0,0,0,0,0,0,
0,0,0,0,0,0,0,0,0,
0,0,0,0,0,0,0,0,0.