[layer]
type=Tile Layer 1
data=
1,0,0,0,1,0,0,21,0,
1,1,1,1,1,21,1,1,1,
0,1,0,0,1,21,1,0,0,
1,1,1,0,1,21,1,0,1,
1,21,1,1,1,0,1,0,1,
1,0,1,21,1,1,1,0,1,
1,1,21,0,1,1,1,0,0,
1,0,21,1,1,1,1,3,5,
1,21,0,0,0,1,1,0,0,
1,1,1,1,21,1,1,0,1,
1,1,0,21,0,1,0,0,1,
1,1,1,1,21,1,1,0,0,
0,0,0,0,0,0,0,0,0,
0,0,0,0,0,0,0,0,0,
0,0,0,0,0,0,0,0,0.
[layer]
type=Tile Layer 2
data=
89,0,0,0,89,0,0,0,0,
57,57,57,57,57,0,57,57,57,
0,63,0,0,63,0,63,0,0,
62,62,62,0,62,0,62,0,62,
55,0,55,55,55,0,55,0,55,
54,0,54,0,54,54,54,0,54,
53,53,0,0,53,53,53,0,0,
50,0,0,50,50,50,50,50,50,
51,0,0,0,0,51,51,0,0,
48,48,48,48,0,48,48,0,48,
49,49,0,0,0,49,0,0,49,
48,48,48,48,0,48,48,0,0,
0,0,0,0,0,0,0,0,0,
0,0,0,0,0,0,0,0,0,
0,0,0,0,0,0,0,0,0.