[layer]
type=Tile Layer 1
data=
0,1,0,1,1,1,1,1,21,
1,1,21,1,1,1,1,1,0,
0,1,0,1,6,0,21,0,0,
1,1,21,0,0,0,1,6,4,
0,1,3,21,0,1,1,0,0,
0,0,1,1,21,1,1,21,0,
1,1,1,1,0,1,1,0,21,
0,1,0,0,0,1,0,21,1,
1,0,0,1,21,0,1,0,1,
0,0,0,0,0,0,0,0,0,
0,0,0,0,0,0,0,0,0,
0,0,0,0,0,0,0,0,0.
[layer]
type=Tile Layer 2
data=
0,76,0,76,76,76,76,76,0,
46,46,0,46,46,46,46,46,0,
0,47,0,47,47,0,0,0,0,
47,47,0,0,0,0,47,47,47,
0,46,46,0,0,46,46,0,0,
0,0,45,45,0,45,45,0,0,
43,43,43,43,0,43,43,0,0,
0,43,0,0,0,43,0,0,43,
42,0,0,42,0,0,42,0,42,
0,0,0,0,0,0,0,0,0,
0,0,0,0,0,0,0,0,0,
0,0,0,0,0,0,0,0,0.