[layer]
type=Tile Layer 1
data=
0,1,1,1,1,1,21,1,0,
0,0,0,1,1,1,21,1,0,
1,1,1,1,21,1,0,1,1,
0,1,0,1,21,1,1,0,0,
1,1,0,1,0,1,1,1,21,
1,1,0,0,21,1,0,1,0,
1,0,21,1,0,0,0,1,1,
1,21,1,1,0,1,1,1,1,
0,21,1,1,0,0,1,1,1,
0,0,1,1,1,0,0,21,1,
1,21,0,1,1,1,0,1,1,
1,21,1,1,1,0,0,1,1,
0,0,0,0,0,0,0,0,0,
0,0,0,0,0,0,0,0,0,
0,0,0,0,0,0,0,0,0.
[layer]
type=Tile Layer 2
data=
0,88,88,88,88,88,0,88,0,
0,0,0,63,63,63,0,63,0,
59,59,59,59,0,59,0,59,59,
0,61,0,61,0,61,61,0,0,
54,54,0,54,0,54,54,54,0,
53,53,0,0,0,53,0,53,0,
52,0,0,52,0,0,0,52,52,
49,0,49,49,0,49,49,49,49,
0,0,50,50,0,0,50,50,50,
0,0,49,49,49,0,0,0,49,
48,0,0,48,48,48,0,48,48,
47,0,47,47,47,0,0,47,47,
0,0,0,0,0,0,0,0,0,
0,0,0,0,0,0,0,0,0,
0,0,0,0,0,0,0,0,0.