[layer]
type=Tile Layer 1
data=
0,1,0,0,1,3,0,1,21,
1,1,1,4,6,21,1,1,1,
2,21,0,0,1,0,1,6,1,
8,2,1,4,1,21,6,1,1,
2,2,2,21,1,0,0,0,1,
1,2,8,21,1,1,5,0,2,
2,2,2,21,0,2,2,2,9,
6,1,1,1,21,1,0,2,2,
1,3,1,1,0,0,21,0,0,
1,6,1,21,1,0,1,1,0,
4,1,1,0,21,2,1,1,5,
2,2,2,2,9,2,21,2,0,
0,21,0,2,2,2,0,1,1,
0,3,0,0,1,0,0,21,2,
0,21,2,2,2,2,2,2,9,
1,21,3,0,5,1,1,0,2,
0,0,1,21,1,1,6,0,1,
3,0,1,21,1,1,1,0,1,
2,2,2,2,7,21,2,2,0,
1,1,1,21,1,1,2,2,1,
5,0,21,0,0,0,2,8,3,
1,1,2,2,2,21,2,2,1,
2,2,2,9,2,21,2,2,2,
1,1,2,2,2,21,5,1,3,
1,0,21,2,6,1,5,0,1,
2,21,9,2,2,2,2,2,2,
1,2,2,2,0,21,0,0,1,
1,1,5,21,5,1,1,0,1,
1,1,3,21,1,1,1,0,1,
6,1,3,1,6,1,1,21,1,
1,6,4,0,1,3,1,21,0,
1,1,2,21,2,1,1,1,0,
0,0,2,10,2,2,21,2,0,
0,0,2,0,21,2,10,0,0,
1,6,3,21,0,2,2,2,0,
1,1,1,21,1,0,0,0,1,
0,1,1,5,1,4,1,21,1,
0,21,1,1,1,3,5,0,0,
0,0,0,0,1,21,0,0,1,
1,0,0,21,0,1,6,1,1,
1,4,5,1,1,1,21,0,0,
0,0,0,0,0,21,2,0,0,
0,0,2,21,2,10,2,1,1,
4,10,2,1,21,2,2,1,1,
1,2,2,5,21,6,0,1,1,
5,2,2,1,21,1,0,3,1,
2,9,2,2,2,2,21,2,0,
1,2,2,1,21,1,1,1,4,
0,0,0,0,0,0,0,0,0,
0,0,0,0,0,0,0,0,0,
0,0,0,0,0,0,0,0,0.
[layer]
type=Tile Layer 2
data=
0,228,0,0,228,228,0,228,0,
216,216,216,216,216,0,216,216,216,
225,0,0,0,225,0,225,225,225,
183,183,183,183,183,0,183,183,183,
168,168,168,0,168,0,0,0,168,
154,154,154,0,154,154,154,0,154,
192,192,192,0,0,192,192,192,192,
178,178,178,178,0,178,0,178,178,
164,164,164,164,0,0,0,0,0,
149,149,149,0,149,0,149,149,0,
187,187,187,0,0,187,187,187,187,
173,173,173,173,173,173,0,173,0,
0,0,0,159,159,159,0,159,159,
0,145,0,0,145,0,0,0,145,
0,0,181,181,181,181,181,181,181,
167,0,167,0,167,167,167,0,167,
0,0,154,0,154,154,154,0,154,
141,0,141,0,141,141,141,0,141,
176,176,176,176,176,0,176,176,0,
154,154,154,0,154,154,154,154,154,
149,0,0,0,0,0,149,149,149,
130,130,130,130,130,0,130,130,130,
170,170,170,170,170,0,170,170,170,
150,150,150,150,150,0,150,150,150,
144,0,0,144,144,144,144,0,144,
132,0,132,132,132,132,132,132,132,
164,164,164,164,0,0,0,0,164,
152,152,152,0,152,152,152,0,152,
140,140,140,0,140,140,140,0,140,
121,121,121,121,121,121,121,0,121,
159,159,159,0,159,159,159,0,0,
147,147,147,0,147,147,147,147,0,
0,0,135,135,135,135,0,135,0,
0,0,123,0,0,123,123,0,0,
153,153,153,0,0,153,153,153,0,
141,141,141,0,141,0,0,0,141,
0,130,130,130,130,130,130,0,130,
0,0,119,119,119,119,119,0,0,
0,0,0,0,118,0,0,0,118,
107,0,0,0,0,107,107,107,107,
106,106,106,106,106,106,0,0,0,
0,0,0,0,0,0,105,0,0,
0,0,94,0,94,94,94,94,94,
93,93,93,93,0,93,93,93,93,
92,92,92,92,0,92,0,92,92,
91,91,91,91,0,91,0,91,91,
90,90,90,90,90,90,0,90,0,
85,85,85,85,0,85,85,85,85,
0,0,0,0,0,0,0,0,0,
0,0,0,0,0,0,0,0,0,
0,0,0,0,0,0,0,0,0.