[layer]
type=Tile Layer 1
data=
0,0,21,1,1,1,0,1,1,
1,1,0,5,4,1,21,1,1,
1,1,0,3,0,21,0,1,1,
1,0,4,4,21,1,1,1,1,
0,4,0,0,0,0,5,21,0,
0,1,3,5,1,3,0,1,21,
0,0,0,0,0,0,0,0,0,
0,0,0,0,0,0,0,0,0,
0,0,0,0,0,0,0,0,0.
[layer]
type=Tile Layer 2
data=
0,0,0,41,41,41,0,41,41,
38,38,0,38,38,38,0,38,38,
39,39,0,39,0,0,0,39,39,
37,0,37,37,0,37,37,37,37,
0,38,0,0,0,0,38,0,0,
0,37,37,37,37,37,0,37,0,
0,0,0,0,0,0,0,0,0,
0,0,0,0,0,0,0,0,0,
0,0,0,0,0,0,0,0,0.