[layer]
type=Tile Layer 1
data=
0,1,0,1,5,1,0,4,21,
1,1,21,0,0,1,1,4,0,
1,1,1,1,21,3,1,1,1,
1,1,21,1,0,1,0,1,0,
0,1,0,1,1,6,0,1,21,
0,1,0,1,0,3,0,4,21,
1,1,3,0,21,0,6,1,3,
1,1,1,0,1,21,0,0,5,
1,1,6,0,0,21,1,1,1,
1,3,1,4,1,21,0,0,3,
0,1,1,0,21,0,0,1,1,
0,1,1,1,1,1,0,21,0,
0,0,0,0,0,0,0,0,0,
0,0,0,0,0,0,0,0,0,
0,0,0,0,0,0,0,0,0.
[layer]
type=Tile Layer 2
data=
0,89,0,89,89,89,0,89,0,
64,64,0,0,0,64,64,64,0,
57,57,57,57,0,57,57,57,57,
62,62,0,62,0,62,0,62,0,
0,55,0,55,55,55,0,55,0,
0,54,0,54,0,54,0,54,0,
53,53,53,0,0,0,53,53,53,
52,52,52,0,52,0,0,0,52,
51,51,51,0,0,0,51,51,51,
50,50,50,50,50,0,0,0,50,
0,49,49,0,0,0,0,49,49,
0,48,48,48,48,48,0,0,0,
0,0,0,0,0,0,0,0,0,
0,0,0,0,0,0,0,0,0,
0,0,0,0,0,0,0,0,0.