[layer]
type=Tile Layer 1
data=
0,0,21,0,1,1,1,2,10,
5,0,3,21,0,1,1,2,2,
2,21,2,7,2,2,2,2,0,
1,1,21,0,1,0,0,0,0,
1,1,1,21,1,0,1,4,5,
2,7,2,2,2,21,2,2,0,
2,2,2,2,9,2,21,2,0,
1,1,3,2,2,2,21,1,0,
1,6,1,1,2,2,21,1,0,
1,0,1,21,2,10,2,0,1,
1,21,5,0,2,2,2,0,1,
0,21,6,0,2,2,1,0,1,
2,2,2,21,9,2,2,0,2,
0,0,0,2,2,2,0,21,0,
2,2,2,2,7,2,2,21,2,
2,9,2,2,2,2,21,0,2,
1,2,2,5,1,4,6,21,1,
1,1,1,21,1,1,1,0,1,
1,21,1,0,1,1,1,1,1,
0,21,7,2,2,2,2,2,2,
1,4,6,4,1,21,5,0,1,
1,0,0,21,1,0,1,0,0,
1,0,1,21,1,0,1,3,1,
0,0,1,21,6,0,0,0,5,
5,1,1,21,1,3,1,0,1,
1,0,1,0,21,0,0,0,1,
1,21,1,1,1,1,1,3,4,
0,0,0,21,0,1,0,1,1,
5,6,1,1,1,1,21,1,1,
0,0,0,3,0,0,0,0,21,
5,1,21,1,0,3,2,2,1,
0,2,2,2,21,2,2,9,2,
1,4,1,1,21,1,2,2,1,
0,0,0,0,0,0,0,0,0,
0,0,0,0,0,0,0,0,0,
0,0,0,0,0,0,0,0,0.
[layer]
type=Tile Layer 2
data=
0,0,0,0,170,170,170,170,170,
169,0,169,0,0,169,169,169,169,
167,0,167,167,167,167,167,167,0,
146,146,0,0,146,0,0,0,0,
134,134,134,0,134,0,134,134,134,
123,123,123,123,123,0,123,123,0,
112,112,112,112,112,112,0,112,0,
140,140,140,140,140,140,0,140,0,
129,129,129,129,129,129,0,129,0,
118,0,118,0,118,118,118,0,118,
108,0,108,0,108,108,108,0,108,
0,0,134,0,134,134,134,0,134,
124,124,124,0,124,124,124,0,124,
0,0,0,114,114,114,0,0,0,
103,103,103,103,103,103,103,0,103,
129,129,129,129,129,129,0,0,129,
113,113,113,113,113,113,113,0,113,
109,109,109,0,109,109,109,0,109,
99,0,99,0,99,99,99,99,99,
0,0,123,123,123,123,123,123,123,
113,113,113,113,113,0,113,0,113,
104,0,0,0,104,0,104,0,0,
95,0,95,0,95,0,95,95,95,
0,0,94,0,94,0,0,0,94,
85,85,85,0,85,85,85,0,85,
84,0,84,0,0,0,0,0,84,
79,0,79,79,79,79,79,79,79,
0,0,0,0,0,74,0,74,74,
70,70,70,70,70,70,0,70,70,
0,0,0,72,0,0,0,0,0,
71,71,0,71,0,71,71,71,71,
0,70,70,70,0,70,70,70,70,
66,66,66,66,0,66,66,66,66,
0,0,0,0,0,0,0,0,0,
0,0,0,0,0,0,0,0,0,
0,0,0,0,0,0,0,0,0.