[layer]
type=Tile Layer 1
data=
1,6,1,0,1,0,21,0,3,
1,2,8,2,21,1,1,0,1,
5,2,2,0,0,1,1,21,0,
2,2,7,21,2,2,2,2,0,
2,2,2,21,2,0,2,2,7,
5,1,0,21,2,0,1,1,1,
1,1,2,10,21,1,1,3,1,
0,0,2,2,2,0,0,0,21,
0,1,4,5,1,1,2,2,21,
0,0,0,0,0,0,21,8,0,
0,1,1,1,5,1,0,2,21,
0,2,2,2,1,1,0,4,21,
1,2,10,2,1,5,21,1,0,
0,2,2,2,1,1,21,3,0,
21,1,4,4,1,1,1,1,1,
6,1,6,1,1,21,1,1,1,
1,0,21,0,0,0,1,0,0,
4,1,1,21,1,1,5,0,1,
0,0,21,0,1,0,0,0,1,
2,21,1,1,1,0,4,1,3,
9,2,2,2,2,21,2,2,0,
2,2,1,21,1,1,1,1,6,
0,0,0,0,1,0,1,21,0,
4,3,1,1,1,21,2,2,4,
2,2,21,2,2,2,9,2,2,
0,1,21,0,0,2,0,2,0,
6,21,5,1,1,0,1,1,1,
1,21,0,0,1,0,3,1,4,
1,21,1,1,1,0,1,1,6,
7,2,2,21,2,2,2,2,0,
0,0,0,0,0,0,0,0,0,
0,0,0,0,0,0,0,0,0,
0,0,0,0,0,0,0,0,0.
[layer]
type=Tile Layer 2
data=
166,166,166,0,166,0,0,0,166,
164,164,164,164,0,164,164,0,164,
162,162,162,0,0,162,162,0,0,
112,112,112,0,112,112,112,112,0,
140,140,140,0,140,0,140,140,140,
129,129,0,0,129,0,129,129,129,
118,118,118,118,0,118,118,118,118,
0,0,108,108,108,0,0,0,0,
0,134,134,134,134,134,134,134,0,
0,0,0,0,0,0,0,124,0,
0,114,114,114,114,114,0,114,0,
0,103,103,103,103,103,0,103,0,
129,129,129,129,129,129,0,129,0,
0,119,119,119,119,119,0,119,0,
0,104,104,104,104,104,104,104,104,
94,94,94,94,94,0,94,94,94,
123,0,0,0,0,0,123,0,0,
113,113,113,0,113,113,113,0,113,
0,0,0,0,104,0,0,0,104,
95,0,95,95,95,0,95,95,95,
94,94,94,94,94,0,94,94,0,
81,81,81,0,81,81,81,81,81,
0,0,0,0,84,0,84,0,0,
79,79,79,79,79,0,79,79,79,
74,74,0,74,74,74,74,74,74,
0,73,0,0,0,73,0,73,0,
72,0,72,72,72,0,72,72,72,
71,0,0,0,71,0,71,71,71,
70,0,70,70,70,0,70,70,70,
69,69,69,0,69,69,69,69,0,
0,0,0,0,0,0,0,0,0,
0,0,0,0,0,0,0,0,0,
0,0,0,0,0,0,0,0,0.