[layer]
type=Tile Layer 1
data=
1,21,1,1,1,1,1,0,1,
1,1,1,21,0,1,1,1,1,
1,1,0,21,1,1,1,1,1,
1,0,0,1,21,1,0,1,0,
1,0,1,1,1,0,21,1,0,
0,0,21,1,1,1,1,1,1,
1,1,0,1,1,0,0,1,0,
1,0,21,1,0,1,1,1,21,
6,4,1,0,0,1,21,1,0,
0,0,0,0,0,0,0,0,0,
0,0,0,0,0,0,0,0,0,
0,0,0,0,0,0,0,0,0.
[layer]
type=Tile Layer 2
data=
75,0,75,75,75,75,75,0,75,
48,48,48,0,0,48,48,48,48,
47,47,0,0,47,47,47,47,47,
48,0,0,48,0,48,0,48,0,
48,0,48,48,48,0,0,48,0,
0,0,0,47,47,47,47,47,47,
46,46,0,46,46,0,0,46,0,
46,0,0,46,0,46,46,46,0,
44,44,44,0,0,44,0,44,0,
0,0,0,0,0,0,0,0,0,
0,0,0,0,0,0,0,0,0,
0,0,0,0,0,0,0,0,0.