[layer]
type=Tile Layer 1
data=
1,1,1,1,0,21,0,1,0,
1,1,1,1,1,1,1,1,21,
1,1,1,1,1,0,21,0,1,
1,1,1,1,1,21,1,0,0,
1,0,0,0,21,0,1,1,0,
0,0,1,1,1,1,1,1,21,
1,1,0,0,0,21,1,0,1,
1,1,1,1,1,21,1,0,1,
1,1,0,1,0,21,0,0,1,
1,1,21,1,0,1,1,1,1,
1,0,21,0,0,0,1,1,1,
0,21,1,1,1,0,1,1,1,
0,0,21,1,1,0,0,1,1,
1,1,21,1,1,1,0,0,0,
0,0,0,1,1,1,1,1,21,
0,0,1,0,1,21,0,0,1,
1,21,1,0,1,0,1,1,1,
1,0,0,21,1,0,1,0,0,
1,1,1,1,1,21,1,0,1,
0,0,1,0,1,21,0,0,1,
1,21,1,0,1,1,1,1,1,
0,0,1,21,0,0,1,0,0,
1,1,1,0,1,21,1,0,1,
1,0,1,0,1,21,0,0,1,
0,1,1,1,1,1,21,1,1,
1,1,1,1,1,1,21,1,1,
1,0,1,1,21,0,0,1,1,
21,1,1,1,1,1,1,1,1,
0,0,0,1,21,1,0,1,1,
1,1,21,1,0,1,0,1,1,
1,1,21,0,0,1,0,1,0,
1,1,21,1,1,1,0,1,1,
1,1,21,1,0,1,0,0,0,
0,1,21,1,1,1,0,1,1,
0,1,0,1,0,1,21,0,0,
1,1,1,1,21,1,1,1,1,
1,21,1,1,1,1,1,1,1,
1,0,1,1,1,21,0,0,1,
1,0,1,1,1,21,1,0,1,
0,0,0,0,0,0,0,0,0,
0,0,0,0,0,0,0,0,0,
0,0,0,0,0,0,0,0,0.
[layer]
type=Tile Layer 2
data=
198,198,198,198,0,0,0,198,0,
187,187,187,187,187,187,187,187,0,
195,195,195,195,195,0,0,0,195,
147,147,147,147,147,0,147,0,0,
134,0,0,0,0,0,134,134,0,
0,0,167,167,167,167,167,167,0,
154,154,0,0,0,0,154,0,154,
142,142,142,142,142,0,142,0,142,
130,130,0,130,0,0,0,0,130,
162,162,0,162,0,162,162,162,162,
149,0,0,0,0,0,149,149,149,
0,0,137,137,137,0,137,137,137,
0,0,0,125,125,0,0,125,125,
156,156,0,156,156,156,0,0,0,
0,0,0,144,144,144,144,144,0,
0,0,132,0,132,0,0,0,132,
121,0,121,0,121,0,121,121,121,
150,0,0,0,150,0,150,0,0,
139,139,139,139,139,0,139,0,139,
0,0,128,0,128,0,0,0,128,
116,0,116,0,116,116,116,116,116,
0,0,145,0,0,0,145,0,0,
134,134,134,0,134,0,134,0,134,
123,0,123,0,123,0,0,0,123,
0,112,112,112,112,112,0,112,112,
133,133,133,133,133,133,0,133,133,
128,0,128,128,0,0,0,128,128,
0,112,112,112,112,112,112,112,112,
0,0,0,108,0,108,0,108,108,
107,107,0,107,0,107,0,107,107,
97,97,0,0,0,97,0,97,0,
96,96,0,96,96,96,0,96,96,
95,95,0,95,0,95,0,0,0,
0,85,0,85,85,85,0,85,85,
0,84,0,84,0,84,0,0,0,
79,79,79,79,0,79,79,79,79,
78,0,78,78,78,78,78,78,78,
81,0,81,81,81,0,0,0,81,
80,0,80,80,80,0,80,0,80,
0,0,0,0,0,0,0,0,0,
0,0,0,0,0,0,0,0,0,
0,0,0,0,0,0,0,0,0.