[layer]
type=Tile Layer 1
data=
1,1,21,0,0,0,1,1,1,
1,1,1,1,1,21,0,0,0,
1,1,1,1,1,1,1,1,21,
1,1,1,1,1,1,21,0,1,
1,1,1,0,0,0,21,0,1,
1,1,1,21,0,1,0,0,0,
1,1,1,1,21,1,0,1,1,
1,1,1,1,21,1,0,0,1,
1,0,21,0,0,1,1,0,1,
1,0,1,1,1,21,0,1,1,
1,0,0,0,0,1,21,0,1,
1,21,0,1,1,1,1,0,1,
1,1,1,21,1,1,1,0,1,
0,0,0,0,1,21,1,0,1,
1,1,1,0,1,21,1,0,1,
0,0,1,0,0,0,1,21,0,
1,21,1,1,1,1,1,0,1,
1,0,1,0,0,21,1,0,1,
1,0,1,21,1,0,1,1,1,
1,0,1,0,1,21,0,0,1,
1,21,1,0,1,1,1,0,1,
1,1,1,21,1,1,1,1,1,
1,1,1,0,0,0,21,0,0,
1,1,1,21,1,1,1,1,1,
1,0,21,0,1,1,1,1,1,
1,1,1,21,1,1,1,1,1,
1,0,1,21,1,0,0,0,1,
1,21,1,0,1,1,1,0,1,
0,0,1,21,1,1,1,0,0,
1,1,1,21,1,1,1,1,1,
1,1,0,1,21,1,1,1,0,
1,1,0,1,21,1,1,1,0,
1,1,1,1,21,1,1,1,0,
0,0,0,0,21,0,0,1,0,
1,1,1,1,1,1,21,1,0,
0,0,0,0,0,1,21,1,0,
0,0,0,0,0,0,0,0,0,
0,0,0,0,0,0,0,0,0,
0,0,0,0,0,0,0,0,0.
[layer]
type=Tile Layer 2
data=
176,176,0,0,0,0,176,176,176,
175,175,175,175,175,0,0,0,0,
165,165,165,165,165,165,165,165,0,
140,140,140,140,140,140,0,0,140,
129,129,129,0,0,0,0,0,129,
118,118,118,0,0,118,0,0,0,
147,147,147,147,0,147,0,147,147,
135,135,135,135,0,135,0,0,135,
124,0,0,0,0,124,124,0,124,
113,0,113,113,113,0,0,113,113,
141,0,0,0,0,141,0,0,141,
130,0,0,130,130,130,130,0,130,
119,119,119,0,119,119,119,0,119,
0,0,0,0,109,0,109,0,109,
135,135,135,0,135,0,135,0,135,
0,0,125,0,0,0,125,0,0,
115,0,115,115,115,115,115,0,115,
104,0,104,0,0,0,104,0,104,
130,0,130,0,130,0,130,130,130,
120,0,120,0,120,0,0,0,120,
110,0,110,0,110,110,110,0,110,
95,95,95,0,95,95,95,95,95,
124,124,124,0,0,0,0,0,0,
109,109,109,0,109,109,109,109,109,
105,0,0,0,105,105,105,105,105,
91,91,91,0,91,91,91,91,91,
95,0,95,0,95,0,0,0,95,
86,0,86,0,86,86,86,0,86,
0,0,85,0,85,85,85,0,0,
80,80,80,0,80,80,80,80,80,
75,75,0,75,0,75,75,75,0,
74,74,0,74,0,74,74,74,0,
73,73,73,73,0,73,73,73,0,
0,0,0,0,0,0,0,72,0,
71,71,71,71,71,71,0,71,0,
0,0,0,0,0,70,0,70,0,
0,0,0,0,0,0,0,0,0,
0,0,0,0,0,0,0,0,0,
0,0,0,0,0,0,0,0,0.