[layer]
type=Tile Layer 1
data=
1,1,1,1,21,1,1,1,1,
1,1,1,1,21,1,1,1,1,
1,1,1,1,21,1,1,1,1,
0,1,1,1,1,1,21,1,1,
0,0,0,21,1,1,0,0,0,
1,1,1,0,0,0,21,1,0,
1,1,1,1,21,1,0,1,0,
1,1,1,1,1,0,21,0,0,
0,21,0,0,0,0,1,0,1,
1,0,21,1,1,1,1,0,1,
1,1,1,0,21,0,1,0,1,
1,1,1,21,1,1,0,0,0,
1,1,1,1,21,1,1,1,1,
1,1,1,1,21,1,1,1,1,
1,1,1,1,21,1,1,1,1,
0,1,0,0,0,1,0,21,0,
1,1,21,1,1,1,1,1,1,
0,1,1,1,21,0,0,0,1,
1,1,1,1,1,1,1,21,1,
0,0,0,1,1,1,21,0,1,
1,1,1,1,1,1,1,21,1,
1,1,21,1,0,1,1,1,1,
1,1,0,1,21,1,1,1,0,
1,1,21,1,1,1,1,1,0,
1,1,0,0,21,0,0,0,0,
1,1,21,1,1,1,0,1,1,
0,1,0,1,1,1,21,1,0,
1,1,1,1,1,1,21,1,1,
1,21,1,1,1,0,0,1,1,
1,1,21,1,1,1,1,1,1,
1,1,1,1,0,21,1,0,0,
1,1,1,1,21,1,1,1,0,
1,1,1,0,0,21,0,1,0,
0,21,0,0,1,1,0,1,0,
0,1,1,0,21,1,0,1,1,
0,1,1,1,0,21,0,1,1,
0,21,1,0,0,1,1,1,0,
0,1,1,1,1,0,1,21,0,
0,0,21,0,0,0,0,0,1,
1,1,21,1,1,1,1,1,1,
0,1,0,0,21,0,0,1,0,
1,1,1,1,1,21,1,1,1,
1,1,1,1,1,0,0,21,0,
1,1,1,1,1,1,1,21,1,
0,0,1,0,0,0,0,21,0,
0,0,0,0,0,0,0,0,0,
0,0,0,0,0,0,0,0,0,
0,0,0,0,0,0,0,0,0.
[layer]
type=Tile Layer 2
data=
198,198,198,198,0,198,198,198,198,
196,196,196,196,0,196,196,196,196,
194,194,194,194,0,194,194,194,194,
0,178,178,178,178,178,0,178,178,
0,0,0,0,165,165,0,0,0,
152,152,152,0,0,0,0,152,0,
138,138,138,138,0,138,0,138,0,
173,173,173,173,173,0,0,0,0,
0,0,0,0,0,0,160,0,160,
147,0,0,147,147,147,147,0,147,
134,134,134,0,0,0,134,0,134,
167,167,167,0,167,167,0,0,0,
147,147,147,147,0,147,147,147,147,
135,135,135,135,0,135,135,135,135,
123,123,123,123,0,123,123,123,123,
0,162,0,0,0,162,0,0,0,
142,142,0,142,142,142,142,142,142,
0,137,137,137,0,0,0,0,137,
119,119,119,119,119,119,119,0,119,
0,0,0,156,156,156,0,0,156,
137,137,137,137,137,137,137,0,137,
132,132,0,132,0,132,132,132,132,
121,121,0,121,0,121,121,121,0,
150,150,0,150,150,150,150,150,0,
139,139,0,0,0,0,0,0,0,
128,128,0,128,128,128,0,128,128,
0,116,0,116,116,116,0,116,0,
138,138,138,138,138,138,0,138,138,
134,0,134,134,134,0,0,134,134,
117,117,0,117,117,117,117,117,117,
112,112,112,112,0,0,112,0,0,
139,139,139,139,0,139,139,139,0,
128,128,128,0,0,0,0,128,0,
0,0,0,0,118,118,0,118,0,
0,108,108,0,0,108,0,108,108,
0,107,107,107,0,0,0,107,107,
0,0,97,0,0,97,97,97,0,
0,96,96,96,96,0,96,0,0,
0,0,0,0,0,0,0,0,95,
81,81,0,81,81,81,81,81,81,
0,84,0,0,0,0,0,84,0,
79,79,79,79,79,0,79,79,79,
82,82,82,82,82,0,0,0,0,
78,78,78,78,78,78,78,0,78,
0,0,80,0,0,0,0,0,0,
0,0,0,0,0,0,0,0,0,
0,0,0,0,0,0,0,0,0,
0,0,0,0,0,0,0,0,0.