[layer]
type=Tile Layer 1
data=
0,0,1,1,1,1,21,1,0,
1,0,4,1,1,1,0,21,0,
6,21,0,0,0,0,0,5,1,
1,6,1,3,1,0,3,21,0,
1,1,1,1,1,21,1,1,0,
1,1,5,21,0,1,1,5,0,
3,1,1,21,1,1,1,0,0,
1,5,6,1,21,1,0,1,5,
0,21,0,0,0,1,0,1,1,
1,21,6,1,1,0,3,1,1,
0,0,3,0,0,0,0,21,1,
1,4,1,21,1,1,1,1,1,
1,1,3,0,0,0,21,0,1,
1,6,5,21,5,1,1,1,1,
1,1,1,0,1,1,1,21,1,
1,1,1,21,4,1,1,1,5,
1,1,6,1,1,1,1,1,21,
1,21,1,1,1,1,4,1,1,
0,21,1,0,0,0,1,4,3,
0,1,1,1,0,0,21,0,0,
6,1,1,1,1,21,0,0,1,
6,1,3,1,1,21,0,1,1,
0,21,0,0,0,0,5,1,1,
0,0,0,21,0,0,1,1,1,
0,0,0,0,0,0,0,0,0,
0,0,0,0,0,0,0,0,0,
0,0,0,0,0,0,0,0,0.
[layer]
type=Tile Layer 2
data=
0,0,138,138,138,138,0,138,0,
136,0,136,136,136,136,0,0,0,
135,0,0,0,0,0,0,135,135,
109,109,109,109,109,0,109,0,0,
95,95,95,95,95,0,95,95,0,
90,90,90,0,0,90,90,90,0,
113,113,113,0,113,113,113,0,0,
99,99,99,99,0,99,0,99,99,
0,0,0,0,0,95,0,95,95,
82,0,82,82,82,0,82,82,82,
0,0,107,0,0,0,0,0,107,
89,89,89,0,89,89,89,89,89,
72,90,90,0,0,0,0,0,72,
62,62,78,0,78,78,78,3,62,
4,4,4,0,81,81,64,0,64,
55,55,55,0,69,55,55,3,55,
3,3,57,3,57,3,3,3,0,
51,0,51,51,64,51,51,51,51,
0,0,63,0,0,0,63,63,63,
0,62,62,62,0,0,0,0,0,
61,61,61,61,61,0,0,0,61,
57,57,57,57,57,0,0,57,57,
0,0,0,0,0,0,59,59,59,
0,0,0,0,0,0,58,58,58,
0,0,0,0,0,0,0,0,0,
0,0,0,0,0,0,0,0,0,
0,0,0,0,0,0,0,0,0.