[layer]
type=Tile Layer 1
data=
1,0,21,1,0,1,0,0,0,
1,1,1,1,21,1,1,1,1,
0,0,21,1,0,1,0,1,1,
1,1,0,1,21,1,0,1,1,
0,0,21,1,0,1,0,0,0,
1,1,1,1,0,1,1,1,21,
1,1,0,0,0,0,0,1,21,
0,1,1,1,1,1,21,1,0,
0,1,0,0,21,0,0,1,0,
0,0,1,0,1,21,1,1,1,
1,21,1,0,1,0,0,1,1,
1,0,21,1,0,0,1,1,1,
0,1,21,1,1,0,1,1,1,
0,1,21,0,0,0,1,1,1,
1,21,1,1,1,0,1,1,1,
0,0,0,0,0,0,0,0,0,
0,0,0,0,0,0,0,0,0,
0,0,0,0,0,0,0,0,0.
[layer]
type=Tile Layer 2
data=
108,0,0,108,0,108,0,0,0,
76,76,76,76,0,76,76,76,76,
0,0,0,83,0,83,0,83,83,
82,82,0,82,0,82,0,82,82,
0,0,0,74,0,74,0,0,0,
69,69,69,69,0,69,69,69,0,
72,72,0,0,0,0,0,72,0,
0,64,64,64,64,64,0,64,0,
0,63,0,0,0,0,0,63,0,
0,0,62,0,62,0,62,62,62,
61,0,61,0,61,0,0,61,61,
60,0,0,60,0,0,60,60,60,
0,59,0,59,59,0,59,59,59,
0,58,0,0,0,0,58,58,58,
55,0,55,55,55,0,55,55,55,
0,0,0,0,0,0,0,0,0,
0,0,0,0,0,0,0,0,0,
0,0,0,0,0,0,0,0,0.