[layer]
type=Tile Layer 1
data=
5,1,1,1,0,0,0,21,0,
0,21,4,1,1,0,0,6,0,
0,1,5,1,1,1,1,21,0,
0,1,1,1,3,4,1,21,1,
0,0,0,1,1,1,0,21,1,
5,1,21,1,1,1,0,1,4,
1,1,6,1,1,1,21,0,0,
1,5,1,1,21,0,1,3,0,
5,1,0,0,0,0,21,0,0,
3,1,21,1,1,1,6,3,0,
1,1,1,1,1,1,5,1,21,
0,0,0,0,0,1,0,0,21,
21,1,1,3,4,1,1,1,5,
0,1,0,0,1,0,1,0,21,
0,1,5,1,1,1,21,1,1,
0,1,4,3,1,1,21,1,0,
0,1,5,1,1,1,21,1,5,
0,1,0,1,0,0,0,0,21,
1,0,5,0,21,0,3,0,1,
1,21,1,1,6,1,1,0,1,
1,0,3,0,1,21,0,0,1,
1,21,1,0,1,0,1,1,1,
6,21,5,0,0,0,1,0,0,
1,21,1,0,4,5,1,0,1,
1,0,1,21,0,0,1,0,6,
1,0,1,3,1,21,1,0,4,
0,0,1,0,0,21,1,0,1,
0,1,21,1,3,5,1,1,1,
0,1,0,1,5,1,1,1,21,
0,3,21,1,1,4,1,1,1,
0,0,0,0,0,1,21,0,0,
1,4,1,1,21,5,1,1,0,
0,1,6,1,0,1,0,1,21,
0,0,0,0,0,0,0,0,0,
0,0,0,0,0,0,0,0,0,
0,0,0,0,0,0,0,0,0.
[layer]
type=Tile Layer 2
data=
170,170,170,170,0,0,0,0,0,
0,0,169,169,169,0,0,169,0,
0,167,167,167,167,167,167,0,0,
0,146,146,146,146,146,146,0,146,
0,0,0,134,134,134,0,0,134,
123,123,0,123,123,123,0,123,123,
112,112,112,112,112,112,0,0,0,
140,140,140,140,0,0,140,140,0,
129,129,0,0,0,0,0,0,0,
118,118,0,118,118,118,118,118,0,
103,103,103,103,103,103,103,103,0,
0,0,0,0,0,134,0,0,0,
0,118,118,118,118,118,118,118,118,
0,114,0,0,114,0,114,0,0,
0,103,103,103,103,103,0,103,103,
0,129,129,129,129,129,0,129,0,
0,119,119,119,119,119,0,119,119,
0,109,0,109,0,0,0,0,0,
99,0,99,0,0,0,99,0,99,
123,0,123,123,123,123,123,0,123,
113,0,113,0,113,0,0,0,113,
104,0,104,0,104,0,104,104,104,
95,0,95,0,0,0,95,0,0,
94,0,94,0,94,94,94,0,94,
85,0,85,0,0,0,85,0,85,
84,0,84,84,84,0,84,0,84,
0,0,83,0,0,0,83,0,83,
0,74,0,74,74,74,74,74,74,
0,73,0,73,73,73,73,73,0,
0,72,0,72,72,72,72,72,72,
0,0,0,0,0,71,0,0,0,
70,70,70,70,0,70,70,70,0,
0,69,69,69,0,69,0,69,0,
0,0,0,0,0,0,0,0,0,
0,0,0,0,0,0,0,0,0,
0,0,0,0,0,0,0,0,0.