[layer]
type=Tile Layer 1
data=
1,0,21,0,1,1,1,1,1,
0,0,1,21,1,1,1,1,1,
0,1,1,21,1,1,1,1,1,
0,1,1,21,1,1,1,1,1,
0,0,1,1,21,0,0,1,1,
1,1,21,1,1,1,0,1,1,
1,1,21,1,1,0,1,1,1,
1,1,21,0,1,0,1,1,1,
1,1,1,0,21,0,1,1,1,
0,1,1,1,21,1,1,1,0,
0,1,1,1,21,1,1,1,0,
0,1,0,0,0,1,1,1,21,
0,1,21,1,1,1,1,1,1,
0,1,0,1,21,1,0,0,0,
0,1,0,1,21,1,1,1,0,
0,1,0,1,0,1,21,0,0,
0,1,0,1,0,1,1,1,21,
0,1,0,0,21,1,1,1,0,
0,1,1,1,1,1,1,0,21,
0,1,1,1,1,1,0,21,0,
0,0,0,1,1,1,0,21,1,
1,1,0,0,1,1,21,0,1,
1,1,1,21,0,1,0,0,1,
1,1,1,1,21,0,1,0,1,
1,1,1,1,1,0,21,0,0,
1,1,1,1,1,1,21,1,0,
1,1,1,1,1,1,21,0,1,
1,1,1,21,1,1,1,0,0,
1,1,1,0,0,0,0,21,0,
1,1,1,1,1,1,1,1,21,
1,1,1,1,1,21,0,1,0,
1,1,1,1,1,21,1,1,0,
1,1,0,1,1,1,21,0,1,
1,1,21,0,1,1,1,0,1,
1,1,1,21,1,0,0,0,1,
0,21,1,1,1,0,1,1,1,
1,0,0,0,1,21,0,0,1,
1,21,1,1,1,1,1,0,1,
0,0,1,1,1,1,1,0,21,
1,21,1,1,1,1,1,0,1,
0,21,0,0,0,0,0,0,1,
1,21,1,1,1,1,1,1,1,
1,0,1,0,21,0,1,0,0,
1,21,1,1,1,0,1,0,1,
1,21,1,0,0,0,1,0,1,
1,1,1,21,1,1,1,1,0,
1,1,1,0,0,0,1,21,0,
1,1,1,1,1,21,1,0,1,
1,1,1,0,0,0,21,0,1,
1,1,0,0,1,21,0,1,1,
1,1,21,1,1,0,1,1,1,
0,0,0,0,0,0,0,0,0,
0,0,0,0,0,0,0,0,0,
0,0,0,0,0,0,0,0,0.
[layer]
type=Tile Layer 2
data=
234,0,0,0,234,234,234,234,234,
0,0,233,0,233,233,233,233,233,
0,231,231,0,231,231,231,231,231,
0,174,174,0,174,174,174,174,174,
0,0,159,159,0,0,0,159,159,
199,199,0,199,199,199,0,199,199,
184,184,0,184,184,0,184,184,184,
169,169,0,0,169,0,169,169,169,
155,155,155,0,0,0,155,155,155,
0,193,193,193,0,193,193,193,0,
0,179,179,179,0,179,179,179,0,
0,165,0,0,0,165,165,165,0,
0,150,0,150,150,150,150,150,150,
0,188,0,188,0,188,0,0,0,
0,174,0,174,0,174,174,174,0,
0,160,0,160,0,160,0,0,0,
0,146,0,146,0,146,146,146,0,
0,182,0,0,0,182,182,182,0,
0,168,168,168,168,168,168,0,0,
0,155,155,155,155,155,0,0,0,
0,0,0,142,142,142,0,0,142,
177,177,0,0,177,177,0,0,177,
163,163,163,0,0,163,0,0,163,
150,150,150,150,0,0,150,0,150,
137,137,137,137,137,0,0,0,0,
171,171,171,171,171,171,0,171,0,
158,158,158,158,158,158,0,0,158,
145,145,145,0,145,145,145,0,0,
133,133,133,0,0,0,0,0,0,
157,157,157,157,157,157,157,157,0,
153,153,153,153,153,0,0,153,0,
141,141,141,141,141,0,141,141,0,
128,128,0,128,128,128,0,0,128,
160,160,0,0,160,160,160,0,160,
148,148,148,0,148,0,0,0,148,
0,0,136,136,136,0,136,136,136,
124,0,0,0,124,0,0,0,124,
154,0,154,154,154,154,154,0,154,
0,0,142,142,142,142,142,0,0,
131,0,131,131,131,131,131,0,131,
0,0,0,0,0,0,0,0,120,
113,0,113,113,113,113,113,113,113,
108,0,108,0,0,0,108,0,0,
107,0,107,107,107,0,107,0,107,
106,0,106,0,0,0,106,0,106,
95,95,95,0,95,95,95,95,0,
94,94,94,0,0,0,94,0,0,
93,93,93,93,93,0,93,0,93,
92,92,92,0,0,0,0,0,92,
91,91,0,0,91,0,0,91,91,
90,90,0,90,90,0,90,90,90,
0,0,0,0,0,0,0,0,0,
0,0,0,0,0,0,0,0,0,
0,0,0,0,0,0,0,0,0.