[layer]
type=Tile Layer 1
data=
1,1,1,0,0,21,0,0,1,
1,1,1,21,1,0,0,0,0,
1,1,1,21,1,1,1,1,0,
0,1,1,1,1,21,1,1,1,
1,1,1,0,0,21,0,0,0,
1,1,1,21,1,1,1,1,0,
1,1,1,1,0,0,0,21,0,
1,1,0,0,1,1,21,0,1,
0,0,21,1,1,1,1,1,1,
1,1,21,1,1,1,0,0,0,
1,1,21,1,1,1,1,1,1,
1,1,0,21,0,0,0,0,0,
1,1,1,21,1,0,1,1,1,
1,21,1,0,1,0,0,0,1,
1,0,1,0,1,21,1,0,1,
1,0,1,0,21,0,1,0,0,
1,21,1,1,1,1,1,1,1,
0,0,1,0,0,0,0,21,1,
1,21,1,0,1,0,1,1,1,
1,0,1,21,1,0,0,0,1,
1,1,1,21,1,1,1,0,1,
0,1,1,1,1,1,21,0,0,
21,1,1,1,1,1,1,1,1,
0,1,1,1,1,1,21,0,0,
0,1,1,1,1,1,21,1,1,
0,1,0,0,1,1,0,0,21,
1,1,1,1,1,1,1,1,21,
0,21,0,1,0,1,1,1,0,
1,1,0,1,21,1,1,1,0,
0,0,0,1,0,1,21,0,0,
1,1,1,21,1,1,1,1,1,
1,1,1,0,0,21,0,0,0,
1,1,1,21,1,1,1,1,1,
0,0,21,0,1,1,1,1,1,
1,21,1,0,1,1,1,1,1,
1,0,1,0,21,0,0,0,0,
0,0,0,0,0,0,0,0,0,
0,0,0,0,0,0,0,0,0,
0,0,0,0,0,0,0,0,0.
[layer]
type=Tile Layer 2
data=
176,176,176,0,0,0,0,0,176,
175,175,175,0,175,0,0,0,0,
173,173,173,0,173,173,173,173,0,
0,140,140,140,140,0,140,140,140,
129,129,129,0,0,0,0,0,0,
118,118,118,0,118,118,118,118,0,
147,147,147,147,0,0,0,0,0,
135,135,0,0,135,135,0,0,135,
0,0,0,124,124,124,124,124,124,
113,113,0,113,113,113,0,0,0,
134,134,0,134,134,134,134,134,134,
130,130,0,0,0,0,0,0,0,
119,119,119,0,119,0,119,119,119,
109,0,109,0,109,0,0,0,109,
135,0,135,0,135,0,135,0,135,
125,0,125,0,0,0,125,0,0,
109,0,109,109,109,109,109,109,109,
0,0,104,0,0,0,0,0,104,
130,0,130,0,130,0,130,130,130,
120,0,120,0,120,0,0,0,120,
110,110,110,0,110,110,110,0,110,
0,100,100,100,100,100,0,0,0,
0,118,118,118,118,118,118,118,118,
0,114,114,114,114,114,0,0,0,
0,105,105,105,105,105,0,105,105,
0,96,0,0,96,96,0,0,0,
90,90,90,90,90,90,90,90,0,
0,0,0,86,0,86,86,86,0,
85,85,0,85,0,85,85,85,0,
0,0,0,84,0,84,0,0,0,
71,71,71,0,71,71,71,71,71,
74,74,74,0,0,0,0,0,0,
70,70,70,0,70,70,70,70,70,
0,0,0,0,72,72,72,72,72,
71,0,71,0,71,71,71,71,71,
70,0,70,0,0,0,0,0,0,
0,0,0,0,0,0,0,0,0,
0,0,0,0,0,0,0,0,0,
0,0,0,0,0,0,0,0,0.