[layer]
type=Tile Layer 1
data=
6,1,1,21,6,1,1,1,1,
0,0,21,0,1,1,1,1,1,
3,21,1,3,1,1,1,4,1,
1,1,1,4,1,21,0,1,0,
1,3,0,0,0,21,6,1,0,
3,1,21,1,0,0,0,1,0,
4,1,0,1,21,1,1,0,0,
6,0,0,1,21,1,0,0,1,
4,21,5,0,0,1,1,1,0,
0,21,0,3,0,1,1,1,0,
0,1,0,6,21,1,1,0,5,
0,21,0,0,0,0,1,0,1,
0,0,0,6,0,0,0,6,21,
0,1,3,1,1,1,21,1,1,
0,1,1,5,1,1,21,0,0,
0,1,1,5,1,3,21,1,1,
0,1,1,1,1,1,21,1,1,
3,6,1,5,1,6,21,1,1,
0,0,0,1,21,1,0,1,1,
1,6,4,1,21,5,0,1,1,
0,0,0,0,0,21,0,1,0,
1,6,1,3,1,21,1,1,1,
1,21,1,0,0,0,1,0,0,
3,1,1,1,6,21,1,1,5,
4,21,1,1,4,0,3,1,1,
1,21,0,0,1,0,1,1,1,
1,21,1,1,6,3,1,1,1,
1,0,1,0,21,0,1,4,1,
1,21,1,0,1,6,1,3,1,
4,0,1,0,0,0,21,0,0,
1,0,1,21,0,1,6,0,5,
1,0,1,0,1,1,0,21,0,
1,21,0,0,3,0,0,1,0,
6,0,1,0,1,1,21,0,0,
5,21,1,6,1,1,1,3,0,
1,1,0,0,1,21,0,0,0,
1,5,1,1,1,21,1,0,6,
1,21,0,0,1,1,1,0,1,
1,6,0,21,0,0,1,0,4,
1,1,4,1,1,21,1,1,1,
1,1,5,0,21,0,1,0,1,
1,1,1,1,1,4,5,21,6,
1,0,21,0,0,0,0,0,3,
1,1,6,21,1,1,1,1,1,
1,21,5,0,3,1,1,1,1,
0,0,0,0,0,0,0,0,0,
0,0,0,0,0,0,0,0,0,
0,0,0,0,0,0,0,0,0.
[layer]
type=Tile Layer 2
data=
198,198,198,0,198,198,198,198,198,
0,0,0,0,206,206,206,206,206,
194,0,194,194,194,194,194,194,194,
178,178,178,178,178,0,0,178,0,
165,165,0,0,0,0,165,165,0,
152,152,0,152,0,0,0,152,0,
138,138,0,138,0,138,138,0,0,
173,0,0,173,0,173,0,0,173,
160,0,160,0,0,160,160,160,0,
0,0,0,147,0,147,147,147,0,
0,134,0,134,0,134,134,0,134,
0,0,0,0,0,0,167,0,167,
0,0,0,154,0,0,0,154,0,
0,142,142,142,142,142,0,142,142,
0,130,130,130,130,130,0,0,0,
0,162,162,162,162,162,0,162,162,
0,149,149,149,149,149,0,149,149,
131,131,131,131,131,131,0,131,131,
0,0,0,125,0,125,0,125,125,
156,156,156,156,0,156,0,156,156,
0,0,0,0,0,0,0,144,0,
126,126,126,126,126,0,126,126,126,
121,0,121,0,0,0,121,0,0,
143,143,143,143,143,0,143,143,143,
139,0,139,139,139,0,139,139,139,
128,0,0,0,128,0,128,128,128,
111,0,111,111,111,111,111,111,111,
145,0,145,0,0,0,145,145,145,
134,0,134,0,134,134,134,134,134,
123,0,123,0,0,0,0,0,0,
112,0,112,0,0,112,112,0,112,
139,0,139,0,139,139,0,0,0,
128,0,0,0,128,0,0,128,0,
118,0,118,0,118,118,0,0,0,
108,0,108,108,108,108,108,108,0,
107,107,0,0,107,0,0,0,0,
97,97,97,97,97,0,97,0,97,
96,0,0,0,96,96,96,0,96,
95,95,0,0,0,0,95,0,95,
81,81,81,81,81,0,81,81,81,
84,84,84,0,0,0,84,0,84,
79,79,79,79,79,79,79,0,79,
82,0,0,0,0,0,0,0,82,
78,78,78,0,78,78,78,78,78,
80,0,80,0,80,80,80,80,80,
0,0,0,0,0,0,0,0,0,
0,0,0,0,0,0,0,0,0,
0,0,0,0,0,0,0,0,0.