[layer]
type=Tile Layer 1
data=
0,0,1,21,1,0,1,0,1,
1,1,1,21,1,0,1,1,1,
2,2,7,2,2,21,2,2,0,
0,1,21,1,1,1,2,10,1,
0,2,2,0,0,0,21,0,0,
1,2,8,2,0,1,1,21,0,
1,2,2,2,21,0,0,0,1,
1,1,1,1,21,0,0,1,1,
1,1,1,1,1,1,21,0,0,
1,1,1,1,21,0,0,2,0,
1,1,0,21,0,1,2,10,2,
1,1,21,1,1,1,2,2,8,
0,1,21,1,1,1,1,2,2,
0,1,21,1,0,0,0,0,0,
1,1,21,1,2,2,2,1,1,
0,21,2,2,2,9,2,2,2,
1,1,21,1,2,2,0,1,1,
0,2,2,7,21,2,2,2,2,
1,1,1,1,21,1,0,1,1,
1,1,1,1,21,1,0,0,0,
1,1,1,1,21,1,0,1,1,
0,0,1,1,0,21,1,1,1,
0,1,1,1,1,21,0,1,1,
0,0,1,1,1,1,21,1,1,
0,21,1,1,1,1,0,1,1,
0,1,1,1,2,2,21,0,1,
0,0,0,0,21,8,2,0,1,
0,0,0,0,0,0,0,0,0,
0,0,0,0,0,0,0,0,0,
0,0,0,0,0,0,0,0,0.
[layer]
type=Tile Layer 2
data=
0,0,160,0,160,0,160,0,160,
158,158,158,0,158,0,158,158,158,
157,157,157,157,157,0,157,157,0,
0,117,0,117,117,117,117,117,117,
0,107,107,0,0,0,0,0,0,
133,133,133,133,0,133,133,0,0,
123,123,123,123,0,0,0,0,123,
113,113,113,113,0,0,0,113,113,
102,102,102,102,102,102,0,0,0,
128,128,128,128,0,0,0,128,0,
118,118,0,0,0,118,118,118,118,
108,108,0,108,108,108,108,108,108,
0,98,0,98,98,98,98,98,98,
0,122,0,122,0,0,0,0,0,
107,107,0,107,107,107,107,107,107,
0,0,103,103,103,103,103,103,103,
94,94,0,94,94,94,0,94,94,
0,93,93,93,0,93,93,93,93,
84,84,84,84,0,84,0,84,84,
83,83,83,83,0,83,0,0,0,
82,82,82,82,0,82,0,82,82,
0,0,73,73,0,0,73,73,73,
0,72,72,72,72,0,0,72,72,
0,0,71,71,71,71,0,71,71,
0,0,70,70,70,70,0,70,70,
0,69,69,69,69,69,0,0,69,
0,0,0,0,0,68,68,0,68,
0,0,0,0,0,0,0,0,0,
0,0,0,0,0,0,0,0,0,
0,0,0,0,0,0,0,0,0.