[layer]
type=Tile Layer 1
data=
2,2,2,2,2,2,2,7,21,
1,1,1,1,0,0,0,21,0,
1,1,1,1,21,1,1,1,1,
1,1,1,1,1,0,21,0,1,
1,1,1,1,1,1,1,21,0,
1,1,1,1,1,0,21,0,0,
1,21,0,0,0,0,1,1,1,
1,21,1,1,1,1,1,1,1,
1,0,0,21,0,0,1,1,1,
1,1,1,1,1,0,21,0,0,
1,1,21,0,0,0,0,0,0,
1,2,21,2,1,1,1,1,1,
0,2,9,2,2,21,2,2,2,
0,2,2,0,21,0,1,1,1,
0,1,1,21,1,1,1,1,1,
0,2,2,21,0,0,1,1,1,
1,8,2,1,21,1,0,0,1,
1,2,2,1,21,1,1,0,1,
2,9,2,2,21,2,2,2,0,
1,2,2,2,21,1,1,1,0,
1,1,2,10,2,21,0,0,0,
1,1,2,2,0,21,0,0,1,
1,1,1,1,1,1,1,21,0,
2,7,2,2,2,2,21,2,0,
0,0,0,21,2,1,1,1,1,
0,21,2,8,2,1,1,1,1,
1,21,2,2,2,1,1,1,1,
1,21,1,1,1,1,1,1,1,
1,0,21,0,1,1,1,1,1,
1,1,1,21,1,1,1,1,1,
2,2,7,21,2,2,0,2,2,
1,1,1,0,1,21,0,1,1,
2,2,1,21,1,0,1,1,1,
9,2,2,2,2,2,2,21,0,
2,2,1,21,0,1,1,1,0,
0,21,0,0,1,1,1,1,0,
0,1,1,1,1,1,0,21,0,
0,0,0,0,1,1,1,1,21,
2,2,7,2,2,2,21,2,0,
1,1,1,21,1,1,1,0,1,
0,0,0,21,2,2,2,0,0,
2,2,1,1,2,8,2,21,1,
9,2,2,2,21,2,2,0,2,
2,2,1,1,1,21,1,1,1,
7,2,2,2,2,2,21,0,2,
1,2,8,2,1,21,1,1,1,
1,2,2,2,2,21,1,1,1,
1,1,1,2,8,21,1,1,1,
1,21,1,2,2,0,1,1,1,
0,0,2,21,0,0,1,1,0,
2,2,9,21,2,0,2,2,2,
1,2,2,21,1,0,1,0,0,
1,1,1,21,1,0,1,1,1,
1,1,1,21,1,0,0,0,1,
0,0,0,0,0,0,0,0,0,
0,0,0,0,0,0,0,0,0,
0,0,0,0,0,0,0,0,0.
[layer]
type=Tile Layer 2
data=
239,239,239,239,239,239,239,239,0,
237,237,237,237,0,0,0,0,0,
224,224,224,224,0,224,224,224,224,
164,164,164,164,164,0,0,0,164,
205,205,205,205,205,205,205,0,0,
189,189,189,189,189,0,0,0,0,
174,0,0,0,0,0,174,174,174,
152,0,152,152,152,152,152,152,152,
199,0,0,0,0,0,199,199,199,
184,184,184,184,184,0,0,0,0,
169,169,0,0,0,0,0,0,0,
147,147,0,147,147,147,147,147,147,
0,193,193,193,193,0,193,193,193,
0,179,179,0,0,0,179,179,179,
0,165,165,0,165,165,165,165,165,
0,150,150,0,0,0,150,150,150,
188,188,188,188,0,188,0,0,188,
174,174,174,174,0,174,174,0,174,
160,160,160,160,0,160,160,160,0,
146,146,146,146,0,146,146,146,0,
182,182,182,182,182,0,0,0,0,
168,168,168,168,0,0,0,0,168,
155,155,155,155,155,155,155,0,0,
142,142,142,142,142,142,0,142,0,
0,0,0,0,177,177,177,177,177,
0,0,163,163,163,163,163,163,163,
143,0,143,143,143,143,143,143,143,
131,0,131,131,131,131,131,131,131,
171,0,0,0,171,171,171,171,171,
151,151,151,0,151,151,151,151,151,
145,145,145,0,145,145,0,145,145,
133,133,133,0,133,0,0,133,133,
165,165,165,0,165,0,165,165,165,
153,153,153,153,153,153,153,0,0,
141,141,141,0,0,141,141,141,0,
0,0,0,0,128,128,128,128,0,
0,160,160,160,160,160,0,0,0,
0,0,0,0,148,148,148,148,0,
136,136,136,136,136,136,0,136,0,
124,124,124,0,124,124,124,0,124,
0,0,0,0,154,154,154,0,0,
142,142,142,142,142,142,142,0,142,
131,131,131,131,0,131,131,0,131,
114,114,114,114,114,0,114,114,114,
119,119,119,119,119,119,0,0,119,
108,108,108,108,108,0,108,108,108,
102,102,102,102,102,0,102,102,102,
106,106,106,106,106,0,106,106,106,
95,0,95,95,95,0,95,95,95,
0,0,94,0,0,0,94,94,0,
93,93,93,0,93,0,93,93,93,
92,92,92,0,92,0,92,0,0,
91,91,91,0,91,0,91,91,91,
90,90,90,0,90,0,0,0,90,
0,0,0,0,0,0,0,0,0,
0,0,0,0,0,0,0,0,0,
0,0,0,0,0,0,0,0,0.