[layer]
type=Tile Layer 1
data=
5,0,1,0,3,21,0,0,1,
1,21,4,0,1,3,1,1,1,
1,0,1,0,1,0,0,21,0,
1,1,1,21,1,5,1,1,1,
1,1,1,21,1,6,4,4,1,
1,1,5,21,6,1,1,1,1,
1,5,1,21,1,1,6,4,1,
1,1,1,21,1,1,1,6,1,
0,0,1,21,0,0,0,0,0,
0,0,1,1,1,0,0,21,0,
0,1,1,0,0,0,1,1,21,
0,4,1,0,21,5,1,3,0,
0,1,1,1,0,21,1,0,0,
0,0,21,0,1,1,1,0,1,
0,4,3,1,1,4,1,21,6,
0,21,0,1,6,1,1,0,0,
0,1,1,0,1,21,0,0,0,
0,21,4,0,0,1,1,1,3,
0,1,21,1,5,4,1,1,0,
0,4,3,1,1,1,1,1,21,
1,0,0,0,21,0,0,1,0,
1,5,1,3,1,1,21,1,1,
1,1,1,1,21,1,0,1,6,
1,1,1,3,21,1,0,6,5,
5,1,1,1,21,6,0,1,1,
1,1,1,3,21,6,0,1,1,
0,0,0,0,0,1,21,0,0,
0,0,0,0,0,0,1,21,0,
3,1,1,6,1,21,1,4,1,
4,1,1,1,1,21,0,0,1,
1,1,1,1,1,21,1,0,1,
0,0,0,0,4,21,6,0,5,
1,1,1,1,1,1,4,21,1,
1,3,1,1,4,1,1,21,1,
1,0,0,21,1,6,0,1,6,
1,1,1,1,3,1,21,1,1,
0,3,1,21,1,1,5,1,1,
0,0,1,0,21,0,1,1,1,
1,0,0,5,1,0,21,0,6,
1,1,0,21,1,6,1,0,0,
1,1,1,0,0,0,21,0,6,
4,1,1,1,1,21,5,1,0,
1,1,0,21,0,0,0,0,0,
0,0,1,21,4,0,0,0,1,
0,0,1,0,5,21,1,1,1,
0,0,0,6,1,3,21,0,0,
1,1,21,1,3,5,1,1,1,
1,1,21,1,1,1,0,0,0,
5,1,21,1,1,1,4,3,1,
1,0,0,0,0,21,0,1,1,
1,3,1,1,1,1,21,1,4,
0,0,0,0,0,0,0,0,0,
0,0,0,0,0,0,0,0,0,
0,0,0,0,0,0,0,0,0.
[layer]
type=Tile Layer 2
data=
234,0,234,0,234,0,0,0,234,
233,0,233,0,233,233,233,233,233,
231,0,231,0,231,0,0,0,0,
166,166,166,0,166,166,166,166,166,
152,152,152,0,152,152,152,152,152,
189,189,189,0,189,189,189,189,189,
175,175,175,0,175,175,175,175,175,
161,161,161,0,161,161,161,161,161,
0,0,155,0,0,0,0,0,0,
0,0,193,193,193,0,0,0,0,
0,179,179,0,0,0,179,179,0,
0,165,165,0,0,165,165,165,0,
0,150,150,150,0,0,150,0,0,
0,0,0,0,188,188,188,0,188,
0,174,174,174,174,174,174,0,174,
0,0,0,160,160,160,160,0,0,
0,146,146,0,146,0,0,0,0,
0,0,182,0,0,182,182,182,182,
0,168,0,168,168,168,168,168,0,
0,155,155,155,155,155,155,155,0,
142,0,0,0,0,0,0,142,0,
168,168,168,168,168,168,0,168,168,
163,163,163,163,0,163,0,163,163,
150,150,150,150,0,150,0,150,150,
137,137,137,137,0,137,0,137,137,
171,171,171,171,0,171,0,171,171,
0,0,0,0,0,158,0,0,0,
0,0,0,0,0,0,145,0,0,
127,127,127,127,127,0,127,127,127,
165,165,165,165,165,0,0,0,165,
153,153,153,153,153,0,153,0,153,
0,0,0,0,141,0,141,0,141,
122,122,122,122,122,122,122,0,122,
152,152,152,152,152,152,152,0,152,
148,0,0,0,148,148,0,148,148,
129,129,129,129,129,129,0,129,129,
0,124,124,0,124,124,124,124,124,
0,0,154,0,0,0,154,154,154,
142,0,0,142,142,0,0,0,142,
131,131,0,0,131,131,131,0,0,
120,120,120,0,0,0,0,0,120,
119,119,119,119,119,0,119,119,0,
108,108,0,0,0,0,0,0,0,
0,0,107,0,107,0,0,0,107,
0,0,106,0,106,0,106,106,106,
0,0,0,95,95,95,0,0,0,
90,90,0,90,90,90,90,90,90,
93,93,0,93,93,93,0,0,0,
88,88,0,88,88,88,88,88,88,
91,0,0,0,0,0,0,91,91,
86,86,86,86,86,86,0,86,86,
0,0,0,0,0,0,0,0,0,
0,0,0,0,0,0,0,0,0,
0,0,0,0,0,0,0,0,0.