[layer]
type=Tile Layer 1
data=
0,0,0,21,1,1,1,1,1,
0,1,1,21,1,1,1,1,1,
0,1,0,21,0,1,1,1,1,
0,0,1,1,0,21,1,1,1,
1,21,1,1,1,0,0,1,1,
1,21,1,1,1,1,0,1,1,
1,1,1,21,0,0,0,1,1,
0,21,0,0,0,0,1,1,1,
0,21,0,0,1,1,1,1,1,
0,0,0,21,0,1,1,0,1,
1,1,1,1,1,1,1,21,1,
1,0,0,21,0,0,1,0,1,
1,21,1,1,1,0,1,1,1,
1,21,1,1,1,0,0,0,0,
1,21,1,1,1,1,1,1,1,
1,21,0,0,1,0,1,1,1,
1,21,1,1,1,0,1,1,1,
1,21,1,1,1,0,1,1,1,
1,0,1,21,1,1,1,0,1,
0,0,1,0,1,21,0,0,1,
1,1,1,21,1,0,1,0,1,
1,21,0,0,1,0,1,0,1,
1,21,1,1,1,1,1,0,1,
0,0,1,0,0,0,1,21,1,
1,1,1,21,1,0,1,0,1,
1,21,0,0,1,0,0,0,1,
1,21,1,1,1,1,1,1,1,
0,1,1,1,0,0,0,1,21,
1,1,1,1,1,1,1,1,21,
0,0,0,0,21,1,1,1,0,
1,1,1,1,21,1,1,1,0,
0,0,0,1,0,1,1,1,21,
1,1,21,1,0,1,1,1,1,
0,0,0,0,0,0,0,0,0,
0,0,0,0,0,0,0,0,0,
0,0,0,0,0,0,0,0,0.
[layer]
type=Tile Layer 2
data=
0,0,0,0,170,170,170,170,170,
0,169,169,0,169,169,169,169,169,
0,167,0,0,0,167,167,167,167,
0,0,146,146,0,0,146,146,146,
134,0,134,134,134,0,0,134,134,
123,0,123,123,123,123,0,123,123,
112,112,112,0,0,0,0,112,112,
0,0,0,0,0,0,140,140,140,
0,0,0,0,129,129,129,129,129,
0,0,0,0,0,118,118,0,118,
103,103,103,103,103,103,103,0,103,
134,0,0,0,0,0,134,0,134,
124,0,124,124,124,0,124,124,124,
114,0,114,114,114,0,0,0,0,
99,0,99,99,99,99,99,99,99,
129,0,0,0,129,0,129,129,129,
119,0,119,119,119,0,119,119,119,
109,0,109,109,109,0,109,109,109,
99,0,99,0,99,99,99,0,99,
0,0,123,0,123,0,0,0,123,
113,113,113,0,113,0,113,0,113,
104,0,0,0,104,0,104,0,104,
95,0,95,95,95,95,95,0,95,
0,0,94,0,0,0,94,0,94,
85,85,85,0,85,0,85,0,85,
84,0,0,0,84,0,0,0,84,
79,0,79,79,79,79,79,79,79,
0,74,74,74,0,0,0,74,0,
70,70,70,70,70,70,70,70,0,
0,0,0,0,0,72,72,72,0,
71,71,71,71,0,71,71,71,0,
0,0,0,70,0,70,70,70,0,
69,69,0,69,0,69,69,69,69,
0,0,0,0,0,0,0,0,0,
0,0,0,0,0,0,0,0,0,
0,0,0,0,0,0,0,0,0.