[layer]
type=Tile Layer 1
data=
8,2,5,4,0,21,0,0,0,
2,2,5,6,0,0,21,0,0,
4,4,6,1,0,21,1,5,0,
6,3,4,6,3,21,0,0,0,
2,2,1,6,21,0,0,0,0,
10,2,4,4,1,0,0,21,0,
0,2,21,1,2,2,2,3,5,
0,0,0,0,21,8,0,0,0,
0,4,1,4,21,2,2,3,5,
0,6,3,3,0,0,0,0,21,
5,1,5,1,21,3,0,1,6,
0,0,21,2,2,1,5,3,6,
0,5,2,8,21,3,4,1,1,
0,4,2,2,0,4,0,2,21,
3,3,21,5,1,5,2,8,3,
5,2,2,21,0,0,2,2,0,
1,8,2,1,6,21,0,4,6,
4,10,2,5,5,1,21,0,6,
5,2,2,5,1,1,6,21,0,
6,1,3,3,1,21,6,1,0,
7,2,2,2,2,21,2,2,1,
1,4,2,10,2,21,6,6,1,
5,1,21,2,1,1,1,6,1,
5,21,1,4,2,2,2,4,0,
0,21,0,0,2,10,2,6,1,
0,21,4,6,0,2,2,5,4,
1,21,1,0,0,6,5,5,4,
5,21,3,0,0,6,1,2,2,
2,2,2,2,2,21,0,2,9,
2,2,2,2,2,7,2,21,0,
1,4,1,6,6,6,21,5,1,
4,1,4,1,1,21,5,4,1,
5,4,6,5,21,1,1,1,1,
1,5,21,1,5,4,4,6,1,
0,2,2,2,2,7,2,21,2,
4,5,21,1,4,6,6,1,0,
6,4,0,0,0,21,0,0,0,
3,6,21,3,1,4,6,6,1,
1,3,0,4,0,0,0,21,0,
4,1,21,4,5,5,3,5,3,
0,4,0,1,0,0,21,0,0,
4,1,21,5,4,1,3,3,0,
1,4,21,0,5,6,6,0,0,
2,2,21,2,7,2,2,2,0,
0,0,0,5,5,4,4,21,1,
2,2,2,2,2,7,2,21,0,
1,6,1,3,21,3,0,6,3,
6,5,6,21,0,1,5,0,5,
0,0,0,0,0,0,0,0,0,
0,0,0,0,0,0,0,0,0,
0,0,0,0,0,0,0,0,0.
[layer]
type=Tile Layer 2
data=
212,212,212,212,0,0,0,0,0,
211,211,211,211,0,0,0,0,0,
209,209,209,209,0,0,209,209,0,
170,170,170,170,170,0,0,0,0,
156,156,156,156,0,0,0,0,0,
143,143,143,143,143,0,0,0,0,
0,178,0,178,178,178,178,178,178,
0,0,0,0,0,165,0,0,0,
0,152,152,152,0,152,152,152,152,
0,138,138,138,0,0,0,0,0,
173,173,173,173,0,173,0,173,173,
0,0,0,160,160,160,160,160,160,
0,147,147,147,0,147,147,147,147,
0,134,134,134,0,134,0,134,0,
167,167,0,167,167,167,167,167,167,
154,154,154,0,0,0,154,154,0,
142,142,142,142,142,0,0,142,142,
130,130,130,104,104,6,0,0,130,
162,162,162,129,8,8,162,0,0,
149,149,149,119,7,0,149,149,0,
110,110,110,110,110,0,110,110,6,
100,100,100,100,100,0,100,100,6,
125,7,0,125,7,7,125,125,7,
144,0,144,144,144,144,144,144,0,
0,0,0,0,132,132,132,132,132,
0,0,121,121,0,121,121,121,121,
150,0,150,0,0,150,150,150,150,
139,0,139,0,0,139,139,139,139,
128,128,128,128,128,0,0,128,128,
116,116,116,116,116,116,116,0,0,
116,116,116,116,116,116,0,116,7,
107,107,107,107,6,0,107,107,6,
98,98,98,98,0,6,6,6,6,
90,90,0,90,90,90,90,90,5,
0,139,139,139,139,139,139,0,139,
128,128,0,128,128,128,128,128,0,
118,118,0,0,0,0,0,0,0,
103,103,0,103,103,103,103,103,103,
107,107,0,107,0,0,0,0,0,
92,92,0,92,92,92,92,92,92,
0,96,0,96,0,0,0,0,0,
95,95,0,95,95,95,95,95,0,
85,85,0,0,85,85,85,0,0,
84,84,0,84,84,84,84,84,0,
0,0,0,83,83,83,83,0,83,
82,82,82,82,82,82,82,0,0,
81,81,81,81,0,81,0,81,81,
80,80,80,0,0,80,80,0,80,
0,0,0,0,0,0,0,0,0,
0,0,0,0,0,0,0,0,0,
0,0,0,0,0,0,0,0,0.