[layer]
type=Tile Layer 1
data=
1,0,0,0,21,0,1,1,1,
1,1,1,1,1,21,1,1,1,
0,21,1,0,1,0,1,1,1,
1,1,1,1,21,0,0,1,1,
1,1,1,0,21,1,0,0,0,
1,1,1,0,21,0,1,1,0,
1,1,1,1,1,0,1,21,0,
1,1,1,1,1,21,1,1,0,
1,1,0,0,0,0,0,21,0,
1,1,21,0,1,1,1,1,1,
1,1,1,0,0,21,0,0,0,
1,1,1,0,0,0,21,0,0,
1,1,21,1,1,1,1,1,0,
0,0,0,0,0,1,0,0,21,
1,1,21,1,1,1,1,1,0,
1,1,0,0,0,0,21,0,0,
1,1,21,1,1,1,1,1,1,
1,1,0,1,0,21,0,0,0,
0,0,0,0,0,0,0,0,0,
0,0,0,0,0,0,0,0,0,
0,0,0,0,0,0,0,0,0.
[layer]
type=Tile Layer 2
data=
128,0,0,0,0,0,128,128,128,
114,114,114,114,114,0,114,114,114,
0,0,125,0,125,0,125,125,125,
86,86,86,86,0,0,0,86,86,
107,107,107,0,0,107,0,0,0,
98,98,98,0,0,0,98,98,0,
90,90,90,90,90,0,90,0,0,
78,78,78,78,78,0,78,78,0,
81,81,0,0,0,0,0,0,0,
69,69,0,0,69,69,69,69,69,
72,72,72,0,0,0,0,0,0,
71,71,71,0,0,0,0,0,0,
60,60,0,60,60,60,60,60,0,
0,0,0,0,0,62,0,0,0,
58,58,0,58,58,58,58,58,0,
60,60,0,0,0,0,0,0,0,
54,54,0,54,54,54,54,54,54,
58,58,0,58,0,0,0,0,0,
0,0,0,0,0,0,0,0,0,
0,0,0,0,0,0,0,0,0,
0,0,0,0,0,0,0,0,0.