[layer]
type=Tile Layer 1
data=
1,4,1,1,1,21,0,0,0,
1,1,1,6,1,5,5,1,21,
1,1,1,1,1,1,1,6,21,
1,1,1,1,5,1,21,0,0,
0,2,2,21,2,2,2,2,7,
0,6,1,21,1,3,1,1,1,
0,2,2,21,1,1,1,5,1,
0,2,8,0,0,0,21,0,0,
1,2,2,2,1,6,2,8,21,
0,2,21,1,1,3,2,2,1,
10,2,21,0,0,1,0,0,1,
2,2,5,1,0,0,1,21,0,
1,1,1,1,3,21,0,0,0,
1,1,1,1,5,1,21,0,4,
2,2,2,2,2,7,21,0,2,
1,6,1,1,0,0,21,0,0,
3,0,21,0,0,1,1,1,0,
1,0,1,5,1,1,5,21,0,
0,0,1,0,4,21,1,0,0,
1,6,1,0,1,21,1,0,1,
2,2,2,2,7,21,2,0,2,
1,21,6,0,1,0,1,0,1,
4,0,1,0,0,21,2,2,5,
1,21,1,1,2,8,10,2,1,
0,0,1,21,2,2,2,0,1,
1,1,1,21,6,2,2,2,5,
2,21,2,0,2,2,9,2,2,
2,2,1,21,5,0,2,2,6,
9,2,2,21,2,2,2,2,0,
2,2,1,1,1,1,1,21,1,
1,21,6,1,1,1,1,0,1,
1,21,1,1,1,3,1,0,4,
3,0,1,21,0,0,0,0,0,
2,7,2,21,2,2,2,2,2,
1,4,1,21,1,0,1,5,1,
1,3,2,21,2,0,1,1,1,
0,2,21,9,2,2,2,2,2,
0,1,0,2,2,5,21,1,0,
0,1,4,1,1,1,21,1,1,
0,0,0,0,0,21,0,1,0,
1,2,2,2,21,1,0,1,3,
6,2,8,2,21,1,0,1,1,
0,0,0,0,0,0,0,0,0,
0,0,0,0,0,0,0,0,0,
0,0,0,0,0,0,0,0,0.
[layer]
type=Tile Layer 2
data=
203,203,203,203,203,0,0,0,0,
191,191,191,191,191,191,191,191,0,
190,190,190,190,190,190,190,190,0,
138,138,138,138,138,138,0,0,0,
0,173,173,0,173,173,173,173,173,
0,160,160,0,160,160,160,160,160,
0,147,147,0,147,147,147,147,147,
0,134,134,0,0,0,0,0,0,
167,167,167,167,167,167,167,167,0,
0,154,0,154,154,154,154,154,154,
142,142,0,0,0,142,0,0,142,
130,130,130,130,0,0,130,0,0,
162,162,162,162,162,0,0,0,0,
149,149,149,149,149,149,0,0,149,
137,137,137,137,137,137,0,0,137,
125,125,125,125,0,0,0,0,0,
156,0,0,0,0,156,156,156,0,
144,0,144,144,144,144,144,0,0,
0,0,132,0,132,0,132,0,0,
121,121,121,0,121,0,121,0,121,
150,150,150,150,150,0,150,0,150,
139,0,139,0,139,0,139,0,139,
128,0,128,0,0,0,128,128,128,
116,0,116,116,116,116,116,116,116,
0,0,145,0,145,145,145,0,145,
127,127,127,0,127,127,127,127,127,
123,0,123,0,123,123,123,123,123,
112,112,112,0,112,0,112,112,112,
139,139,139,0,139,139,139,139,0,
122,122,122,122,122,122,122,0,122,
118,0,118,118,118,118,118,0,118,
108,0,108,108,108,108,108,0,108,
107,0,107,0,0,0,0,0,0,
97,97,97,0,97,97,97,97,97,
96,96,96,0,96,0,96,96,96,
95,95,95,0,95,0,95,95,95,
0,85,0,85,85,85,85,85,85,
0,84,0,84,84,84,0,84,0,
0,83,83,83,83,83,0,83,83,
0,0,0,0,0,0,0,82,0,
81,81,81,81,0,81,0,81,81,
80,80,80,80,0,80,0,80,80,
0,0,0,0,0,0,0,0,0,
0,0,0,0,0,0,0,0,0,
0,0,0,0,0,0,0,0,0.