[layer]
type=Tile Layer 1
data=
1,1,1,1,1,1,21,1,1,
1,1,1,1,21,24,0,1,1,
2,2,1,1,21,1,1,1,1,
20,2,2,2,2,2,0,2,21,
0,0,0,0,21,1,0,1,0,
0,1,1,1,21,1,1,1,1,
0,1,1,1,21,1,0,0,0,
18,2,2,2,2,2,21,2,2,
0,1,1,1,0,21,0,1,0,
18,2,2,2,2,2,21,2,2,
0,1,0,0,0,1,21,0,0,
0,1,1,1,0,1,1,1,21,
1,0,0,0,21,1,0,0,1,
1,1,1,1,0,21,2,24,1,
1,1,1,1,1,0,1,21,0,
1,1,1,1,1,0,0,21,0,
0,21,0,0,0,0,0,1,1,
0,1,1,1,1,21,0,1,1,
0,0,0,0,0,0,0,0,0,
0,0,0,0,0,0,0,0,0,
0,0,0,0,0,0,0,0,0.
[layer]
type=Tile Layer 2
data=
116,116,116,116,116,116,0,116,116,
127,127,127,127,0,0,0,127,127,
113,113,113,113,0,113,113,113,113,
0,86,86,86,86,86,0,86,0,
0,0,0,0,0,107,0,107,0,
0,94,94,94,0,94,94,94,94,
0,90,90,90,0,90,0,0,0,
0,78,78,78,78,78,0,78,78,
0,81,81,81,0,0,0,81,0,
0,69,69,69,69,69,0,69,69,
0,72,0,0,0,72,0,0,0,
0,71,71,71,0,71,71,71,0,
63,0,0,0,0,63,0,0,63,
62,62,62,62,0,0,62,0,62,
61,61,61,61,61,0,61,0,0,
60,60,60,60,60,0,0,0,0,
0,0,0,0,0,0,0,59,59,
0,58,58,58,58,0,0,58,58,
0,0,0,0,0,0,0,0,0,
0,0,0,0,0,0,0,0,0,
0,0,0,0,0,0,0,0,0.