[layer]
type=Tile Layer 1
data=
1,0,0,1,1,1,21,0,1,
0,20,2,2,2,2,2,2,21,
0,2,2,1,1,1,6,4,21,
0,21,0,0,0,1,1,6,0,
2,2,2,2,21,2,2,18,2,
1,1,1,0,0,0,4,21,1,
1,6,0,0,1,1,1,21,1,
0,0,0,1,1,4,5,21,0,
24,2,1,2,2,2,1,1,21,
0,3,21,2,19,0,0,0,0,
1,1,1,2,21,2,0,2,0,
1,1,21,1,0,1,0,2,24,
0,1,0,1,0,6,4,1,21,
0,0,0,1,0,21,0,1,0,
0,1,3,1,5,1,21,6,4,
0,0,0,0,0,0,0,0,0,
0,0,0,0,0,0,0,0,0,
0,0,0,0,0,0,0,0,0.
[layer]
type=Tile Layer 2
data=
108,0,0,108,108,108,0,0,108,
0,0,84,84,84,84,84,84,0,
0,79,79,79,79,79,79,79,0,
0,0,0,0,0,82,82,82,0,
70,70,70,70,0,70,70,0,70,
73,73,73,0,0,0,73,0,73,
72,72,0,0,72,72,72,0,72,
0,0,0,64,64,64,64,0,0,
0,60,60,60,60,60,60,60,0,
0,62,0,62,0,0,0,0,0,
61,61,61,61,0,61,0,61,0,
60,60,0,60,0,60,0,60,0,
0,59,0,59,0,59,59,59,0,
0,0,0,58,0,0,0,58,0,
0,55,55,55,55,55,0,55,55,
0,0,0,0,0,0,0,0,0,
0,0,0,0,0,0,0,0,0,
0,0,0,0,0,0,0,0,0.