[layer]
type=Tile Layer 1
data=
1,21,0,0,0,0,0,0,1,
1,1,1,1,1,21,1,1,1,
1,1,1,1,1,21,0,0,1,
1,1,1,1,1,21,1,1,1,
1,1,1,1,1,21,1,1,1,
1,1,1,1,1,21,1,1,1,
1,0,0,21,1,1,0,0,0,
1,21,1,1,1,1,1,1,0,
1,0,21,0,1,1,1,1,0,
1,1,1,0,21,1,1,0,0,
1,0,0,1,1,0,21,1,0,
1,0,0,0,1,1,21,0,0,
1,1,1,1,1,21,1,1,0,
0,0,0,0,0,0,1,1,21,
0,21,0,0,1,0,0,1,1,
1,21,0,0,0,0,0,0,1,
1,1,1,21,1,1,1,0,1,
0,0,1,0,1,0,1,21,1,
1,1,1,1,1,21,1,1,1,
1,0,0,1,21,1,0,1,0,
1,1,1,1,21,1,1,1,1,
1,1,1,1,21,0,1,1,1,
1,1,1,1,1,21,1,1,1,
1,1,1,1,1,0,0,21,0,
0,0,21,0,0,0,1,0,0,
1,1,1,21,1,1,1,0,1,
1,1,1,21,0,0,1,0,1,
1,1,1,1,1,21,1,0,1,
0,0,21,0,1,0,0,0,1,
1,1,1,21,1,1,1,1,1,
1,1,1,21,1,1,1,1,1,
1,1,1,21,1,1,1,1,1,
1,1,1,21,1,1,1,1,1,
1,1,1,0,0,0,0,21,0,
1,1,21,0,1,1,1,1,0,
1,1,0,21,1,1,0,0,0,
1,0,21,0,1,1,0,1,0,
1,0,1,1,0,0,0,21,0,
0,1,1,1,21,1,0,1,1,
0,0,0,0,21,1,0,1,1,
1,21,1,0,1,0,0,1,1,
1,0,0,21,1,0,1,1,1,
1,1,1,1,21,1,1,1,1,
0,0,21,1,0,1,1,1,1,
1,1,1,1,21,1,1,1,1,
1,1,1,1,0,0,0,21,0,
1,1,1,1,21,1,1,1,1,
0,0,0,1,0,1,0,21,0,
0,0,0,0,0,0,0,0,0,
0,0,0,0,0,0,0,0,0,
0,0,0,0,0,0,0,0,0.
[layer]
type=Tile Layer 2
data=
229,0,0,0,0,0,0,0,229,
217,217,217,217,217,0,217,217,217,
226,226,226,226,226,0,0,0,226,
175,175,175,175,175,0,175,175,175,
161,161,161,161,161,0,161,161,161,
147,147,147,147,147,0,147,147,147,
193,0,0,0,193,193,0,0,0,
179,0,179,179,179,179,179,179,0,
165,0,0,0,165,165,165,165,0,
150,150,150,0,0,150,150,0,0,
188,0,0,188,188,0,0,188,0,
174,0,0,0,174,174,0,0,0,
160,160,160,160,160,0,160,160,0,
0,0,0,0,0,0,146,146,0,
0,0,0,0,182,0,0,182,182,
168,0,0,0,0,0,0,0,168,
155,155,155,0,155,155,155,0,155,
0,0,142,0,142,0,142,0,142,
168,168,168,168,168,0,168,168,168,
163,0,0,163,0,163,0,163,0,
143,143,143,143,0,143,143,143,143,
137,137,137,137,0,0,137,137,137,
163,163,163,163,163,0,163,163,163,
158,158,158,158,158,0,0,0,0,
0,0,0,0,0,0,145,0,0,
133,133,133,0,133,133,133,0,133,
165,165,165,0,0,0,165,0,165,
153,153,153,153,153,0,153,0,153,
0,0,0,0,141,0,0,0,141,
122,122,122,0,122,122,122,122,122,
152,152,152,0,152,152,152,152,152,
141,141,141,0,141,141,141,141,141,
129,129,129,0,129,129,129,129,129,
124,124,124,0,0,0,0,0,0,
154,154,0,0,154,154,154,154,0,
142,142,0,0,142,142,0,0,0,
131,0,0,0,131,131,0,131,0,
120,0,120,120,0,0,0,0,0,
0,119,119,119,0,119,0,119,119,
0,0,0,0,0,108,0,108,108,
107,0,107,0,107,0,0,107,107,
106,0,0,0,106,0,106,106,106,
91,91,91,91,0,91,91,91,91,
0,0,0,94,0,94,94,94,94,
89,89,89,89,0,89,89,89,89,
92,92,92,92,0,0,0,0,0,
87,87,87,87,0,87,87,87,87,
0,0,0,90,0,90,0,0,0,
0,0,0,0,0,0,0,0,0,
0,0,0,0,0,0,0,0,0,
0,0,0,0,0,0,0,0,0.