[layer]
type=Tile Layer 1
data=
1,1,1,21,1,0,1,1,1,
1,21,1,0,1,0,1,0,1,
1,21,1,1,1,0,1,0,1,
0,0,0,0,21,0,1,0,0,
2,21,2,2,2,2,2,7,2,
1,21,8,2,1,1,2,24,1,
1,21,2,0,1,1,2,24,2,
0,0,0,21,1,1,1,0,8,
1,1,1,1,1,2,2,21,2,
2,2,0,21,2,2,20,2,2,
1,10,2,0,0,0,21,0,1,
2,2,2,0,18,2,2,21,0,
1,1,1,1,0,0,21,0,0,
1,1,1,0,21,0,1,1,1,
1,1,1,21,1,0,1,1,1,
1,2,2,2,1,0,21,0,0,
1,2,8,0,21,1,0,0,0,
2,2,2,2,21,2,18,2,2,
0,2,10,2,1,1,21,1,0,
0,2,0,21,0,0,0,1,0,
1,1,1,1,2,2,2,1,21,
0,21,2,2,2,9,2,2,2,
1,1,21,1,2,2,0,2,1,
0,0,0,2,21,2,20,0,0,
0,0,0,0,0,0,0,0,0,
0,0,0,0,0,0,0,0,0,
0,0,0,0,0,0,0,0,0.
[layer]
type=Tile Layer 2
data=
131,131,131,0,131,0,131,131,131,
136,0,136,0,136,0,136,0,136,
135,0,135,135,135,0,135,0,135,
0,0,0,0,0,0,109,0,0,
95,0,95,95,95,95,95,95,95,
90,0,90,90,90,90,90,0,90,
113,0,113,0,113,113,113,0,113,
0,0,0,0,104,104,104,0,104,
86,86,86,86,86,86,86,0,86,
86,86,0,0,86,86,0,86,86,
107,107,107,0,0,0,0,0,107,
98,98,98,0,0,98,98,0,0,
90,90,90,90,0,0,0,0,0,
82,82,82,0,0,0,82,82,82,
77,77,77,0,77,0,77,77,77,
73,73,73,73,73,0,0,0,0,
72,72,72,0,0,72,0,0,0,
67,67,67,67,0,67,0,67,67,
0,63,63,63,63,63,0,63,0,
0,62,0,0,0,0,0,62,0,
55,55,55,55,55,55,55,55,0,
0,0,60,60,60,60,60,60,60,
57,57,0,57,57,57,0,57,57,
0,0,0,58,0,58,0,0,0,
0,0,0,0,0,0,0,0,0,
0,0,0,0,0,0,0,0,0,
0,0,0,0,0,0,0,0,0.