[layer]
type=Tile Layer 1
data=
1,21,0,1,0,0,1,1,3,
0,21,5,1,1,1,1,6,1,
1,1,21,0,1,1,0,0,0,
1,3,1,0,1,1,21,5,1,
1,1,1,21,6,1,0,1,1,
1,6,1,0,0,21,0,0,1,
0,1,21,0,1,1,0,1,0,
1,6,0,1,1,1,21,5,1,
1,3,5,6,0,0,0,3,21,
1,3,0,4,21,6,6,4,0,
0,1,0,6,4,1,1,1,21,
0,1,21,0,0,1,0,1,1,
0,0,0,0,0,0,0,0,0,
0,0,0,0,0,0,0,0,0,
0,0,0,0,0,0,0,0,0.
[layer]
type=Tile Layer 2
data=
88,0,0,88,0,0,88,88,88,
0,0,59,59,59,59,59,59,59,
62,62,0,0,62,62,0,0,0,
58,58,58,0,58,58,0,58,58,
51,51,51,0,51,51,0,51,51,
53,53,53,0,0,0,0,0,53,
0,52,0,0,52,52,0,52,0,
49,49,0,49,49,49,0,49,49,
50,50,50,50,0,0,0,50,0,
49,49,0,49,0,49,49,49,0,
0,48,0,48,48,48,48,48,0,
0,47,0,0,0,47,0,47,47,
0,0,0,0,0,0,0,0,0,
0,0,0,0,0,0,0,0,0,
0,0,0,0,0,0,0,0,0.