[layer]
type=Tile Layer 1
data=
1,1,6,1,4,0,0,21,0,
6,1,1,1,1,21,1,3,0,
1,1,1,1,1,1,0,21,0,
1,0,21,1,1,1,1,1,0,
4,21,0,0,0,0,0,0,0,
4,1,21,1,3,1,0,1,6,
1,5,21,4,1,1,0,0,0,
1,1,0,0,0,0,0,21,0,
2,2,21,2,2,18,2,2,2,
1,1,1,1,0,21,0,0,0,
1,3,1,2,2,21,4,1,1,
0,0,0,21,20,0,0,2,2,
21,1,1,2,2,2,1,1,1,
18,2,0,2,0,2,21,2,2,
0,2,24,2,0,1,21,4,5,
0,5,0,1,21,0,0,3,0,
0,2,0,1,21,1,1,6,0,
0,19,0,1,0,1,1,1,21,
0,21,2,0,6,0,1,0,1,
0,0,2,1,1,5,1,21,1,
0,20,0,2,2,2,21,0,2,
0,21,2,1,1,1,4,0,1,
21,3,1,1,1,1,1,5,1,
18,2,0,2,2,2,0,2,21,
0,0,0,0,0,0,0,0,0,
0,0,0,0,0,0,0,0,0,
0,0,0,0,0,0,0,0,0.
[layer]
type=Tile Layer 2
data=
138,138,138,138,138,0,0,0,0,
130,130,130,130,130,0,130,130,0,
135,135,135,135,135,135,0,0,0,
109,0,0,109,109,109,109,109,0,
100,0,0,0,0,0,0,0,0,
86,86,0,86,86,86,0,86,86,
113,113,0,113,113,113,0,0,0,
104,104,0,0,0,0,0,0,0,
90,90,0,90,90,0,90,90,90,
86,86,86,86,0,0,0,0,0,
97,97,97,97,97,0,97,97,97,
0,0,0,0,0,0,0,98,98,
0,81,81,81,81,81,81,81,81,
0,82,0,82,0,82,0,82,82,
0,81,0,81,0,81,0,81,81,
0,73,0,73,0,0,0,73,0,
0,72,0,72,0,72,72,72,0,
0,0,0,71,0,71,71,71,0,
0,0,63,0,63,0,63,0,63,
0,0,62,62,62,62,62,0,62,
0,0,0,61,61,61,0,0,61,
0,0,60,60,60,60,60,0,60,
0,54,54,54,54,54,54,54,54,
0,58,0,58,58,58,0,58,0,
0,0,0,0,0,0,0,0,0,
0,0,0,0,0,0,0,0,0,
0,0,0,0,0,0,0,0,0.