[layer]
type=Tile Layer 1
data=
1,1,1,1,1,21,1,1,1,
1,21,0,0,0,0,0,0,0,
1,1,1,21,1,1,1,1,1,
0,1,1,0,21,1,1,1,0,
0,1,1,0,0,1,1,1,21,
0,0,1,1,21,1,1,1,0,
0,1,0,1,1,1,1,21,0,
0,1,0,1,21,0,1,0,1,
0,21,1,0,1,0,0,0,0,
1,0,0,1,1,21,1,1,0,
1,1,1,1,0,1,21,0,0,
0,0,0,21,0,1,1,1,0,
0,0,0,1,0,1,1,1,21,
1,1,1,1,21,1,1,1,0,
0,0,21,0,0,1,0,0,0,
1,1,1,21,1,1,1,1,1,
0,21,1,0,0,0,1,0,1,
1,1,1,1,21,1,1,1,1,
0,1,1,1,21,1,1,1,1,
21,1,1,1,1,1,1,1,1,
0,1,1,1,21,1,1,1,1,
1,21,1,0,1,1,1,1,1,
1,21,1,0,1,1,1,1,1,
1,0,21,0,1,1,1,1,1,
1,1,1,21,1,1,1,1,1,
1,1,1,0,0,21,0,0,0,
1,1,1,1,1,1,1,21,1,
0,21,1,1,0,0,0,0,1,
1,21,1,0,1,1,1,1,1,
1,21,1,0,1,1,1,1,1,
1,1,1,1,21,1,0,1,1,
1,1,0,0,21,1,0,1,1,
0,0,0,1,1,0,0,21,0,
0,21,1,1,1,1,0,1,0,
1,0,0,0,1,1,21,0,1,
1,1,1,0,1,1,1,21,0,
1,1,1,21,1,1,1,1,0,
1,1,1,0,0,21,0,0,0,
1,1,1,0,0,21,0,0,0,
1,1,1,21,1,1,1,1,1,
1,1,1,0,0,21,0,0,0,
1,1,1,21,1,1,1,1,1,
1,21,0,0,1,1,1,1,1,
1,1,1,21,1,1,1,1,1,
1,0,1,0,1,21,0,0,1,
0,0,0,0,0,0,0,0,0,
0,0,0,0,0,0,0,0,0,
0,0,0,0,0,0,0,0,0.
[layer]
type=Tile Layer 2
data=
198,198,198,198,198,0,198,198,198,
206,0,0,0,0,0,0,0,0,
194,194,194,0,194,194,194,194,194,
0,178,178,0,0,178,178,178,0,
0,165,165,0,0,165,165,165,0,
0,0,152,152,0,152,152,152,0,
0,138,0,138,138,138,138,0,0,
0,173,0,173,0,0,173,0,173,
0,0,160,0,160,0,0,0,0,
147,0,0,147,147,0,147,147,0,
134,134,134,134,0,134,0,0,0,
0,0,0,0,0,167,167,167,0,
0,0,0,154,0,154,154,154,0,
142,142,142,142,0,142,142,142,0,
0,0,0,0,0,130,0,0,0,
154,154,154,0,154,154,154,154,154,
0,0,149,0,0,0,149,0,149,
131,131,131,131,0,131,131,131,131,
0,125,125,125,0,125,125,125,125,
0,148,148,148,148,148,148,148,148,
0,144,144,144,0,144,144,144,144,
132,0,132,0,132,132,132,132,132,
121,0,121,0,121,121,121,121,121,
150,0,0,0,150,150,150,150,150,
132,132,132,0,132,132,132,132,132,
128,128,128,0,0,0,0,0,0,
111,111,111,111,111,111,111,0,111,
0,0,145,145,0,0,0,0,145,
134,0,134,0,134,134,134,134,134,
123,0,123,0,123,123,123,123,123,
112,112,112,112,0,112,0,112,112,
139,139,0,0,0,139,0,139,139,
0,0,0,128,128,0,0,0,0,
0,0,118,118,118,118,0,118,0,
108,0,0,0,108,108,0,0,108,
107,107,107,0,107,107,107,0,0,
97,97,97,0,97,97,97,97,0,
96,96,96,0,0,0,0,0,0,
95,95,95,0,0,0,0,0,0,
81,81,81,0,81,81,81,81,81,
84,84,84,0,0,0,0,0,0,
79,79,79,0,79,79,79,79,79,
82,0,0,0,82,82,82,82,82,
78,78,78,0,78,78,78,78,78,
80,0,80,0,80,0,0,0,80,
0,0,0,0,0,0,0,0,0,
0,0,0,0,0,0,0,0,0,
0,0,0,0,0,0,0,0,0.