[layer]
type=Tile Layer 1
data=
1,1,1,1,3,21,1,2,24,
2,2,2,2,0,21,0,2,18,
0,0,0,0,21,1,5,0,0,
0,21,1,3,1,1,1,0,0,
3,0,21,0,0,1,1,0,0,
1,1,1,6,21,1,5,0,1,
1,1,5,6,0,21,0,2,0,
1,1,3,1,1,21,24,2,0,
6,1,1,1,0,21,1,2,0,
0,0,0,0,0,2,2,21,20,
0,0,1,1,1,1,1,2,21,
2,21,1,1,4,1,3,5,0,
20,0,0,0,21,2,2,2,2,
0,0,21,6,2,24,2,4,1,
1,1,1,0,0,0,0,21,0,
1,21,5,0,1,0,1,0,1,
6,0,21,0,5,0,1,0,0,
3,1,1,1,2,21,2,1,1,
1,21,0,0,2,24,0,0,1,
1,21,4,1,6,3,1,0,1,
1,0,21,0,0,0,1,0,1,
1,1,2,21,2,1,4,0,1,
0,0,0,24,2,0,0,21,1,
1,1,1,21,1,0,3,1,6,
1,1,1,6,1,21,1,1,4,
0,0,1,0,1,1,21,6,0,
1,1,1,1,5,5,21,1,1,
1,1,1,1,4,1,21,1,1,
0,0,0,1,21,6,0,0,0,
3,4,0,1,21,2,0,2,1,
2,2,0,21,0,2,20,2,2,
1,1,1,4,1,2,21,2,1,
1,6,21,0,0,0,0,0,0,
1,1,21,1,1,1,1,4,0,
1,1,5,1,3,1,4,1,21,
0,0,21,1,3,1,1,1,0,
1,5,1,1,1,6,1,1,21,
0,0,0,0,0,0,0,1,21,
20,2,2,2,2,2,2,2,21,
0,0,0,0,0,0,0,0,0,
0,0,0,0,0,0,0,0,0,
0,0,0,0,0,0,0,0,0.
[layer]
type=Tile Layer 2
data=
197,197,197,197,197,0,197,197,0,
195,195,195,195,0,0,0,195,0,
0,0,0,0,0,194,194,0,0,
0,0,146,146,146,146,146,0,0,
133,0,0,0,0,133,133,0,0,
166,166,166,166,0,166,166,0,166,
153,153,153,153,0,0,0,153,0,
141,141,141,141,141,0,0,141,0,
129,129,129,129,0,0,129,129,0,
0,0,0,0,0,161,161,0,0,
0,0,148,148,148,148,148,148,0,
136,0,136,136,136,136,136,136,0,
0,0,0,0,0,124,124,124,124,
0,0,0,155,155,0,155,155,155,
143,143,143,0,0,0,0,0,0,
131,0,131,0,131,0,131,0,131,
120,0,0,0,120,0,120,0,0,
142,142,142,142,142,0,142,142,142,
138,0,0,0,138,0,0,0,138,
127,0,127,127,127,127,127,0,127,
115,0,0,0,0,0,115,0,115,
144,144,144,0,144,144,144,0,144,
0,0,0,0,133,0,0,0,133,
122,122,122,0,122,0,122,122,122,
106,106,106,106,106,0,106,106,106,
0,0,138,0,138,138,0,138,0,
121,121,121,121,121,121,0,121,121,
111,111,111,111,111,111,0,111,111,
0,0,0,107,0,107,0,0,0,
106,106,0,106,0,106,0,106,106,
96,96,0,0,0,96,0,96,96,
90,90,90,90,90,90,0,90,90,
94,94,0,0,0,0,0,0,0,
84,84,0,84,84,84,84,84,0,
79,79,79,79,79,79,79,79,0,
0,0,0,82,82,82,82,82,0,
77,77,77,77,77,77,77,77,0,
0,0,0,0,0,0,0,80,0,
0,79,79,79,79,79,79,79,0,
0,0,0,0,0,0,0,0,0,
0,0,0,0,0,0,0,0,0,
0,0,0,0,0,0,0,0,0.