[layer]
type=Tile Layer 1
data=
1,3,1,0,21,0,1,5,1,
4,1,1,0,21,0,1,1,1,
1,1,3,1,5,21,1,1,1,
0,0,1,0,1,21,1,0,1,
1,21,1,0,1,0,6,0,1,
1,21,5,0,1,0,5,0,4,
1,0,1,0,6,21,1,0,6,
4,0,0,21,1,0,0,0,1,
1,1,1,1,1,21,5,1,1,
3,0,0,21,1,0,1,1,6,
1,21,1,1,6,0,1,4,1,
1,21,1,0,0,0,1,0,0,
0,21,0,1,1,5,1,1,6,
1,1,21,1,1,1,1,6,1,
5,1,21,0,0,1,3,1,1,
1,1,1,21,0,1,1,1,6,
6,5,1,0,0,21,0,0,0,
1,4,1,1,1,1,0,21,0,
0,0,0,0,0,0,21,1,1,
0,21,1,1,1,1,1,1,1,
1,21,6,6,4,1,3,1,1,
1,1,4,1,3,0,0,21,0,
1,6,1,1,1,21,0,0,0,
1,1,1,1,1,1,3,21,0,
1,4,1,1,1,1,6,21,0,
6,5,1,1,1,0,21,1,0,
1,1,1,1,21,0,1,5,0,
0,0,0,21,0,1,3,5,0,
0,1,1,1,1,6,1,0,21,
0,21,0,0,1,1,1,0,1,
0,4,21,0,0,1,0,3,1,
1,1,21,1,1,1,0,1,1,
0,1,0,4,0,0,21,1,6,
1,1,21,1,0,1,1,1,1,
0,5,21,4,0,0,0,0,0,
0,3,21,1,1,1,1,1,5,
0,3,0,21,0,0,0,0,0,
21,1,6,1,6,1,1,1,1,
0,1,1,21,1,1,0,1,5,
3,1,1,1,21,1,1,1,1,
1,1,1,4,21,1,5,1,3,
0,0,0,21,0,1,1,1,4,
21,1,3,1,1,5,4,1,1,
0,21,0,0,0,0,1,1,1,
0,0,0,1,1,0,21,0,0,
0,0,0,0,0,0,0,0,0,
0,0,0,0,0,0,0,0,0,
0,0,0,0,0,0,0,0,0.
[layer]
type=Tile Layer 2
data=
208,208,208,0,0,0,208,208,208,
206,206,206,0,0,0,206,206,206,
194,194,194,194,194,0,194,194,194,
0,0,178,0,178,0,178,0,178,
165,0,165,0,165,0,165,0,165,
152,0,152,0,152,0,152,0,152,
138,0,138,0,138,0,138,0,138,
173,0,0,0,173,0,0,0,173,
152,152,152,152,152,0,152,152,152,
147,0,0,0,147,0,147,147,147,
134,0,134,134,134,0,134,134,134,
167,0,167,0,0,0,167,0,0,
0,0,0,154,154,154,154,154,154,
135,135,0,135,135,135,135,135,135,
130,130,0,0,0,130,130,130,130,
162,162,162,0,0,162,162,162,162,
149,149,149,0,0,0,0,0,0,
137,137,137,137,137,137,0,0,0,
0,0,0,0,0,0,0,125,125,
0,0,156,156,156,156,156,156,156,
137,0,137,137,137,137,137,137,137,
132,132,132,132,132,0,0,0,0,
121,121,121,121,121,0,0,0,0,
150,150,150,150,150,150,150,0,0,
139,139,139,139,139,139,139,0,0,
128,128,128,128,128,0,0,128,0,
116,116,116,116,0,0,116,116,0,
0,0,0,0,0,145,145,145,0,
0,134,134,134,134,134,134,0,0,
0,0,0,0,123,123,123,0,123,
0,112,0,0,0,112,0,112,112,
139,139,0,139,139,139,0,139,139,
0,128,0,128,0,0,0,128,128,
118,118,0,118,0,118,118,118,118,
0,108,0,108,0,0,0,0,0,
0,107,0,107,107,107,107,107,107,
0,97,0,0,0,0,0,0,0,
0,91,91,91,91,91,91,91,91,
0,95,95,0,95,95,0,95,95,
81,81,81,81,0,81,81,81,81,
80,80,80,80,0,80,80,80,80,
0,0,0,0,0,83,83,83,83,
0,78,78,78,78,78,78,78,78,
0,0,0,0,0,0,81,81,81,
0,0,0,80,80,0,0,0,0,
0,0,0,0,0,0,0,0,0,
0,0,0,0,0,0,0,0,0,
0,0,0,0,0,0,0,0,0.