[layer]
type=Tile Layer 1
data=
1,1,1,1,1,1,1,21,1,
0,0,2,21,1,0,0,0,0,
1,8,2,1,1,21,1,1,1,
1,2,2,1,1,21,1,1,1,
1,1,1,1,1,21,1,1,1,
2,2,2,21,2,0,2,2,7,
2,9,2,2,2,2,21,2,0,
19,2,2,1,1,21,2,2,0,
0,2,1,1,1,0,19,2,21,
0,21,1,0,0,0,2,0,0,
24,2,1,1,1,21,1,0,1,
20,0,0,2,2,2,2,21,2,
2,2,21,2,7,2,2,2,0,
2,2,2,21,2,2,9,2,2,
0,1,1,0,21,2,0,2,0,
1,21,0,0,2,8,2,1,1,
1,1,1,21,2,2,2,1,1,
2,2,7,2,2,21,2,2,0,
2,2,1,1,1,1,1,21,1,
8,2,2,21,1,1,1,0,1,
2,8,2,21,1,1,1,0,1,
0,0,2,0,0,0,1,0,21,
1,1,1,21,2,2,2,1,1,
2,2,2,21,2,20,2,2,2,
1,21,2,0,2,0,2,2,1,
2,21,2,20,2,2,8,2,2,
2,21,2,0,2,2,10,2,1,
24,0,1,0,21,2,2,0,1,
1,1,1,2,2,21,2,0,1,
1,1,1,2,8,21,2,24,1,
1,1,1,2,2,21,1,1,1,
1,0,0,1,0,21,1,1,0,
1,1,1,21,1,1,1,1,1,
2,0,21,1,1,1,0,1,1,
9,2,21,2,2,2,2,2,0,
2,2,21,2,2,2,2,9,0,
2,2,2,18,2,0,21,0,0,
1,1,21,0,0,0,1,1,0,
1,0,0,0,1,21,0,0,1,
1,0,1,0,1,1,21,0,1,
2,2,1,1,1,21,0,1,1,
10,0,21,0,0,0,0,1,1,
2,2,0,1,0,1,21,0,0,
1,1,1,1,21,1,1,1,1,
1,1,0,21,0,1,1,1,1,
1,1,1,1,21,1,1,1,1,
1,1,21,0,1,0,1,0,1,
1,1,1,1,1,1,21,1,0,
0,0,0,0,0,0,0,0,0,
0,0,0,0,0,0,0,0,0,
0,0,0,0,0,0,0,0,0.
[layer]
type=Tile Layer 2
data=
217,217,217,217,217,217,217,0,217,
0,0,227,0,227,0,0,0,0,
225,225,225,225,225,0,225,225,225,
174,174,174,174,174,0,174,174,174,
160,160,160,160,160,0,160,160,160,
154,154,154,0,154,0,154,154,154,
192,192,192,192,192,192,0,192,0,
0,178,178,178,178,0,178,178,0,
0,164,164,164,164,0,0,164,0,
0,0,149,0,0,0,149,0,0,
0,187,187,187,187,0,187,0,187,
0,0,0,173,173,173,173,0,173,
159,159,0,159,159,159,159,159,0,
145,145,145,0,145,145,145,145,145,
0,181,181,0,0,181,0,181,0,
167,0,0,0,167,167,167,167,167,
147,147,147,0,147,147,147,147,147,
141,141,141,141,141,0,141,141,0,
167,167,167,167,167,167,167,0,167,
162,162,162,0,162,162,162,0,162,
149,149,149,0,149,149,149,0,149,
0,0,136,0,0,0,136,0,0,
162,162,162,0,162,162,162,162,162,
157,157,157,0,157,0,157,157,157,
144,0,144,0,144,0,144,144,144,
132,0,132,0,132,132,132,132,132,
164,0,164,0,164,164,164,164,164,
0,0,152,0,0,152,152,0,152,
140,140,140,140,140,0,140,0,140,
127,127,127,127,127,0,127,0,127,
151,151,151,151,151,0,151,151,151,
147,0,0,147,0,0,147,147,0,
128,128,128,0,128,128,128,128,128,
123,0,0,123,123,123,0,123,123,
153,153,0,153,153,153,153,153,0,
141,141,0,141,141,141,141,141,0,
130,130,130,0,130,0,0,0,0,
119,119,0,0,0,0,119,119,0,
118,0,0,0,118,0,0,0,118,
107,0,107,0,107,107,0,0,107,
106,106,106,106,106,0,0,106,106,
105,0,0,0,0,0,0,105,105,
94,94,0,94,0,94,0,0,0,
89,89,89,89,0,89,89,89,89,
92,92,0,0,0,92,92,92,92,
87,87,87,87,0,87,87,87,87,
90,90,0,0,90,0,90,0,90,
89,89,89,89,89,89,0,89,0,
0,0,0,0,0,0,0,0,0,
0,0,0,0,0,0,0,0,0,
0,0,0,0,0,0,0,0,0.