[layer]
type=Tile Layer 1
data=
1,1,1,1,21,0,1,1,0,
1,0,0,21,0,1,1,1,0,
0,0,1,1,21,0,0,0,0,
0,2,2,2,21,7,2,2,2,
0,2,1,1,0,21,0,1,1,
9,2,2,21,2,2,0,2,2,
2,2,7,2,2,2,21,2,2,
0,2,2,2,2,2,21,9,2,
0,1,1,1,1,1,21,2,1,
0,0,0,1,0,0,21,0,0,
2,2,21,7,2,2,2,2,2,
0,1,0,0,0,1,0,21,0,
0,1,2,2,2,1,1,1,21,
0,2,2,9,2,2,2,2,21,
0,1,2,2,0,1,1,1,21,
1,1,0,1,1,21,0,0,1,
1,0,1,21,1,0,1,0,1,
1,0,2,0,2,21,1,0,1,
0,2,2,9,21,2,2,2,2,
1,0,2,21,2,1,0,1,1,
0,1,0,1,0,1,1,1,21,
0,0,0,0,0,0,0,0,0,
0,0,0,0,0,0,0,0,0,
0,0,0,0,0,0,0,0,0.
[layer]
type=Tile Layer 2
data=
133,133,133,133,0,0,133,133,0,
132,0,0,0,0,132,132,132,0,
0,0,130,130,0,0,0,0,0,
0,113,113,113,0,113,113,113,113,
0,104,104,104,0,0,0,104,104,
95,95,95,0,95,95,0,95,95,
82,82,82,82,82,82,0,82,82,
0,107,107,107,107,107,0,107,107,
0,94,94,94,94,94,0,94,94,
0,0,0,90,0,0,0,0,0,
78,78,0,78,78,78,78,78,78,
0,81,0,0,0,81,0,0,0,
0,69,69,69,69,69,69,69,0,
0,72,72,72,72,72,72,72,0,
0,71,71,71,0,71,71,71,0,
63,63,0,63,63,0,0,0,63,
62,0,62,0,62,0,62,0,62,
61,0,61,0,61,0,61,0,61,
0,60,60,60,0,60,60,60,60,
59,0,59,0,59,59,0,59,59,
0,58,0,58,0,58,58,58,0,
0,0,0,0,0,0,0,0,0,
0,0,0,0,0,0,0,0,0,
0,0,0,0,0,0,0,0,0.