[layer]
type=Tile Layer 1
data=
10,0,0,0,0,21,1,1,0,
2,21,1,0,1,1,1,1,0,
1,0,1,21,1,1,1,1,0,
2,21,2,2,0,7,2,2,2,
0,21,2,2,0,1,1,1,1,
0,2,9,2,2,21,2,2,2,
0,2,0,2,21,1,1,1,1,
0,1,0,1,21,0,0,1,0,
1,1,21,1,1,1,1,1,0,
0,0,0,0,0,0,0,1,21,
1,1,1,2,2,2,21,1,0,
0,1,1,2,8,2,0,1,21,
21,7,2,2,2,2,2,2,2,
0,1,0,0,0,0,21,0,0,
0,1,1,1,1,1,1,2,21,
0,2,2,2,2,2,2,21,9,
0,2,2,2,1,1,1,21,0,
0,2,9,2,2,2,2,2,21,
1,21,2,0,1,1,1,1,1,
1,0,21,0,0,0,1,1,1,
1,1,1,1,0,0,21,0,1,
0,0,0,0,0,0,0,0,0,
0,0,0,0,0,0,0,0,0,
0,0,0,0,0,0,0,0,0.
[layer]
type=Tile Layer 2
data=
133,0,0,0,0,0,133,133,0,
132,0,132,0,132,132,132,132,0,
130,0,130,0,130,130,130,130,0,
113,0,113,113,0,113,113,113,113,
0,0,104,104,0,104,104,104,104,
0,95,95,95,95,0,95,95,95,
0,86,0,86,0,86,86,86,86,
0,107,0,107,0,0,0,107,0,
94,94,0,94,94,94,94,94,0,
0,0,0,0,0,0,0,90,0,
78,78,78,78,78,78,0,78,0,
0,81,81,81,81,81,0,81,0,
0,69,69,69,69,69,69,69,69,
0,72,0,0,0,0,0,0,0,
0,67,67,67,67,67,67,67,0,
0,63,63,63,63,63,63,0,63,
0,62,62,62,62,62,62,0,0,
0,61,61,61,61,61,61,61,0,
57,0,57,0,57,57,57,57,57,
59,0,0,0,0,0,59,59,59,
58,58,58,58,0,0,0,0,58,
0,0,0,0,0,0,0,0,0,
0,0,0,0,0,0,0,0,0,
0,0,0,0,0,0,0,0,0.