[layer]
type=Tile Layer 1
data=
0,24,0,1,0,1,21,0,0,
2,2,0,2,21,2,18,2,2,
0,0,21,1,0,1,0,1,0,
0,1,1,1,21,1,0,1,1,
0,0,21,1,0,1,0,0,0,
0,1,0,1,0,1,21,1,0,
0,1,21,1,0,1,0,1,0,
0,2,21,2,18,2,0,2,2,
0,1,0,1,0,1,0,1,21,
2,2,0,2,0,21,18,2,2,
0,0,1,1,1,1,21,0,0,
1,0,0,0,0,0,0,21,0,
1,1,1,21,1,1,1,1,1,
1,1,1,21,2,0,2,1,1,
2,2,2,21,2,20,2,2,2,
0,0,0,0,0,0,0,0,0,
0,0,0,0,0,0,0,0,0,
0,0,0,0,0,0,0,0,0.
[layer]
type=Tile Layer 2
data=
0,0,0,123,0,123,0,0,0,
121,121,0,121,0,121,0,121,121,
0,0,0,119,0,119,0,119,0,
0,89,89,89,0,89,0,89,89,
0,0,0,81,0,81,0,0,0,
0,80,0,80,0,80,0,80,0,
0,72,0,72,0,72,0,72,0,
0,71,0,71,0,71,0,71,71,
0,70,0,70,0,70,0,70,0,
62,62,0,62,0,0,0,62,62,
0,0,61,61,61,61,0,0,0,
60,0,0,0,0,0,0,0,0,
54,54,54,0,54,54,54,54,54,
56,56,56,0,56,0,56,56,56,
55,55,55,0,55,0,55,55,55,
0,0,0,0,0,0,0,0,0,
0,0,0,0,0,0,0,0,0,
0,0,0,0,0,0,0,0,0.