[layer]
type=Tile Layer 1
data=
2,2,21,0,0,20,2,2,0,
1,1,1,1,2,0,0,21,0,
1,1,1,0,0,21,1,1,0,
2,2,2,2,2,21,2,2,18,
1,1,0,1,0,1,0,21,24,
1,1,21,0,1,0,1,1,1,
1,0,1,21,6,0,2,0,0,
1,1,1,21,4,0,2,1,1,
1,21,1,0,1,1,19,2,1,
1,1,1,21,1,0,2,0,1,
1,0,0,21,1,0,2,1,1,
1,21,1,1,1,0,1,0,1,
0,0,0,0,0,0,0,0,0,
0,0,0,0,0,0,0,0,0,
0,0,0,0,0,0,0,0,0.
[layer]
type=Tile Layer 2
data=
88,88,0,0,0,0,88,88,0,
63,63,63,63,63,0,0,0,0,
62,62,62,0,0,0,62,62,0,
58,58,58,58,58,0,58,58,0,
54,54,0,54,0,54,0,0,0,
53,53,0,0,53,0,53,53,53,
52,0,52,0,52,0,52,0,0,
49,49,49,0,49,0,49,49,49,
50,0,50,0,50,50,0,50,50,
49,49,49,0,49,0,49,0,49,
48,0,0,0,48,0,48,48,48,
47,0,47,47,47,0,47,0,47,
0,0,0,0,0,0,0,0,0,
0,0,0,0,0,0,0,0,0,
0,0,0,0,0,0,0,0,0.