[layer]
type=Tile Layer 1
data=
1,0,0,0,0,21,0,0,3,
1,21,5,1,1,5,1,0,1,
1,21,4,1,1,1,1,0,1,
1,0,21,0,1,1,0,1,1,
1,1,5,0,1,1,21,0,0,
4,1,3,0,0,0,21,0,0,
0,1,5,1,21,1,0,3,1,
0,0,0,3,0,1,0,21,0,
0,1,21,6,0,1,1,1,1,
0,1,0,4,0,3,21,1,0,
0,1,1,1,0,1,21,1,0,
0,0,0,5,0,1,0,1,21,
1,3,1,1,21,1,0,1,1,
4,1,1,1,0,1,0,21,0,
4,1,1,1,21,1,6,1,6,
1,0,0,0,4,1,1,21,0,
0,1,1,21,1,1,4,1,0,
0,0,5,1,0,1,3,1,21,
1,0,0,21,0,1,5,4,0,
1,0,1,0,1,21,0,0,1,
1,0,1,21,1,0,3,0,0,
0,0,0,0,0,0,0,0,0,
0,0,0,0,0,0,0,0,0,
0,0,0,0,0,0,0,0,0.
[layer]
type=Tile Layer 2
data=
133,0,0,0,0,0,0,0,133,
125,0,125,125,125,125,125,0,125,
124,0,124,124,124,124,124,0,124,
113,0,0,0,113,113,0,113,113,
104,104,104,0,104,104,0,0,0,
95,95,95,0,0,0,0,0,0,
0,86,86,86,0,86,0,86,86,
0,0,0,107,0,107,0,0,0,
0,98,0,98,0,98,98,98,98,
0,90,0,90,0,90,0,90,0,
0,82,82,82,0,82,0,82,0,
0,0,0,81,0,81,0,81,0,
69,69,69,69,0,69,0,69,69,
72,72,72,72,0,72,0,0,0,
64,64,64,64,0,64,64,64,64,
63,0,0,0,63,63,63,0,0,
0,62,62,0,62,62,62,62,0,
0,0,61,61,0,61,61,61,0,
60,0,0,0,0,60,60,60,0,
59,0,59,0,59,0,0,0,59,
58,0,58,0,58,0,58,0,0,
0,0,0,0,0,0,0,0,0,
0,0,0,0,0,0,0,0,0,
0,0,0,0,0,0,0,0,0.