[layer]
type=Tile Layer 1
data=
0,3,1,1,21,1,1,0,0,
1,4,6,1,21,6,0,0,1,
1,1,21,0,0,1,1,0,1,
1,1,0,3,21,0,0,0,1,
0,21,1,0,5,1,1,6,1,
0,0,21,0,1,3,1,1,1,
4,21,1,1,3,1,1,1,1,
1,0,0,21,0,0,0,0,0,
3,21,1,1,1,6,1,1,1,
0,0,1,0,1,0,0,0,21,
1,21,3,0,1,1,1,1,1,
1,21,1,1,1,6,1,5,3,
1,21,4,1,1,6,1,1,1,
5,21,6,1,1,1,0,0,1,
1,1,1,21,1,1,1,1,1,
1,6,21,1,1,1,1,4,1,
1,5,1,1,21,1,1,1,1,
5,0,1,0,21,0,1,0,1,
0,1,6,1,1,1,1,3,21,
0,0,21,1,0,1,0,0,0,
0,0,1,5,0,1,1,21,0,
0,0,0,0,0,0,0,0,0,
0,0,0,0,0,0,0,0,0,
0,0,0,0,0,0,0,0,0.
[layer]
type=Tile Layer 2
data=
0,133,133,133,0,133,133,0,0,
132,132,132,132,0,132,0,0,132,
130,130,0,0,0,130,130,0,130,
113,113,0,113,0,0,0,0,113,
0,0,104,0,104,104,104,104,104,
0,0,0,0,95,95,95,95,95,
78,0,78,78,78,78,78,78,78,
107,0,0,0,0,0,0,0,0,
89,0,89,89,89,89,89,89,89,
0,0,90,0,90,0,0,0,0,
78,0,78,0,78,78,78,78,78,
77,0,77,3,61,61,77,77,77,
69,0,69,3,55,55,69,69,69,
72,0,72,3,57,3,0,0,72,
56,3,56,0,56,56,56,3,56,
48,48,0,48,48,48,3,48,48,
3,50,50,50,0,50,50,50,3,
61,0,61,0,0,0,61,0,61,
0,57,57,57,57,57,57,57,0,
0,0,0,59,0,59,0,0,0,
0,0,58,58,0,58,58,0,0,
0,0,0,0,0,0,0,0,0,
0,0,0,0,0,0,0,0,0,
0,0,0,0,0,0,0,0,0.