[layer]
type=Tile Layer 1
data=
1,1,1,21,4,3,1,0,1,
1,1,4,0,5,21,0,0,0,
1,5,1,21,1,1,1,1,1,
0,0,0,0,0,0,0,21,1,
21,6,1,1,1,1,1,5,1,
0,21,1,0,4,1,1,5,1,
4,0,1,0,0,0,21,0,0,
1,21,1,5,1,1,1,1,6,
1,21,0,0,0,0,1,0,0,
1,1,1,1,4,21,1,1,1,
0,0,0,0,3,0,0,21,0,
21,3,6,1,1,1,1,1,1,
21,1,1,1,6,4,1,1,1,
0,1,0,0,21,1,4,1,1,
0,5,1,5,21,1,1,1,1,
0,0,1,21,1,0,5,0,1,
1,1,1,21,1,1,6,0,5,
1,21,0,0,0,0,1,0,4,
1,3,3,21,1,0,1,0,1,
0,21,1,0,4,0,1,0,1,
1,21,1,0,6,0,1,0,1,
0,0,1,0,1,0,1,21,0,
1,1,1,1,1,21,1,1,3,
0,0,0,21,6,0,0,0,4,
0,21,0,1,1,0,5,1,1,
1,5,1,1,1,21,0,1,4,
3,1,1,1,1,21,1,0,4,
5,1,1,1,6,0,0,21,0,
5,1,1,1,21,0,3,1,0,
1,1,0,0,21,1,0,0,0,
0,0,4,1,1,1,21,3,1,
0,0,1,1,6,1,21,3,1,
1,1,21,1,0,1,1,0,1,
0,5,5,1,1,1,1,1,21,
1,1,1,1,1,1,4,1,21,
1,3,1,1,1,0,1,21,1,
1,1,21,1,1,1,4,1,1,
1,0,1,21,0,0,1,6,3,
0,21,1,1,1,1,0,1,1,
0,0,0,0,0,0,0,0,0,
0,0,0,0,0,0,0,0,0,
0,0,0,0,0,0,0,0,0.
[layer]
type=Tile Layer 2
data=
197,197,197,0,197,197,197,0,197,
195,195,195,0,195,0,0,0,0,
184,184,184,0,184,184,184,184,184,
0,0,0,0,0,0,0,0,146,
0,127,127,127,127,127,127,127,127,
0,0,166,0,166,166,166,166,166,
153,0,153,0,0,0,0,0,0,
134,0,134,134,134,134,134,134,134,
129,0,0,0,0,0,129,0,0,
153,153,153,153,153,0,153,153,153,
0,0,0,0,148,0,0,0,0,
0,130,130,130,130,130,130,130,130,
0,118,118,118,118,118,118,118,118,
0,155,0,0,0,155,155,155,155,
0,143,143,143,0,143,143,143,143,
0,0,131,0,131,0,131,0,131,
120,120,120,0,120,120,120,0,120,
149,0,0,0,0,0,149,0,149,
138,138,138,0,138,0,138,0,138,
0,0,127,0,127,0,127,0,127,
115,0,115,0,115,0,115,0,115,
0,0,144,0,144,0,144,0,0,
126,126,126,126,126,0,126,126,126,
0,0,0,0,122,0,0,0,122,
0,0,0,111,111,0,111,111,111,
138,138,138,138,138,0,0,138,138,
127,127,127,127,127,0,127,0,127,
117,117,117,117,117,0,0,0,0,
107,107,107,107,0,0,107,107,0,
106,106,0,0,0,106,0,0,0,
0,0,96,96,96,96,0,96,96,
0,0,95,95,95,95,0,95,95,
94,94,0,4,0,4,4,0,94,
0,67,67,84,84,84,67,67,0,
4,4,4,66,83,66,66,66,0,
66,82,4,82,82,0,4,0,4,
81,81,0,4,4,4,65,81,81,
4,0,4,0,0,0,4,80,64,
0,0,79,79,79,79,0,79,79,
0,0,0,0,0,0,0,0,0,
0,0,0,0,0,0,0,0,0,
0,0,0,0,0,0,0,0,0.