[layer]
type=Tile Layer 1
data=
1,1,21,1,1,1,0,1,1,
0,0,0,1,0,0,21,1,1,
1,1,21,1,1,1,1,1,1,
1,1,0,0,0,21,0,1,1,
1,1,21,1,1,1,1,1,1,
0,0,0,0,21,0,0,1,0,
1,1,1,21,0,0,0,0,1,
1,1,1,21,1,1,1,0,1,
0,0,1,0,1,1,1,21,1,
1,1,1,21,1,1,1,0,1,
0,21,0,0,1,1,1,0,1,
1,1,1,1,1,1,1,21,1,
1,1,1,0,0,21,0,0,1,
1,1,1,21,1,1,1,1,1,
0,0,1,0,1,0,21,0,0,
1,21,1,0,1,1,1,1,1,
1,0,0,0,0,0,1,21,0,
1,21,1,1,1,1,1,0,1,
1,21,0,0,1,0,0,0,1,
1,1,1,1,1,21,1,1,1,
1,0,0,0,0,21,1,0,0,
1,21,1,1,1,1,1,0,1,
0,21,1,0,0,0,1,0,1,
1,1,1,21,1,0,1,0,1,
1,1,1,1,21,1,1,1,1,
1,1,1,1,21,1,1,1,1,
0,0,21,0,0,1,1,1,1,
21,1,1,1,1,1,1,1,1,
0,21,0,0,0,0,1,1,1,
0,0,0,1,1,0,0,0,21,
1,1,1,1,1,21,0,0,0,
1,1,1,21,0,0,1,1,1,
1,1,1,21,1,1,1,1,1,
1,1,0,0,1,0,21,0,1,
1,1,1,0,21,0,0,0,1,
1,1,1,1,21,0,1,1,1,
0,0,1,1,1,1,21,1,1,
1,0,0,0,0,1,21,0,1,
1,1,0,0,21,1,1,0,1,
0,0,0,0,0,0,0,0,0,
0,0,0,0,0,0,0,0,0,
0,0,0,0,0,0,0,0,0.
[layer]
type=Tile Layer 2
data=
197,197,0,197,197,197,0,197,197,
0,0,0,195,0,0,0,195,195,
184,184,0,184,184,184,184,184,184,
146,146,0,0,0,0,0,146,146,
127,127,0,127,127,127,127,127,127,
0,0,0,0,0,0,0,166,0,
153,153,153,0,0,0,0,0,153,
141,141,141,0,141,141,141,0,141,
0,0,129,0,129,129,129,0,129,
161,161,161,0,161,161,161,0,161,
0,0,0,0,148,148,148,0,148,
130,130,130,130,130,130,130,0,130,
124,124,124,0,0,0,0,0,124,
147,147,147,0,147,147,147,147,147,
0,0,143,0,143,0,0,0,0,
131,0,131,0,131,131,131,131,131,
120,0,0,0,0,0,120,0,0,
149,0,149,149,149,149,149,0,149,
138,0,0,0,138,0,0,0,138,
121,121,121,121,121,0,121,121,121,
115,0,0,0,0,0,115,0,0,
144,0,144,144,144,144,144,0,144,
0,0,133,0,0,0,133,0,133,
122,122,122,0,122,0,122,0,122,
106,106,106,106,0,106,106,106,106,
132,132,132,132,0,132,132,132,132,
0,0,0,0,0,127,127,127,127,
0,111,111,111,111,111,111,111,111,
0,0,0,0,0,0,107,107,107,
0,0,0,106,106,0,0,0,0,
96,96,96,96,96,0,0,0,0,
95,95,95,0,0,0,95,95,95,
89,89,89,0,89,89,89,89,89,
84,84,0,0,84,0,0,0,84,
83,83,83,0,0,0,0,0,83,
82,82,82,82,0,0,82,82,82,
0,0,81,81,81,81,0,81,81,
80,0,0,0,0,80,0,0,80,
79,79,0,0,0,79,79,0,79,
0,0,0,0,0,0,0,0,0,
0,0,0,0,0,0,0,0,0,
0,0,0,0,0,0,0,0,0.