[layer]
type=Tile Layer 1
data=
0,21,0,1,1,1,1,1,1,
0,1,21,0,1,1,1,1,1,
0,1,1,0,0,21,0,0,1,
1,1,1,1,1,0,0,21,0,
1,1,1,1,1,21,0,1,0,
1,1,1,0,0,1,21,1,0,
1,1,1,0,1,1,0,21,0,
1,1,1,0,1,1,1,21,0,
0,1,0,0,21,0,1,1,0,
0,0,1,1,1,0,0,0,21,
1,0,21,1,1,1,1,1,0,
1,1,21,1,1,1,1,1,0,
0,1,1,1,0,0,1,0,21,
1,1,1,1,1,1,1,21,1,
1,0,0,0,0,0,0,21,0,
1,21,1,1,1,1,1,1,1,
0,21,1,0,0,0,0,0,1,
1,1,1,21,1,0,1,0,1,
1,0,1,0,1,21,1,0,1,
1,0,1,21,1,0,1,1,1,
1,21,0,0,1,0,0,0,1,
1,1,0,1,0,1,0,21,0,
1,1,1,1,21,1,1,1,1,
1,1,21,0,0,1,1,1,1,
1,1,1,1,21,1,1,1,1,
1,1,21,0,1,0,1,0,1,
1,1,1,1,1,1,21,1,0,
0,0,21,0,0,1,0,1,0,
1,1,1,1,21,1,1,1,1,
0,0,0,1,21,0,0,0,0,
1,21,1,1,1,1,1,0,1,
1,0,0,0,0,0,21,0,1,
1,1,1,1,1,1,21,1,1,
1,1,1,1,1,1,21,1,1,
0,0,0,1,21,1,0,1,0,
1,1,1,1,21,1,1,1,0,
0,0,0,0,0,0,0,0,0,
0,0,0,0,0,0,0,0,0,
0,0,0,0,0,0,0,0,0.
[layer]
type=Tile Layer 2
data=
0,0,0,192,192,192,192,192,192,
0,191,0,0,191,191,191,191,191,
0,189,189,0,0,0,0,0,189,
153,153,153,153,153,0,0,0,0,
141,141,141,141,141,0,0,141,0,
129,129,129,0,0,129,0,129,0,
161,161,161,0,161,161,0,0,0,
148,148,148,0,148,148,148,0,0,
0,136,0,0,0,0,136,136,0,
0,0,124,124,124,0,0,0,0,
155,0,0,155,155,155,155,155,0,
143,143,0,143,143,143,143,143,0,
0,131,131,131,0,0,131,0,0,
114,114,114,114,114,114,114,0,114,
149,0,0,0,0,0,0,0,0,
131,0,131,131,131,131,131,131,131,
0,0,127,0,0,0,0,0,127,
115,115,115,0,115,0,115,0,115,
144,0,144,0,144,0,144,0,144,
133,0,133,0,133,0,133,133,133,
122,0,0,0,122,0,0,0,122,
111,111,0,111,0,111,0,0,0,
132,132,132,132,0,132,132,132,132,
127,127,0,0,0,127,127,127,127,
111,111,111,111,0,111,111,111,111,
107,107,0,0,107,0,107,0,107,
106,106,106,106,106,106,0,106,0,
0,0,0,0,0,96,0,96,0,
90,90,90,90,0,90,90,90,90,
0,0,0,94,0,0,0,0,0,
84,0,84,84,84,84,84,0,84,
83,0,0,0,0,0,0,0,83,
78,78,78,78,78,78,0,78,78,
77,77,77,77,77,77,0,77,77,
0,0,0,80,0,80,0,80,0,
79,79,79,79,0,79,79,79,0,
0,0,0,0,0,0,0,0,0,
0,0,0,0,0,0,0,0,0,
0,0,0,0,0,0,0,0,0.