[layer]
type=Tile Layer 1
data=
4,1,1,1,1,21,1,1,1,
1,1,1,1,1,21,5,0,5,
1,1,1,1,6,21,4,0,6,
4,0,21,1,0,0,1,1,1,
1,21,1,1,1,6,3,1,4,
0,0,0,1,1,21,1,0,0,
1,1,3,21,1,1,0,0,0,
1,1,0,21,1,6,1,5,0,
1,6,0,1,0,0,21,0,0,
0,0,21,0,1,1,0,1,1,
0,6,1,0,0,21,5,1,6,
0,0,0,21,1,1,1,3,1,
0,0,0,0,0,21,6,5,1,
1,1,1,21,1,1,0,0,0,
1,1,3,0,0,0,0,21,0,
5,1,1,1,21,1,1,4,1,
1,3,1,1,21,1,1,1,3,
1,5,4,1,21,1,1,1,1,
0,1,0,0,0,5,21,0,0,
1,1,21,1,1,1,4,1,1,
0,5,1,6,0,21,0,0,1,
6,1,1,1,1,1,1,21,1,
0,0,0,3,1,1,21,0,1,
1,1,3,6,1,1,4,21,1,
6,1,21,1,0,5,1,1,1,
5,3,0,1,21,1,1,3,0,
1,1,21,1,1,1,1,1,0,
4,1,0,0,0,0,0,21,0,
1,1,21,1,1,1,0,3,5,
0,1,21,1,1,1,0,4,0,
1,6,6,1,1,4,21,1,1,
1,21,1,5,1,0,0,5,1,
1,1,21,1,1,1,1,4,1,
0,0,3,1,6,6,0,0,21,
1,21,4,1,1,1,1,1,0,
1,1,1,1,1,0,21,0,0,
0,0,0,21,0,0,1,3,1,
0,1,0,5,1,0,21,4,1,
0,1,0,1,1,1,21,1,4,
0,1,4,1,1,21,0,0,1,
0,5,0,0,0,1,1,21,1,
0,0,0,0,0,0,0,21,1,
1,1,1,1,1,21,1,1,1,
0,0,1,0,1,1,21,1,0,
1,1,4,3,6,4,21,3,1,
1,1,1,1,4,1,21,6,1,
0,0,0,1,0,5,21,0,0,
1,1,0,1,21,1,0,6,1,
0,0,0,0,0,0,0,0,0,
0,0,0,0,0,0,0,0,0,
0,0,0,0,0,0,0,0,0.
[layer]
type=Tile Layer 2
data=
218,218,218,218,218,0,218,218,218,
228,228,228,228,228,0,228,0,228,
226,226,226,226,226,0,226,0,226,
184,0,0,184,0,0,184,184,184,
161,0,161,161,161,161,161,161,161,
0,0,0,155,155,0,155,0,0,
193,193,193,0,193,193,0,0,0,
179,179,0,0,179,179,179,179,0,
165,165,0,165,0,0,0,0,0,
0,0,0,0,150,150,0,150,150,
0,188,188,0,0,0,188,188,188,
0,0,0,0,174,174,174,174,174,
0,0,0,0,0,0,160,160,160,
146,146,146,0,146,146,0,0,0,
182,182,182,0,0,0,0,0,0,
160,160,160,160,0,160,160,160,160,
148,148,148,148,0,148,148,148,148,
135,135,135,135,0,135,135,135,135,
0,177,0,0,0,177,0,0,0,
155,155,0,155,155,155,155,155,155,
0,150,150,150,0,0,0,0,150,
131,131,131,131,131,131,131,0,131,
0,0,0,171,171,171,0,0,171,
151,151,151,151,151,151,151,0,151,
145,145,0,145,0,145,145,145,145,
133,133,0,133,0,133,133,133,0,
165,165,0,165,165,165,165,165,0,
153,153,0,0,0,0,0,0,0,
141,141,0,141,141,141,0,141,141,
0,128,0,128,128,128,0,128,0,
152,152,152,152,152,152,0,152,152,
148,0,148,148,148,0,0,148,148,
129,129,0,129,129,129,129,129,129,
0,0,124,124,124,124,0,0,0,
154,0,154,154,154,154,154,154,0,
142,142,142,142,142,0,0,0,0,
0,0,0,0,0,0,131,131,131,
0,120,0,120,120,0,0,120,120,
0,119,0,119,119,119,0,119,119,
0,108,108,108,108,0,0,0,108,
0,107,0,0,0,107,107,0,107,
0,0,0,0,0,0,0,0,106,
91,91,91,91,91,0,91,91,91,
0,0,94,0,94,94,0,94,0,
89,89,89,89,89,89,0,89,89,
88,88,88,88,88,88,0,88,88,
0,0,0,91,0,91,0,0,0,
90,90,0,90,0,90,0,90,90,
0,0,0,0,0,0,0,0,0,
0,0,0,0,0,0,0,0,0,
0,0,0,0,0,0,0,0,0.