[layer]
type=Tile Layer 1
data=
1,0,1,1,1,1,0,21,1,
5,6,1,1,1,21,1,0,1,
1,1,0,21,1,1,0,4,1,
1,1,21,0,1,0,5,1,0,
6,1,1,0,0,21,0,0,0,
1,4,1,1,21,5,1,1,0,
0,1,21,0,0,4,0,6,0,
1,1,0,1,21,5,0,1,1,
1,1,21,1,6,4,0,1,0,
1,1,1,1,0,6,0,1,21,
0,1,0,0,0,4,0,21,0,
0,1,21,1,6,6,4,1,1,
0,0,0,0,0,0,0,0,0,
0,0,0,0,0,0,0,0,0,
0,0,0,0,0,0,0,0,0.
[layer]
type=Tile Layer 2
data=
88,0,88,88,88,88,0,0,88,
59,59,59,59,59,0,59,0,59,
62,62,0,0,62,62,0,62,62,
61,61,0,0,61,0,61,61,0,
54,54,54,0,0,0,0,0,0,
50,50,50,50,0,50,50,50,0,
0,52,0,0,0,52,0,52,0,
51,51,0,51,0,51,0,51,51,
50,50,0,50,50,50,0,50,0,
49,49,49,49,0,49,0,49,0,
0,48,0,0,0,48,0,0,0,
0,45,0,45,45,45,45,45,45,
0,0,0,0,0,0,0,0,0,
0,0,0,0,0,0,0,0,0,
0,0,0,0,0,0,0,0,0.