[layer]
type=Tile Layer 1
data=
1,1,1,1,1,21,0,1,0,
0,21,0,0,0,0,0,1,0,
0,1,1,1,1,1,1,1,21,
1,1,1,1,0,0,0,21,0,
1,1,1,1,21,1,1,0,0,
1,1,1,1,21,1,1,1,0,
0,1,1,1,21,1,1,1,1,
0,1,0,21,0,1,1,1,0,
0,1,1,1,0,1,1,1,21,
0,1,0,1,21,1,1,1,0,
0,1,21,1,0,1,1,1,0,
0,0,0,1,0,0,21,0,0,
1,1,1,1,21,1,1,1,1,
1,21,0,0,0,1,0,0,0,
1,1,21,1,1,1,1,1,1,
0,0,0,1,1,0,21,1,1,
0,1,21,1,1,0,0,1,1,
0,0,0,1,1,0,1,21,0,
1,0,1,0,21,1,1,1,0,
1,0,1,0,1,1,1,21,0,
21,1,1,1,1,1,1,1,1,
0,0,0,0,0,0,0,0,0,
0,0,0,0,0,0,0,0,0,
0,0,0,0,0,0,0,0,0.
[layer]
type=Tile Layer 2
data=
133,133,133,133,133,0,0,133,0,
0,0,0,0,0,0,0,132,0,
0,124,124,124,124,124,124,124,0,
113,113,113,113,0,0,0,0,0,
104,104,104,104,0,104,104,0,0,
90,90,90,90,0,90,90,90,0,
0,82,82,82,0,82,82,82,82,
0,107,0,0,0,107,107,107,0,
0,98,98,98,0,98,98,98,0,
0,90,0,90,0,90,90,90,0,
0,82,0,82,0,82,82,82,0,
0,0,0,81,0,0,0,0,0,
66,66,66,66,0,66,66,66,66,
72,0,0,0,0,72,0,0,0,
64,64,0,64,64,64,64,64,64,
0,0,0,63,63,0,0,63,63,
0,62,0,62,62,0,0,62,62,
0,0,0,61,61,0,61,0,0,
60,0,60,0,0,60,60,60,0,
59,0,59,0,59,59,59,0,0,
0,53,53,53,53,53,53,53,53,
0,0,0,0,0,0,0,0,0,
0,0,0,0,0,0,0,0,0,
0,0,0,0,0,0,0,0,0.