[layer]
type=Tile Layer 1
data=
0,1,21,1,1,5,1,3,0,
0,3,21,1,1,1,1,1,0,
1,1,21,6,1,1,1,6,0,
0,21,0,1,0,0,0,0,0,
4,1,1,1,1,1,1,1,21,
0,0,0,0,0,21,0,6,0,
3,1,1,6,1,0,0,21,0,
6,1,1,1,1,21,1,1,0,
1,3,1,1,1,1,4,1,21,
3,1,1,1,1,1,1,21,0,
1,1,1,1,1,21,1,1,1,
5,6,1,1,1,5,21,0,0,
0,0,1,1,1,4,1,21,0,
0,1,1,1,1,1,1,21,1,
0,21,1,1,1,1,3,5,1,
0,1,1,1,1,1,1,4,21,
0,0,0,21,0,5,0,1,0,
5,6,1,1,1,1,21,1,0,
1,1,0,0,0,0,0,21,0,
6,5,21,1,1,1,1,1,1,
1,1,21,3,1,1,6,1,0,
1,1,3,5,1,1,1,5,21,
0,0,0,21,0,0,0,4,0,
21,1,1,1,1,1,1,1,1,
0,1,1,1,1,1,1,1,21,
0,0,21,6,1,1,1,4,0,
5,1,0,6,1,0,0,21,0,
1,1,21,0,0,0,1,1,4,
0,0,0,0,0,0,21,1,1,
0,0,3,1,1,1,21,1,6,
0,0,0,0,0,0,0,0,0,
0,0,0,0,0,0,0,0,0,
0,0,0,0,0,0,0,0,0.
[layer]
type=Tile Layer 2
data=
0,166,0,166,166,166,166,166,0,
0,164,0,164,164,164,164,164,0,
162,162,0,162,162,162,162,162,0,
0,0,0,112,0,0,0,0,0,
133,133,133,133,133,133,133,133,0,
0,0,0,0,0,0,0,129,0,
118,118,118,118,118,0,0,0,0,
108,108,108,108,108,0,108,108,0,
128,128,102,102,102,102,102,128,0,
124,124,99,99,99,6,6,0,0,
114,114,91,91,5,0,5,114,114,
103,103,83,83,5,83,0,0,0,
0,0,6,6,6,103,103,0,0,
0,119,5,5,5,5,5,0,119,
0,0,109,109,109,109,109,109,109,
0,99,99,99,99,99,99,99,0,
0,0,0,0,0,123,0,123,0,
113,113,113,113,113,113,0,113,0,
104,104,0,0,0,0,0,0,0,
90,90,0,90,90,90,90,90,90,
94,94,0,94,94,94,94,94,0,
81,81,81,81,81,81,81,81,0,
0,0,0,0,0,0,0,84,0,
0,79,79,79,79,79,79,79,79,
0,74,74,74,74,74,74,74,0,
0,0,0,73,73,73,73,73,0,
72,72,0,72,72,0,0,0,0,
71,71,0,0,0,0,71,71,71,
0,0,0,0,0,0,0,70,70,
0,0,69,69,69,69,0,69,69,
0,0,0,0,0,0,0,0,0,
0,0,0,0,0,0,0,0,0,
0,0,0,0,0,0,0,0,0.