[layer]
type=Tile Layer 1
data=
1,8,0,0,21,0,0,6,1,
1,2,2,0,1,1,0,21,0,
1,1,4,21,1,1,5,1,0,
0,1,0,1,0,21,1,0,0,
0,21,0,1,3,1,5,1,0,
4,4,21,0,1,1,1,1,0,
0,1,1,5,21,1,2,2,1,
0,2,2,2,21,2,2,9,2,
0,2,2,2,2,2,2,7,21,
0,1,21,1,1,1,0,3,0,
0,1,0,4,1,1,0,6,21,
0,0,0,2,0,21,0,1,0,
1,1,21,2,10,2,3,5,0,
1,1,21,2,2,2,2,2,0,
2,2,21,2,2,2,9,2,0,
0,2,2,9,2,2,2,21,2,
0,1,2,2,2,1,1,21,0,
0,1,5,0,1,0,1,6,21,
2,21,2,2,2,2,7,0,2,
0,1,1,1,1,1,1,4,21,
0,5,0,1,0,1,0,6,21,
0,0,0,0,0,0,0,0,0,
0,0,0,0,0,0,0,0,0,
0,0,0,0,0,0,0,0,0.
[layer]
type=Tile Layer 2
data=
133,133,0,0,0,0,0,133,133,
132,132,132,0,132,132,0,0,0,
124,124,124,0,124,124,124,124,0,
0,113,0,113,0,0,113,0,0,
0,0,0,104,104,104,104,104,0,
95,95,0,0,95,95,95,95,0,
0,82,82,82,0,82,82,82,82,
0,107,107,107,0,107,107,107,107,
0,98,98,98,98,98,98,98,0,
0,90,0,90,90,90,0,90,0,
0,82,0,82,82,82,0,82,0,
0,0,0,81,0,0,0,81,0,
73,58,0,58,73,58,58,58,0,
68,54,0,54,68,54,54,54,0,
71,56,0,56,56,56,56,56,0,
0,63,63,50,50,50,63,0,63,
0,3,50,50,50,50,50,0,0,
0,61,61,0,61,0,61,61,0,
60,0,60,60,60,60,60,0,60,
0,57,57,57,57,57,57,57,0,
0,58,0,58,0,58,0,58,0,
0,0,0,0,0,0,0,0,0,
0,0,0,0,0,0,0,0,0,
0,0,0,0,0,0,0,0,0.