[layer]
type=Tile Layer 1
data=
3,4,1,1,21,0,1,1,4,
1,1,21,0,0,0,1,1,1,
6,1,21,1,1,6,1,1,1,
1,3,21,0,6,1,1,1,1,
0,0,21,0,1,1,1,1,1,
0,0,0,21,0,0,6,4,1,
1,1,4,1,1,21,0,6,1,
1,1,1,0,21,0,0,5,1,
5,1,1,21,1,1,1,1,6,
3,21,5,5,6,1,1,1,1,
1,21,0,0,0,0,0,0,0,
1,21,1,1,1,1,1,1,1,
1,21,1,0,0,0,1,0,1,
4,0,4,0,1,21,1,0,1,
6,0,1,21,1,0,1,0,5,
1,0,1,21,1,1,4,0,1,
5,1,6,21,1,1,1,1,1,
4,6,1,21,1,1,1,1,1,
1,1,1,3,1,1,21,4,6,
0,1,4,1,1,1,21,3,1,
1,1,1,1,1,1,21,0,1,
0,21,0,0,1,6,4,0,0,
1,1,1,21,1,3,1,1,0,
1,1,1,6,1,21,0,0,0,
5,1,1,1,1,0,21,0,1,
4,1,6,6,1,21,0,0,0,
1,1,1,1,0,0,21,1,0,
1,5,1,1,1,0,21,0,0,
1,6,1,1,1,6,3,21,0,
1,1,1,1,1,0,21,0,1,
0,0,0,21,0,0,1,1,1,
21,3,1,1,4,1,1,1,4,
0,21,5,1,1,1,1,1,1,
1,0,21,0,0,0,0,1,6,
1,1,1,1,21,0,0,3,1,
1,1,6,1,21,1,4,1,1,
0,1,21,0,0,0,0,0,0,
21,1,1,3,1,1,1,1,1,
0,4,0,0,0,0,0,21,0,
0,6,21,1,0,1,1,1,0,
0,1,0,1,21,1,4,1,0,
0,1,1,1,1,6,5,1,21,
0,21,0,1,0,5,0,0,0,
0,1,1,3,21,6,1,1,0,
1,1,1,1,1,1,21,1,1,
3,1,21,1,1,1,1,1,1,
0,0,1,21,1,1,1,0,5,
0,0,1,4,1,1,21,1,1,
1,21,6,1,1,1,0,1,1,
1,21,1,1,6,4,1,0,1,
0,21,3,1,3,1,1,0,0,
0,0,0,0,0,0,0,0,0,
0,0,0,0,0,0,0,0,0,
0,0,0,0,0,0,0,0,0.
[layer]
type=Tile Layer 2
data=
234,234,234,234,0,0,234,234,234,
233,233,0,0,0,0,233,233,233,
220,220,0,220,220,220,220,220,220,
174,174,0,0,174,174,174,174,174,
0,0,0,0,159,159,159,159,159,
0,0,0,0,0,0,199,199,199,
184,184,184,184,184,0,0,184,184,
169,169,169,0,0,0,0,169,169,
147,147,147,0,147,147,147,147,147,
184,0,184,184,184,184,184,184,184,
179,0,0,0,0,0,0,0,0,
157,0,157,157,157,157,157,157,157,
150,0,150,0,0,0,150,0,150,
188,0,188,0,188,0,188,0,188,
174,0,174,0,174,0,174,0,174,
160,0,128,0,160,128,128,0,160,
146,7,117,0,146,146,117,7,146,
146,146,146,0,182,146,146,9,146,
8,168,135,168,168,168,0,168,135,
0,155,124,124,124,124,0,155,155,
7,142,113,142,142,142,0,0,113,
0,0,0,0,177,177,177,0,0,
163,163,163,0,163,163,163,163,0,
150,150,150,150,150,0,0,0,0,
137,137,137,137,137,0,0,0,137,
171,171,171,171,171,0,0,0,0,
158,158,158,158,0,0,0,158,0,
145,145,145,145,145,0,0,0,0,
133,133,133,133,133,133,133,0,0,
165,165,165,165,165,0,0,0,165,
0,0,0,0,0,0,153,153,153,
0,134,134,134,134,134,134,134,134,
0,0,128,128,128,128,128,128,128,
160,0,0,0,0,0,0,160,160,
148,148,148,148,0,0,0,148,148,
129,129,129,129,0,129,129,129,129,
0,124,0,0,0,0,0,0,0,
0,147,147,147,147,147,147,147,147,
0,142,0,0,0,0,0,0,0,
0,131,0,131,0,131,131,131,0,
0,120,0,120,0,120,120,120,0,
0,119,119,119,119,119,119,119,0,
0,0,0,108,0,108,0,0,0,
0,107,107,107,0,107,107,107,0,
5,84,84,84,5,84,0,84,5,
95,76,0,4,4,4,76,4,95,
0,0,4,0,4,4,4,0,94,
0,0,93,74,74,74,0,93,93,
92,0,92,92,74,92,0,92,92,
91,0,91,73,73,73,91,0,91,
0,0,90,90,90,90,90,0,0,
0,0,0,0,0,0,0,0,0,
0,0,0,0,0,0,0,0,0,
0,0,0,0,0,0,0,0,0.