[layer]
type=Tile Layer 1
data=
6,1,5,0,21,0,1,4,1,
0,0,0,21,0,0,6,4,1,
21,6,4,5,5,4,4,5,6,
6,3,5,6,3,21,3,0,3,
1,1,5,1,3,21,5,0,1,
0,0,0,21,5,0,6,0,6,
4,4,4,21,6,3,4,0,3,
6,0,0,0,0,0,1,21,0,
3,3,21,1,1,6,3,1,6,
3,3,21,6,6,4,4,4,1,
1,1,0,21,0,0,0,0,0,
3,3,21,6,3,1,6,4,4,
1,4,4,3,21,4,6,3,1,
0,21,0,4,0,6,1,6,3,
6,3,21,6,1,4,4,3,1,
5,5,0,1,0,1,21,0,0,
4,5,21,3,1,3,1,3,4,
1,5,1,3,21,4,1,4,5,
3,3,6,1,21,5,1,3,5,
1,1,1,21,6,1,3,1,5,
6,3,3,1,21,6,6,5,5,
0,5,6,3,0,6,0,3,21,
0,5,6,6,21,1,5,5,3,
0,3,21,0,0,1,1,5,1,
5,4,5,6,21,1,4,4,5,
6,5,4,6,21,5,5,1,6,
4,6,4,1,21,1,6,1,1,
3,1,3,4,21,0,0,6,0,
1,4,6,1,21,3,1,6,0,
0,0,21,4,0,4,0,0,0,
4,5,1,5,5,3,21,5,1,
3,1,0,0,21,3,0,3,5,
1,4,21,3,1,4,0,4,4,
0,21,0,6,1,3,0,0,0,
4,6,21,6,4,1,0,1,4,
0,21,0,3,0,4,0,1,3,
4,4,1,1,21,6,0,5,5,
4,1,1,6,21,0,1,0,0,
5,4,5,1,6,6,21,5,6,
1,4,6,1,1,6,6,21,1,
6,4,1,6,5,1,1,21,0,
5,5,4,4,5,0,1,21,0,
1,5,4,4,4,1,1,21,0,
0,21,0,0,0,0,4,1,6,
21,5,6,5,5,1,6,1,6,
0,21,1,6,5,5,4,6,4,
5,0,0,21,0,5,4,6,1,
4,5,1,4,21,1,6,1,6,
6,0,21,0,0,1,1,1,3,
5,0,0,0,0,0,0,21,0,
5,3,5,6,1,5,6,3,21,
4,4,1,5,1,6,6,6,21,
5,5,0,0,21,0,0,0,0,
0,0,21,6,1,1,5,4,4,
0,0,0,0,0,0,0,0,0,
0,0,0,0,0,0,0,0,0,
0,0,0,0,0,0,0,0,0.
[layer]
type=Tile Layer 2
data=
239,239,239,0,0,0,239,239,239,
0,0,0,0,0,0,237,237,237,
0,224,224,224,224,224,224,224,224,
164,164,164,164,164,0,164,0,164,
205,205,205,205,205,0,205,0,205,
0,0,0,0,189,0,189,0,189,
174,174,174,0,174,174,174,0,174,
159,0,0,0,0,0,159,0,0,
189,189,0,189,189,189,189,189,189,
175,175,0,175,175,175,175,175,175,
169,169,0,0,0,0,0,0,0,
147,147,0,147,147,147,147,147,147,
184,184,184,184,0,184,184,184,184,
0,0,0,179,0,179,179,179,179,
157,157,0,125,157,125,157,157,157,
150,150,0,120,0,7,0,0,0,
179,179,0,143,143,143,143,179,179,
8,139,8,139,0,139,139,139,139,
152,152,122,152,0,152,122,152,152,
7,117,7,0,146,117,117,7,117,
173,173,173,173,0,173,173,173,173,
0,168,168,168,0,168,0,168,0,
0,155,155,155,0,155,155,155,155,
0,142,0,0,0,142,142,142,142,
168,168,168,168,0,168,168,168,168,
155,155,155,155,0,155,155,155,155,
143,143,143,143,0,143,143,143,143,
137,137,137,137,0,0,0,137,0,
171,171,171,171,0,171,171,171,0,
0,0,0,158,0,158,0,0,0,
138,138,138,138,138,138,0,138,138,
133,133,0,0,0,133,0,133,133,
165,165,0,165,165,165,0,165,165,
0,0,0,153,153,153,0,0,0,
141,141,0,141,141,141,0,141,141,
0,0,0,128,0,128,0,128,128,
160,160,160,160,0,160,0,160,160,
148,148,118,148,0,0,7,0,0,
129,103,103,103,129,103,0,103,129,
99,99,99,99,99,99,99,0,6,
154,123,123,123,154,7,7,0,0,
142,142,114,142,142,0,7,0,0,
131,105,105,105,131,6,6,0,0,
0,0,0,0,0,0,120,120,120,
0,113,113,113,113,113,113,113,113,
0,0,108,108,108,108,108,108,108,
107,0,0,0,0,107,107,107,107,
101,101,101,101,0,101,101,101,101,
95,0,0,0,0,95,95,95,95,
94,0,0,0,0,0,0,0,0,
89,89,89,89,89,89,89,89,0,
88,88,88,88,88,88,88,88,0,
91,91,0,0,0,0,0,0,0,
0,0,0,90,90,90,90,90,90,
0,0,0,0,0,0,0,0,0,
0,0,0,0,0,0,0,0,0,
0,0,0,0,0,0,0,0,0.