[layer]
type=Tile Layer 1
data=
0,0,0,21,0,1,1,1,1,
0,21,1,1,1,1,1,1,1,
1,0,0,21,0,1,1,1,1,
1,1,1,1,0,21,0,0,1,
1,1,1,1,1,21,0,0,1,
1,1,1,1,1,21,1,1,1,
0,1,1,1,1,1,0,1,21,
0,0,0,0,21,1,0,1,0,
0,1,1,1,21,1,1,1,1,
0,1,1,1,0,1,0,0,21,
0,1,1,1,1,1,21,1,1,
0,1,1,1,0,21,0,1,0,
0,1,1,1,1,1,21,1,1,
0,1,0,0,21,1,0,0,0,
0,1,1,1,0,1,1,1,21,
1,1,1,21,0,1,1,0,1,
1,1,1,1,21,0,1,1,1,
1,1,0,0,0,0,21,0,0,
1,1,21,1,1,1,1,0,0,
1,0,0,1,1,1,1,21,0,
0,0,1,1,1,1,1,1,21,
0,21,1,1,1,1,1,1,0,
1,21,1,1,1,1,1,1,0,
1,0,0,21,0,1,1,1,0,
1,1,1,1,21,0,1,1,1,
1,1,1,1,1,0,21,0,0,
1,1,1,1,1,1,1,1,21,
1,1,1,1,1,1,1,1,21,
0,0,1,1,0,21,0,0,0,
0,0,0,0,0,21,0,1,1,
1,1,1,1,1,21,0,1,1,
1,1,1,1,1,21,0,0,0,
1,1,1,1,1,1,1,1,21,
0,0,21,0,0,1,0,1,1,
0,1,1,1,21,1,0,1,1,
0,1,1,1,21,1,0,0,0,
1,1,1,1,21,1,1,1,1,
0,1,1,1,0,1,21,0,0,
0,1,1,1,0,1,21,1,0,
0,0,0,21,0,1,0,1,0,
1,1,21,1,1,1,0,1,1,
1,1,0,1,21,0,0,1,1,
1,1,0,21,1,1,1,0,1,
0,21,0,1,1,1,1,1,1,
0,1,21,1,1,1,1,1,1,
0,1,1,1,1,21,0,0,1,
0,0,0,0,21,0,1,1,1,
1,1,0,0,21,0,1,0,0,
0,0,0,0,0,0,0,0,0,
0,0,0,0,0,0,0,0,0,
0,0,0,0,0,0,0,0,0.
[layer]
type=Tile Layer 2
data=
0,0,0,0,0,228,228,228,228,
0,0,227,227,227,227,227,227,227,
225,0,0,0,0,225,225,225,225,
183,183,183,183,0,0,0,0,183,
168,168,168,168,168,0,0,0,168,
146,146,146,146,146,0,146,146,146,
0,192,192,192,192,192,0,192,0,
0,0,0,0,0,178,0,178,0,
0,164,164,164,0,164,164,164,164,
0,149,149,149,0,149,0,0,0,
0,187,187,187,187,187,0,187,187,
0,173,173,173,0,0,0,173,0,
0,159,159,159,159,159,0,159,159,
0,145,0,0,0,145,0,0,0,
0,181,181,181,0,181,181,181,0,
167,167,167,0,0,167,167,0,167,
154,154,154,154,0,0,154,154,154,
141,141,0,0,0,0,0,0,0,
176,176,0,176,176,176,176,0,0,
162,0,0,162,162,162,162,0,0,
0,0,149,149,149,149,149,149,0,
0,0,136,136,136,136,136,136,0,
170,0,170,170,170,170,170,170,0,
157,0,0,0,0,157,157,157,0,
144,144,144,144,0,0,144,144,144,
132,132,132,132,132,0,0,0,0,
156,156,156,156,156,156,156,156,0,
145,145,145,145,145,145,145,145,0,
0,0,140,140,0,0,0,0,0,
0,0,0,0,0,0,0,127,127,
159,159,159,159,159,0,0,159,159,
147,147,147,147,147,0,0,0,0,
128,128,128,128,128,128,128,128,0,
0,0,0,0,0,123,0,123,123,
0,153,153,153,0,153,0,153,153,
0,141,141,141,0,141,0,0,0,
124,124,124,124,0,124,124,124,124,
0,119,119,119,0,119,0,0,0,
0,118,118,118,0,118,0,118,0,
0,0,0,0,0,107,0,107,0,
106,106,0,106,106,106,0,106,106,
105,105,0,105,0,0,0,105,105,
94,94,0,0,94,94,94,0,94,
0,0,0,93,93,93,93,93,93,
0,92,0,92,92,92,92,92,92,
0,91,91,91,91,0,0,0,91,
0,0,0,0,0,0,90,90,90,
89,89,0,0,0,0,89,0,0,
0,0,0,0,0,0,0,0,0,
0,0,0,0,0,0,0,0,0,
0,0,0,0,0,0,0,0,0.