[layer]
type=Tile Layer 1
data=
1,0,21,0,0,0,0,0,0,
1,1,1,21,1,0,1,1,1,
0,21,2,0,2,0,1,1,1,
0,2,2,9,2,21,2,2,2,
0,1,2,2,2,1,0,0,21,
0,1,1,1,1,1,0,21,0,
0,2,2,2,2,2,21,2,9,
1,0,1,1,21,0,0,2,2,
0,0,1,1,21,1,1,1,1,
0,0,21,1,1,1,1,1,1,
0,2,2,21,1,1,1,1,1,
0,10,2,0,21,2,2,0,1,
0,2,0,1,2,8,0,1,21,
1,1,0,2,21,2,2,1,0,
0,2,2,9,2,2,21,2,2,
0,10,2,2,2,1,21,1,1,
0,0,21,1,0,0,0,1,0,
0,1,0,1,1,1,0,1,21,
0,0,0,0,0,0,0,0,0,
0,0,0,0,0,0,0,0,0,
0,0,0,0,0,0,0,0,0.
[layer]
type=Tile Layer 2
data=
128,0,0,0,0,0,0,0,0,
121,121,121,0,121,0,121,121,121,
0,0,125,0,125,0,125,125,125,
0,86,86,86,86,0,86,86,86,
0,107,107,107,107,107,0,0,0,
0,98,98,98,98,98,0,0,0,
0,90,90,90,90,90,0,90,90,
82,0,82,82,0,0,0,82,82,
0,0,81,81,0,81,81,81,81,
0,0,0,73,73,73,73,73,73,
0,68,68,0,68,68,68,68,68,
0,71,71,0,0,71,71,0,71,
0,63,0,63,63,63,0,63,0,
62,62,0,62,0,62,62,62,0,
0,61,61,61,61,61,0,61,61,
0,60,60,60,60,60,0,60,60,
0,0,0,59,0,0,0,59,0,
0,58,0,58,58,58,0,58,0,
0,0,0,0,0,0,0,0,0,
0,0,0,0,0,0,0,0,0,
0,0,0,0,0,0,0,0,0.