[layer]
type=Tile Layer 1
data=
0,1,0,1,1,1,21,1,0,
1,1,21,1,1,5,3,1,0,
0,0,1,1,0,21,0,0,0,
1,6,4,1,6,21,1,0,0,
1,0,6,0,0,4,1,1,21,
1,0,4,0,1,1,1,1,1,
0,0,1,0,21,1,1,0,0,
0,1,1,3,0,21,1,1,0,
0,1,1,6,0,1,1,21,1,
0,0,0,0,0,0,0,0,0,
0,0,0,0,0,0,0,0,0,
0,0,0,0,0,0,0,0,0.
[layer]
type=Tile Layer 2
data=
0,74,0,74,74,74,0,74,0,
44,44,0,44,44,44,44,44,0,
0,0,46,46,0,0,0,0,0,
45,45,45,45,45,0,45,0,0,
44,0,44,0,0,44,44,44,0,
41,0,41,0,41,41,41,41,41,
0,0,43,0,0,43,43,0,0,
0,43,43,43,0,0,43,43,0,
0,42,42,42,0,42,42,0,42,
0,0,0,0,0,0,0,0,0,
0,0,0,0,0,0,0,0,0,
0,0,0,0,0,0,0,0,0.