[layer]
type=Tile Layer 1
data=
1,1,21,1,1,1,1,0,1,
1,0,0,21,24,2,1,1,1,
0,0,1,1,21,1,1,1,1,
1,1,1,0,1,21,1,0,0,
1,1,1,21,1,0,1,1,1,
0,0,1,0,1,21,0,0,0,
1,1,1,21,1,1,1,1,1,
1,0,21,0,1,0,0,0,0,
1,21,1,1,1,1,1,1,1,
1,21,1,0,1,1,1,1,1,
1,21,1,1,1,1,1,1,1,
1,0,1,21,0,0,0,0,0,
2,2,2,21,2,0,2,18,2,
0,0,2,18,2,21,2,0,0,
1,0,1,21,1,1,2,0,1,
2,0,2,0,21,0,2,20,2,
2,21,2,2,2,0,2,18,2,
1,0,1,21,0,0,1,0,1,
2,21,2,2,2,0,2,18,2,
1,0,0,21,1,0,1,0,1,
1,0,1,0,1,21,1,0,1,
1,1,2,2,21,1,0,1,1,
0,0,0,24,21,1,0,0,0,
1,1,1,1,1,1,1,1,21,
1,2,21,2,0,1,0,0,0,
2,2,20,2,21,2,2,2,0,
0,0,0,2,21,1,1,1,0,
0,0,0,0,0,0,0,0,0,
0,0,0,0,0,0,0,0,0,
0,0,0,0,0,0,0,0,0.
[layer]
type=Tile Layer 2
data=
160,160,0,160,160,160,160,0,160,
158,0,0,0,0,158,158,158,158,
0,0,157,157,0,157,157,157,157,
117,117,117,0,117,0,117,0,0,
107,107,107,0,107,0,107,107,107,
0,0,133,0,133,0,0,0,0,
117,117,117,0,117,117,117,117,117,
113,0,0,0,113,0,0,0,0,
98,0,98,98,98,98,98,98,98,
128,0,128,0,128,128,128,128,128,
112,0,112,112,112,112,112,112,112,
108,0,108,0,0,0,0,0,0,
98,98,98,0,98,0,98,0,98,
0,0,122,0,122,0,122,0,0,
112,0,112,0,112,112,112,0,112,
103,0,103,0,0,0,103,0,103,
94,0,94,94,94,0,94,0,94,
93,0,93,0,0,0,93,0,93,
84,0,84,84,84,0,84,0,84,
83,0,0,0,83,0,83,0,83,
82,0,82,0,82,0,82,0,82,
73,73,73,73,0,73,0,73,73,
0,0,0,0,0,72,0,0,0,
68,68,68,68,68,68,68,68,0,
70,70,0,70,0,70,0,0,0,
69,69,0,69,0,69,69,69,0,
0,0,0,68,0,68,68,68,0,
0,0,0,0,0,0,0,0,0,
0,0,0,0,0,0,0,0,0,
0,0,0,0,0,0,0,0,0.