[layer]
type=Tile Layer 1
data=
0,1,5,1,6,1,3,1,21,
0,0,0,0,1,1,1,1,21,
3,1,1,21,0,0,0,0,0,
5,1,1,1,6,1,6,1,21,
1,1,1,1,1,21,1,1,0,
1,1,1,1,4,21,0,0,4,
1,1,1,6,0,21,0,0,1,
1,1,1,1,1,1,21,6,0,
3,1,1,5,1,5,21,1,0,
1,0,0,0,21,0,0,0,1,
1,21,1,4,5,1,0,0,1,
1,1,21,6,1,1,0,0,0,
6,1,0,0,21,1,1,1,0,
1,1,1,1,21,0,1,1,0,
1,3,1,5,3,0,21,0,0,
1,21,1,1,1,1,1,1,1,
5,0,0,21,0,0,0,0,1,
4,1,21,5,1,1,1,6,1,
0,0,0,0,21,0,0,0,1,
1,1,6,21,1,1,1,0,1,
0,0,1,0,0,21,3,0,0,
1,21,1,1,1,1,3,4,1,
0,0,3,0,0,0,0,21,0,
1,1,1,21,1,1,1,1,6,
4,21,1,1,1,4,1,0,1,
1,1,5,1,5,1,1,21,1,
0,0,21,1,0,1,1,6,1,
1,1,1,1,5,21,1,1,1,
0,0,0,0,5,21,1,6,4,
1,1,6,21,1,1,1,1,1,
0,0,0,0,1,0,0,0,21,
1,5,1,21,1,6,1,1,1,
1,1,4,21,1,0,0,0,0,
1,1,1,1,4,21,1,1,1,
3,1,0,21,1,0,0,1,1,
1,21,3,5,4,1,1,1,1,
1,21,1,0,0,0,0,0,0,
1,0,1,21,1,5,1,0,1,
1,0,3,21,1,6,6,0,1,
0,0,0,0,0,0,0,0,0,
0,0,0,0,0,0,0,0,0,
0,0,0,0,0,0,0,0,0.
[layer]
type=Tile Layer 2
data=
0,197,197,197,197,197,197,197,0,
0,0,0,0,195,195,195,195,0,
194,194,194,0,0,0,0,0,0,
139,139,139,139,139,139,139,139,0,
133,133,133,133,133,0,133,133,0,
166,166,166,166,166,0,0,0,166,
153,153,153,153,0,0,0,0,153,
141,141,141,141,141,141,0,141,0,
129,129,129,129,129,129,0,129,0,
161,0,0,0,0,0,0,0,161,
148,0,148,148,148,148,0,0,148,
136,136,0,136,136,136,0,0,0,
124,124,0,0,0,124,124,124,0,
155,155,155,155,0,0,155,155,0,
143,143,143,143,143,0,0,0,0,
125,0,125,125,125,125,125,125,125,
120,0,0,0,0,0,0,0,120,
142,142,0,142,142,142,142,142,142,
0,0,0,0,0,0,0,0,138,
127,127,127,0,127,127,127,0,127,
0,0,115,0,0,0,115,0,0,
137,0,137,137,137,137,137,137,137,
0,0,133,0,0,0,0,0,0,
116,116,116,0,116,116,116,116,116,
111,0,111,111,111,111,111,0,111,
132,132,132,132,132,132,132,0,132,
0,0,0,127,0,127,127,127,127,
111,111,111,111,111,0,111,111,111,
0,0,0,0,107,0,107,107,107,
101,101,101,0,101,101,101,101,101,
0,0,0,0,96,0,0,0,0,
90,90,90,0,90,90,90,90,90,
94,94,94,0,94,0,0,0,0,
80,80,80,80,80,0,80,80,80,
83,83,0,0,83,0,0,83,83,
78,0,78,78,78,78,78,78,78,
81,0,81,0,0,0,0,0,0,
80,0,80,0,80,80,80,0,80,
79,0,79,0,79,79,79,0,79,
0,0,0,0,0,0,0,0,0,
0,0,0,0,0,0,0,0,0,
0,0,0,0,0,0,0,0,0.