[layer]
type=Tile Layer 1
data=
0,0,0,21,1,0,1,1,1,
1,1,1,1,1,21,1,1,1,
1,1,1,0,0,21,0,0,0,
0,0,1,0,1,21,1,0,0,
0,0,0,0,1,1,1,21,1,
0,1,1,21,0,0,1,1,1,
0,1,1,1,1,0,21,1,1,
0,0,0,1,21,0,1,0,1,
1,1,1,1,1,21,1,1,0,
1,1,0,1,0,0,1,21,0,
1,0,21,1,1,0,1,1,0,
1,1,0,0,0,0,0,21,0,
0,2,2,2,2,0,21,20,2,
1,1,1,1,1,1,2,21,1,
1,1,1,1,1,21,0,0,0,
1,1,1,1,1,21,1,1,1,
0,0,0,0,0,21,0,0,1,
1,21,1,1,1,1,1,0,2,
0,0,1,2,2,2,1,21,19,
1,21,1,2,19,2,1,2,2,
0,0,21,2,2,2,1,1,1,
0,21,1,1,0,0,0,0,1,
1,1,1,1,1,1,1,21,1,
0,1,1,1,1,1,0,21,0,
2,2,1,1,1,1,21,1,1,
20,2,2,2,2,2,21,2,2,
0,2,1,1,1,1,21,1,1,
0,0,0,0,21,0,0,1,1,
0,1,1,1,1,1,21,1,1,
0,2,21,0,18,2,0,2,0,
0,0,0,21,0,1,1,1,1,
0,1,1,1,21,1,1,1,1,
0,0,1,1,21,1,1,1,1,
1,21,0,0,0,0,0,0,1,
2,2,1,0,21,0,1,0,1,
19,0,0,2,2,21,0,18,2,
2,2,0,0,21,1,1,0,1,
2,2,0,0,0,18,21,0,0,
0,18,2,2,21,0,0,0,0,
0,1,1,1,1,1,0,21,0,
21,2,1,1,1,1,1,1,1,
24,2,1,1,1,1,0,21,0,
0,1,1,1,1,1,21,1,1,
0,1,0,0,1,1,21,0,0,
1,1,1,1,1,1,1,1,21,
0,0,0,0,0,0,0,0,0,
0,0,0,0,0,0,0,0,0,
0,0,0,0,0,0,0,0,0.
[layer]
type=Tile Layer 2
data=
0,0,0,0,208,0,208,208,208,
196,196,196,196,196,0,196,196,196,
204,204,204,0,0,0,0,0,0,
0,0,178,0,178,0,178,0,0,
0,0,0,0,165,165,165,0,165,
0,152,152,0,0,0,152,152,152,
0,138,138,138,138,0,0,138,138,
0,0,0,173,0,0,173,0,173,
160,160,160,160,160,0,160,160,0,
147,147,0,147,0,0,147,0,0,
134,0,0,134,134,0,134,134,0,
167,167,0,0,0,0,0,0,0,
0,154,154,154,154,0,0,0,154,
135,135,135,135,135,135,135,0,135,
130,130,130,130,130,0,0,0,0,
154,154,154,154,154,0,154,154,154,
0,0,0,0,0,0,0,0,149,
137,0,137,137,137,137,137,0,137,
0,0,125,125,125,125,125,0,0,
156,0,156,156,0,156,156,156,156,
0,0,0,144,144,144,144,144,144,
0,0,132,132,0,0,0,0,132,
115,115,115,115,115,115,115,0,115,
0,150,150,150,150,150,0,0,0,
132,132,132,132,132,132,0,132,132,
0,128,128,128,128,128,0,128,128,
0,116,116,116,116,116,0,116,116,
0,0,0,0,0,0,0,145,145,
0,134,134,134,134,134,0,134,134,
0,123,0,0,0,123,0,123,0,
0,0,0,0,0,112,112,112,112,
0,139,139,139,0,139,139,139,139,
0,0,128,128,0,128,128,128,128,
118,0,0,0,0,0,0,0,118,
108,108,108,0,0,0,108,0,108,
0,0,0,107,107,0,0,0,107,
97,97,0,0,0,97,97,0,97,
96,96,0,0,0,0,0,0,0,
0,0,95,95,0,0,0,0,0,
0,85,85,85,85,85,0,0,0,
0,80,80,80,80,80,80,80,80,
0,83,83,83,83,83,0,0,0,
0,82,82,82,82,82,0,82,82,
0,81,0,0,81,81,0,0,0,
77,77,77,77,77,77,77,77,0,
0,0,0,0,0,0,0,0,0,
0,0,0,0,0,0,0,0,0,
0,0,0,0,0,0,0,0,0.