[layer]
type=Tile Layer 1
data=
0,1,5,4,0,1,21,0,1,
0,0,21,1,0,1,0,3,5,
1,1,21,1,1,1,1,6,0,
0,1,21,0,0,1,0,0,0,
1,1,1,6,4,1,6,4,4,
0,0,0,21,1,6,0,0,21,
0,0,0,0,0,0,0,0,0,
0,0,0,0,0,0,0,0,0,
0,0,0,0,0,0,0,0,0.
[layer]
type=Tile Layer 2
data=
0,35,35,35,0,35,0,0,35,
0,0,0,34,0,34,0,34,34,
30,30,0,30,30,30,30,30,0,
0,33,0,0,0,33,0,0,0,
26,26,26,26,26,26,26,26,26,
0,0,0,0,32,32,0,0,0,
0,0,0,0,0,0,0,0,0,
0,0,0,0,0,0,0,0,0,
0,0,0,0,0,0,0,0,0.